Location_ID,Sensing_DateTime,Sensing_Date,Sensing_Time,Direction_1,Direction_2,Total_of_Directions
3,2023-08-11T23:42:00+10:00,2023-08-11,23:42,16,3,19
3,2023-08-11T23:43:00+10:00,2023-08-11,23:43,5,4,9
3,2023-08-11T23:45:00+10:00,2023-08-11,23:45,9,10,19
3,2023-08-11T23:48:00+10:00,2023-08-11,23:48,11,12,23
3,2023-08-11T23:49:00+10:00,2023-08-11,23:49,11,23,34
3,2023-08-11T23:54:00+10:00,2023-08-11,23:54,19,13,32
4,2023-08-11T23:41:00+10:00,2023-08-11,23:41,2,6,8
4,2023-08-11T23:48:00+10:00,2023-08-11,23:48,11,20,31
6,2023-08-11T23:46:00+10:00,2023-08-11,23:46,1,4,5
6,2023-08-11T23:47:00+10:00,2023-08-11,23:47,7,0,7
6,2023-08-11T23:52:00+10:00,2023-08-11,23:52,5,5,10
6,2023-08-11T23:53:00+10:00,2023-08-11,23:53,3,3,6
8,2023-08-11T23:43:00+10:00,2023-08-11,23:43,1,5,6
8,2023-08-11T23:50:00+10:00,2023-08-11,23:50,4,0,4
14,2023-08-11T23:42:00+10:00,2023-08-11,23:42,8,4,12
14,2023-08-11T23:43:00+10:00,2023-08-11,23:43,3,3,6
14,2023-08-11T23:51:00+10:00,2023-08-11,23:51,4,0,4
14,2023-08-11T23:52:00+10:00,2023-08-11,23:52,4,0,4
14,2023-08-11T23:53:00+10:00,2023-08-11,23:53,1,1,2
21,2023-08-11T23:40:00+10:00,2023-08-11,23:40,0,2,2
21,2023-08-11T23:41:00+10:00,2023-08-11,23:41,7,6,13
21,2023-08-11T23:46:00+10:00,2023-08-11,23:46,8,9,17
21,2023-08-11T23:47:00+10:00,2023-08-11,23:47,4,9,13
21,2023-08-11T23:50:00+10:00,2023-08-11,23:50,4,8,12
21,2023-08-11T23:53:00+10:00,2023-08-11,23:53,1,3,4
28,2023-08-11T23:42:00+10:00,2023-08-11,23:42,3,0,3
28,2023-08-11T23:43:00+10:00,2023-08-11,23:43,3,0,3
28,2023-08-11T23:46:00+10:00,2023-08-11,23:46,3,0,3
28,2023-08-11T23:48:00+10:00,2023-08-11,23:48,7,1,8
28,2023-08-11T23:52:00+10:00,2023-08-11,23:52,3,0,3
29,2023-08-11T23:40:00+10:00,2023-08-11,23:40,1,2,3
29,2023-08-11T23:43:00+10:00,2023-08-11,23:43,0,3,3
29,2023-08-11T23:44:00+10:00,2023-08-11,23:44,0,2,2
39,2023-08-11T23:54:00+10:00,2023-08-11,23:54,1,1,2
41,2023-08-11T23:41:00+10:00,2023-08-11,23:41,10,8,18
41,2023-08-11T23:43:00+10:00,2023-08-11,23:43,21,8,29
41,2023-08-11T23:45:00+10:00,2023-08-11,23:45,7,13,20
41,2023-08-11T23:47:00+10:00,2023-08-11,23:47,14,9,23
41,2023-08-11T23:51:00+10:00,2023-08-11,23:51,12,18,30
41,2023-08-11T23:53:00+10:00,2023-08-11,23:53,24,11,35
54,2023-08-11T23:49:00+10:00,2023-08-11,23:49,0,4,4
54,2023-08-11T23:50:00+10:00,2023-08-11,23:50,1,3,4
54,2023-08-11T23:51:00+10:00,2023-08-11,23:51,0,4,4
54,2023-08-11T23:54:00+10:00,2023-08-11,23:54,3,2,5
55,2023-08-11T23:41:00+10:00,2023-08-11,23:41,9,11,20
55,2023-08-11T23:45:00+10:00,2023-08-11,23:45,19,12,31
55,2023-08-11T23:51:00+10:00,2023-08-11,23:51,4,7,11
55,2023-08-11T23:52:00+10:00,2023-08-11,23:52,1,10,11
61,2023-08-11T23:40:00+10:00,2023-08-11,23:40,1,1,2
61,2023-08-11T23:41:00+10:00,2023-08-11,23:41,1,0,1
61,2023-08-11T23:52:00+10:00,2023-08-11,23:52,4,3,7
65,2023-08-11T23:40:00+10:00,2023-08-11,23:40,1,11,12
65,2023-08-11T23:41:00+10:00,2023-08-11,23:41,1,2,3
65,2023-08-11T23:42:00+10:00,2023-08-11,23:42,4,9,13
65,2023-08-11T23:45:00+10:00,2023-08-11,23:45,0,6,6
65,2023-08-11T23:47:00+10:00,2023-08-11,23:47,2,0,2
65,2023-08-11T23:49:00+10:00,2023-08-11,23:49,5,2,7
66,2023-08-11T23:41:00+10:00,2023-08-11,23:41,2,8,10
66,2023-08-11T23:43:00+10:00,2023-08-11,23:43,3,3,6
66,2023-08-11T23:44:00+10:00,2023-08-11,23:44,5,6,11
66,2023-08-11T23:54:00+10:00,2023-08-11,23:54,8,0,8
69,2023-08-11T23:41:00+10:00,2023-08-11,23:41,1,0,1
69,2023-08-11T23:43:00+10:00,2023-08-11,23:43,4,0,4
70,2023-08-11T23:49:00+10:00,2023-08-11,23:49,1,0,1
70,2023-08-11T23:53:00+10:00,2023-08-11,23:53,0,2,2
75,2023-08-11T23:43:00+10:00,2023-08-11,23:43,0,1,1
75,2023-08-11T23:53:00+10:00,2023-08-11,23:53,1,0,1
77,2023-08-11T23:40:00+10:00,2023-08-11,23:40,19,0,19
77,2023-08-11T23:43:00+10:00,2023-08-11,23:43,1,0,1
77,2023-08-11T23:51:00+10:00,2023-08-11,23:51,0,2,2
77,2023-08-11T23:53:00+10:00,2023-08-11,23:53,2,0,2
87,2023-08-11T23:40:00+10:00,2023-08-11,23:40,0,2,2
87,2023-08-11T23:47:00+10:00,2023-08-11,23:47,0,2,2
108,2023-08-11T23:41:00+10:00,2023-08-11,23:41,0,4,4
108,2023-08-11T23:43:00+10:00,2023-08-11,23:43,2,0,2
108,2023-08-11T23:44:00+10:00,2023-08-11,23:44,3,1,4
108,2023-08-11T23:45:00+10:00,2023-08-11,23:45,1,1,2
118,2023-08-11T23:45:00+10:00,2023-08-11,23:45,1,1,2
1,2023-08-11T23:47:00+10:00,2023-08-11,23:47,3,0,3
1,2023-08-11T23:52:00+10:00,2023-08-11,23:52,1,3,4
1,2023-08-11T23:53:00+10:00,2023-08-11,23:53,1,4,5
2,2023-08-11T23:53:00+10:00,2023-08-11,23:53,1,2,3
7,2023-08-11T23:40:00+10:00,2023-08-11,23:40,0,4,4
7,2023-08-11T23:47:00+10:00,2023-08-11,23:47,0,4,4
7,2023-08-11T23:49:00+10:00,2023-08-11,23:49,0,7,7
7,2023-08-11T23:54:00+10:00,2023-08-11,23:54,0,6,6
9,2023-08-11T23:46:00+10:00,2023-08-11,23:46,1,0,1
9,2023-08-11T23:50:00+10:00,2023-08-11,23:50,0,3,3
9,2023-08-11T23:51:00+10:00,2023-08-11,23:51,7,0,7
11,2023-08-11T23:40:00+10:00,2023-08-11,23:40,9,6,15
12,2023-08-11T23:41:00+10:00,2023-08-11,23:41,1,6,7
12,2023-08-11T23:42:00+10:00,2023-08-11,23:42,3,4,7
12,2023-08-11T23:43:00+10:00,2023-08-11,23:43,0,15,15
12,2023-08-11T23:44:00+10:00,2023-08-11,23:44,5,0,5
12,2023-08-11T23:47:00+10:00,2023-08-11,23:47,2,1,3
12,2023-08-11T23:52:00+10:00,2023-08-11,23:52,2,14,16
17,2023-08-11T23:41:00+10:00,2023-08-11,23:41,4,2,6
17,2023-08-11T23:43:00+10:00,2023-08-11,23:43,3,1,4
17,2023-08-11T23:48:00+10:00,2023-08-11,23:48,1,1,2
17,2023-08-11T23:49:00+10:00,2023-08-11,23:49,0,1,1
17,2023-08-11T23:53:00+10:00,2023-08-11,23:53,0,1,1
24,2023-08-11T23:45:00+10:00,2023-08-11,23:45,5,5,10
24,2023-08-11T23:48:00+10:00,2023-08-11,23:48,10,5,15
24,2023-08-11T23:53:00+10:00,2023-08-11,23:53,0,17,17
27,2023-08-11T23:45:00+10:00,2023-08-11,23:45,1,0,1
27,2023-08-11T23:46:00+10:00,2023-08-11,23:46,2,0,2
27,2023-08-11T23:50:00+10:00,2023-08-11,23:50,0,1,1
35,2023-08-11T23:43:00+10:00,2023-08-11,23:43,5,6,11
35,2023-08-11T23:45:00+10:00,2023-08-11,23:45,3,5,8
35,2023-08-11T23:48:00+10:00,2023-08-11,23:48,7,17,24
35,2023-08-11T23:52:00+10:00,2023-08-11,23:52,5,15,20
53,2023-08-11T23:40:00+10:00,2023-08-11,23:40,6,0,6
53,2023-08-11T23:41:00+10:00,2023-08-11,23:41,1,2,3
53,2023-08-11T23:44:00+10:00,2023-08-11,23:44,1,2,3
53,2023-08-11T23:47:00+10:00,2023-08-11,23:47,0,2,2
53,2023-08-11T23:52:00+10:00,2023-08-11,23:52,1,1,2
53,2023-08-11T23:53:00+10:00,2023-08-11,23:53,0,11,11
56,2023-08-11T23:41:00+10:00,2023-08-11,23:41,3,5,8
56,2023-08-11T23:50:00+10:00,2023-08-11,23:50,3,3,6
56,2023-08-11T23:52:00+10:00,2023-08-11,23:52,5,1,6
57,2023-08-11T23:46:00+10:00,2023-08-11,23:46,4,2,6
57,2023-08-11T23:48:00+10:00,2023-08-11,23:48,2,1,3
57,2023-08-11T23:54:00+10:00,2023-08-11,23:54,0,1,1
58,2023-08-11T23:40:00+10:00,2023-08-11,23:40,0,2,2
58,2023-08-11T23:41:00+10:00,2023-08-11,23:41,0,6,6
58,2023-08-11T23:45:00+10:00,2023-08-11,23:45,5,4,9
58,2023-08-11T23:47:00+10:00,2023-08-11,23:47,3,1,4
58,2023-08-11T23:48:00+10:00,2023-08-11,23:48,4,8,12
58,2023-08-11T23:49:00+10:00,2023-08-11,23:49,0,2,2
58,2023-08-11T23:53:00+10:00,2023-08-11,23:53,5,0,5
62,2023-08-11T23:40:00+10:00,2023-08-11,23:40,4,0,4
62,2023-08-11T23:41:00+10:00,2023-08-11,23:41,1,1,2
62,2023-08-11T23:50:00+10:00,2023-08-11,23:50,3,4,7
62,2023-08-11T23:53:00+10:00,2023-08-11,23:53,5,0,5
63,2023-08-11T23:42:00+10:00,2023-08-11,23:42,5,0,5
63,2023-08-11T23:45:00+10:00,2023-08-11,23:45,7,1,8
63,2023-08-11T23:47:00+10:00,2023-08-11,23:47,3,4,7
63,2023-08-11T23:49:00+10:00,2023-08-11,23:49,9,22,31
63,2023-08-11T23:51:00+10:00,2023-08-11,23:51,3,8,11
63,2023-08-11T23:52:00+10:00,2023-08-11,23:52,0,3,3
67,2023-08-11T23:43:00+10:00,2023-08-11,23:43,0,2,2
67,2023-08-11T23:46:00+10:00,2023-08-11,23:46,0,12,12
67,2023-08-11T23:51:00+10:00,2023-08-11,23:51,2,3,5
67,2023-08-11T23:53:00+10:00,2023-08-11,23:53,1,5,6
67,2023-08-11T23:54:00+10:00,2023-08-11,23:54,0,5,5
68,2023-08-11T23:40:00+10:00,2023-08-11,23:40,1,0,1
68,2023-08-11T23:44:00+10:00,2023-08-11,23:44,1,0,1
72,2023-08-11T23:41:00+10:00,2023-08-11,23:41,1,8,9
72,2023-08-11T23:42:00+10:00,2023-08-11,23:42,2,3,5
72,2023-08-11T23:47:00+10:00,2023-08-11,23:47,2,3,5
72,2023-08-11T23:50:00+10:00,2023-08-11,23:50,2,7,9
72,2023-08-11T23:51:00+10:00,2023-08-11,23:51,1,4,5
79,2023-08-11T23:41:00+10:00,2023-08-11,23:41,12,9,21
79,2023-08-11T23:47:00+10:00,2023-08-11,23:47,4,3,7
79,2023-08-11T23:51:00+10:00,2023-08-11,23:51,5,6,11
79,2023-08-11T23:54:00+10:00,2023-08-11,23:54,8,7,15
117,2023-08-11T23:40:00+10:00,2023-08-11,23:40,9,10,19
117,2023-08-11T23:45:00+10:00,2023-08-11,23:45,13,24,37
122,2023-08-11T23:44:00+10:00,2023-08-11,23:44,1,2,3
122,2023-08-11T23:49:00+10:00,2023-08-11,23:49,0,1,1
3,2023-08-11T23:12:00+10:00,2023-08-11,23:12,32,14,46
3,2023-08-11T23:13:00+10:00,2023-08-11,23:13,12,17,29
3,2023-08-11T23:16:00+10:00,2023-08-11,23:16,11,10,21
3,2023-08-11T23:18:00+10:00,2023-08-11,23:18,24,15,39
3,2023-08-11T23:19:00+10:00,2023-08-11,23:19,14,26,40
3,2023-08-11T23:21:00+10:00,2023-08-11,23:21,13,15,28
3,2023-08-11T23:24:00+10:00,2023-08-11,23:24,15,15,30
4,2023-08-11T23:19:00+10:00,2023-08-11,23:19,35,10,45
4,2023-08-11T23:20:00+10:00,2023-08-11,23:20,31,15,46
4,2023-08-11T23:23:00+10:00,2023-08-11,23:23,17,7,24
6,2023-08-11T23:12:00+10:00,2023-08-11,23:12,8,17,25
6,2023-08-11T23:14:00+10:00,2023-08-11,23:14,6,7,13
6,2023-08-11T23:21:00+10:00,2023-08-11,23:21,6,6,12
8,2023-08-11T23:19:00+10:00,2023-08-11,23:19,2,3,5
8,2023-08-11T23:22:00+10:00,2023-08-11,23:22,1,0,1
14,2023-08-11T23:15:00+10:00,2023-08-11,23:15,12,16,28
14,2023-08-11T23:20:00+10:00,2023-08-11,23:20,4,12,16
14,2023-08-11T23:22:00+10:00,2023-08-11,23:22,4,18,22
14,2023-08-11T23:24:00+10:00,2023-08-11,23:24,7,0,7
21,2023-08-11T23:10:00+10:00,2023-08-11,23:10,4,7,11
21,2023-08-11T23:11:00+10:00,2023-08-11,23:11,14,2,16
21,2023-08-11T23:12:00+10:00,2023-08-11,23:12,13,6,19
21,2023-08-11T23:15:00+10:00,2023-08-11,23:15,14,11,25
21,2023-08-11T23:17:00+10:00,2023-08-11,23:17,3,6,9
21,2023-08-11T23:18:00+10:00,2023-08-11,23:18,21,2,23
21,2023-08-11T23:22:00+10:00,2023-08-11,23:22,8,2,10
21,2023-08-11T23:24:00+10:00,2023-08-11,23:24,4,2,6
28,2023-08-11T23:11:00+10:00,2023-08-11,23:11,29,1,30
28,2023-08-11T23:16:00+10:00,2023-08-11,23:16,18,5,23
28,2023-08-11T23:21:00+10:00,2023-08-11,23:21,17,1,18
28,2023-08-11T23:24:00+10:00,2023-08-11,23:24,6,3,9
29,2023-08-11T23:10:00+10:00,2023-08-11,23:10,0,23,23
29,2023-08-11T23:13:00+10:00,2023-08-11,23:13,7,18,25
29,2023-08-11T23:14:00+10:00,2023-08-11,23:14,0,25,25
29,2023-08-11T23:17:00+10:00,2023-08-11,23:17,2,2,4
29,2023-08-11T23:18:00+10:00,2023-08-11,23:18,7,13,20
29,2023-08-11T23:20:00+10:00,2023-08-11,23:20,3,24,27
29,2023-08-11T23:23:00+10:00,2023-08-11,23:23,5,7,12
29,2023-08-11T23:24:00+10:00,2023-08-11,23:24,0,4,4
39,2023-08-11T23:16:00+10:00,2023-08-11,23:16,2,0,2
41,2023-08-11T23:13:00+10:00,2023-08-11,23:13,54,18,72
41,2023-08-11T23:16:00+10:00,2023-08-11,23:16,57,13,70
41,2023-08-11T23:17:00+10:00,2023-08-11,23:17,33,12,45
41,2023-08-11T23:22:00+10:00,2023-08-11,23:22,29,12,41
41,2023-08-11T23:23:00+10:00,2023-08-11,23:23,28,9,37
54,2023-08-11T23:12:00+10:00,2023-08-11,23:12,1,2,3
54,2023-08-11T23:17:00+10:00,2023-08-11,23:17,1,0,1
54,2023-08-11T23:18:00+10:00,2023-08-11,23:18,1,7,8
55,2023-08-11T23:12:00+10:00,2023-08-11,23:12,14,17,31
55,2023-08-11T23:17:00+10:00,2023-08-11,23:17,12,10,22
55,2023-08-11T23:21:00+10:00,2023-08-11,23:21,15,3,18
55,2023-08-11T23:24:00+10:00,2023-08-11,23:24,14,14,28
59,2023-08-11T23:15:00+10:00,2023-08-11,23:15,32,23,55
59,2023-08-11T23:20:00+10:00,2023-08-11,23:20,34,12,46
61,2023-08-11T23:13:00+10:00,2023-08-11,23:13,2,3,5
61,2023-08-11T23:15:00+10:00,2023-08-11,23:15,4,3,7
61,2023-08-11T23:18:00+10:00,2023-08-11,23:18,3,5,8
65,2023-08-11T23:11:00+10:00,2023-08-11,23:11,5,4,9
65,2023-08-11T23:12:00+10:00,2023-08-11,23:12,1,10,11
65,2023-08-11T23:16:00+10:00,2023-08-11,23:16,5,9,14
65,2023-08-11T23:19:00+10:00,2023-08-11,23:19,1,15,16
65,2023-08-11T23:23:00+10:00,2023-08-11,23:23,0,4,4
65,2023-08-11T23:24:00+10:00,2023-08-11,23:24,0,5,5
66,2023-08-11T23:10:00+10:00,2023-08-11,23:10,18,1,19
66,2023-08-11T23:12:00+10:00,2023-08-11,23:12,5,1,6
66,2023-08-11T23:17:00+10:00,2023-08-11,23:17,7,5,12
66,2023-08-11T23:19:00+10:00,2023-08-11,23:19,12,1,13
66,2023-08-11T23:21:00+10:00,2023-08-11,23:21,2,10,12
66,2023-08-11T23:22:00+10:00,2023-08-11,23:22,11,6,17
69,2023-08-11T23:16:00+10:00,2023-08-11,23:16,1,0,1
69,2023-08-11T23:23:00+10:00,2023-08-11,23:23,0,3,3
70,2023-08-11T23:11:00+10:00,2023-08-11,23:11,0,2,2
70,2023-08-11T23:17:00+10:00,2023-08-11,23:17,1,0,1
70,2023-08-11T23:22:00+10:00,2023-08-11,23:22,0,3,3
70,2023-08-11T23:24:00+10:00,2023-08-11,23:24,0,1,1
75,2023-08-11T23:10:00+10:00,2023-08-11,23:10,29,0,29
75,2023-08-11T23:11:00+10:00,2023-08-11,23:11,4,0,4
75,2023-08-11T23:13:00+10:00,2023-08-11,23:13,1,0,1
75,2023-08-11T23:14:00+10:00,2023-08-11,23:14,2,6,8
75,2023-08-11T23:17:00+10:00,2023-08-11,23:17,3,0,3
75,2023-08-11T23:19:00+10:00,2023-08-11,23:19,4,0,4
75,2023-08-11T23:20:00+10:00,2023-08-11,23:20,2,2,4
77,2023-08-11T23:17:00+10:00,2023-08-11,23:17,1,0,1
78,2023-08-11T23:24:00+10:00,2023-08-11,23:24,0,3,3
87,2023-08-11T23:16:00+10:00,2023-08-11,23:16,0,3,3
107,2023-08-11T23:15:00+10:00,2023-08-11,23:15,7,0,7
108,2023-08-11T23:13:00+10:00,2023-08-11,23:13,0,4,4
108,2023-08-11T23:16:00+10:00,2023-08-11,23:16,1,0,1
108,2023-08-11T23:17:00+10:00,2023-08-11,23:17,4,1,5
118,2023-08-11T23:15:00+10:00,2023-08-11,23:15,8,4,12
1,2023-08-11T23:15:00+10:00,2023-08-11,23:15,4,0,4
1,2023-08-11T23:21:00+10:00,2023-08-11,23:21,0,3,3
1,2023-08-11T23:23:00+10:00,2023-08-11,23:23,0,4,4
1,2023-08-11T23:24:00+10:00,2023-08-11,23:24,6,1,7
2,2023-08-11T23:13:00+10:00,2023-08-11,23:13,3,0,3
2,2023-08-11T23:14:00+10:00,2023-08-11,23:14,0,5,5
2,2023-08-11T23:17:00+10:00,2023-08-11,23:17,1,6,7
2,2023-08-11T23:18:00+10:00,2023-08-11,23:18,0,9,9
2,2023-08-11T23:19:00+10:00,2023-08-11,23:19,0,1,1
7,2023-08-11T23:10:00+10:00,2023-08-11,23:10,2,120,122
7,2023-08-11T23:15:00+10:00,2023-08-11,23:15,0,25,25
7,2023-08-11T23:18:00+10:00,2023-08-11,23:18,0,20,20
7,2023-08-11T23:20:00+10:00,2023-08-11,23:20,1,31,32
7,2023-08-11T23:24:00+10:00,2023-08-11,23:24,1,13,14
9,2023-08-11T23:11:00+10:00,2023-08-11,23:11,1,0,1
11,2023-08-11T23:12:00+10:00,2023-08-11,23:12,0,1,1
12,2023-08-11T23:12:00+10:00,2023-08-11,23:12,2,0,2
12,2023-08-11T23:14:00+10:00,2023-08-11,23:14,2,0,2
12,2023-08-11T23:15:00+10:00,2023-08-11,23:15,1,0,1
12,2023-08-11T23:19:00+10:00,2023-08-11,23:19,1,0,1
12,2023-08-11T23:22:00+10:00,2023-08-11,23:22,1,1,2
17,2023-08-11T23:11:00+10:00,2023-08-11,23:11,12,9,21
17,2023-08-11T23:12:00+10:00,2023-08-11,23:12,11,4,15
17,2023-08-11T23:14:00+10:00,2023-08-11,23:14,8,2,10
17,2023-08-11T23:16:00+10:00,2023-08-11,23:16,3,1,4
17,2023-08-11T23:23:00+10:00,2023-08-11,23:23,0,4,4
18,2023-08-11T23:17:00+10:00,2023-08-11,23:17,0,1,1
18,2023-08-11T23:24:00+10:00,2023-08-11,23:24,0,1,1
24,2023-08-11T23:10:00+10:00,2023-08-11,23:10,6,30,36
24,2023-08-11T23:11:00+10:00,2023-08-11,23:11,6,4,10
24,2023-08-11T23:12:00+10:00,2023-08-11,23:12,4,8,12
24,2023-08-11T23:14:00+10:00,2023-08-11,23:14,8,11,19
24,2023-08-11T23:15:00+10:00,2023-08-11,23:15,5,6,11
24,2023-08-11T23:17:00+10:00,2023-08-11,23:17,7,5,12
24,2023-08-11T23:18:00+10:00,2023-08-11,23:18,6,3,9
24,2023-08-11T23:19:00+10:00,2023-08-11,23:19,3,10,13
24,2023-08-11T23:20:00+10:00,2023-08-11,23:20,1,4,5
24,2023-08-11T23:23:00+10:00,2023-08-11,23:23,3,32,35
27,2023-08-11T23:20:00+10:00,2023-08-11,23:20,3,0,3
35,2023-08-11T23:10:00+10:00,2023-08-11,23:10,6,70,76
35,2023-08-11T23:11:00+10:00,2023-08-11,23:11,6,64,70
35,2023-08-11T23:12:00+10:00,2023-08-11,23:12,6,65,71
35,2023-08-11T23:14:00+10:00,2023-08-11,23:14,14,53,67
35,2023-08-11T23:15:00+10:00,2023-08-11,23:15,4,54,58
35,2023-08-11T23:19:00+10:00,2023-08-11,23:19,7,42,49
35,2023-08-11T23:21:00+10:00,2023-08-11,23:21,10,42,52
35,2023-08-11T23:22:00+10:00,2023-08-11,23:22,8,39,47
35,2023-08-11T23:23:00+10:00,2023-08-11,23:23,5,48,53
35,2023-08-11T23:24:00+10:00,2023-08-11,23:24,4,38,42
53,2023-08-11T23:10:00+10:00,2023-08-11,23:10,0,3,3
53,2023-08-11T23:12:00+10:00,2023-08-11,23:12,4,6,10
53,2023-08-11T23:14:00+10:00,2023-08-11,23:14,1,3,4
53,2023-08-11T23:15:00+10:00,2023-08-11,23:15,0,5,5
53,2023-08-11T23:19:00+10:00,2023-08-11,23:19,3,8,11
53,2023-08-11T23:20:00+10:00,2023-08-11,23:20,0,2,2
53,2023-08-11T23:21:00+10:00,2023-08-11,23:21,3,11,14
53,2023-08-11T23:22:00+10:00,2023-08-11,23:22,2,4,6
53,2023-08-11T23:23:00+10:00,2023-08-11,23:23,1,2,3
56,2023-08-11T23:12:00+10:00,2023-08-11,23:12,4,2,6
56,2023-08-11T23:15:00+10:00,2023-08-11,23:15,1,0,1
56,2023-08-11T23:22:00+10:00,2023-08-11,23:22,6,3,9
57,2023-08-11T23:12:00+10:00,2023-08-11,23:12,0,3,3
58,2023-08-11T23:10:00+10:00,2023-08-11,23:10,5,4,9
58,2023-08-11T23:11:00+10:00,2023-08-11,23:11,13,3,16
58,2023-08-11T23:16:00+10:00,2023-08-11,23:16,9,10,19
58,2023-08-11T23:19:00+10:00,2023-08-11,23:19,2,1,3
58,2023-08-11T23:20:00+10:00,2023-08-11,23:20,2,2,4
58,2023-08-11T23:22:00+10:00,2023-08-11,23:22,4,6,10
58,2023-08-11T23:24:00+10:00,2023-08-11,23:24,1,3,4
62,2023-08-11T23:11:00+10:00,2023-08-11,23:11,1,2,3
62,2023-08-11T23:19:00+10:00,2023-08-11,23:19,4,3,7
62,2023-08-11T23:22:00+10:00,2023-08-11,23:22,5,1,6
63,2023-08-11T23:11:00+10:00,2023-08-11,23:11,3,11,14
63,2023-08-11T23:13:00+10:00,2023-08-11,23:13,4,15,19
63,2023-08-11T23:14:00+10:00,2023-08-11,23:14,1,9,10
63,2023-08-11T23:17:00+10:00,2023-08-11,23:17,11,14,25
63,2023-08-11T23:19:00+10:00,2023-08-11,23:19,3,5,8
63,2023-08-11T23:20:00+10:00,2023-08-11,23:20,5,1,6
63,2023-08-11T23:22:00+10:00,2023-08-11,23:22,2,7,9
67,2023-08-11T23:11:00+10:00,2023-08-11,23:11,6,7,13
67,2023-08-11T23:12:00+10:00,2023-08-11,23:12,9,10,19
67,2023-08-11T23:13:00+10:00,2023-08-11,23:13,2,17,19
67,2023-08-11T23:21:00+10:00,2023-08-11,23:21,6,8,14
67,2023-08-11T23:23:00+10:00,2023-08-11,23:23,0,1,1
68,2023-08-11T23:17:00+10:00,2023-08-11,23:17,4,3,7
72,2023-08-11T23:15:00+10:00,2023-08-11,23:15,3,29,32
72,2023-08-11T23:17:00+10:00,2023-08-11,23:17,9,48,57
72,2023-08-11T23:18:00+10:00,2023-08-11,23:18,6,36,42
72,2023-08-11T23:20:00+10:00,2023-08-11,23:20,3,13,16
72,2023-08-11T23:24:00+10:00,2023-08-11,23:24,6,8,14
76,2023-08-11T23:16:00+10:00,2023-08-11,23:16,1,0,1
79,2023-08-11T23:13:00+10:00,2023-08-11,23:13,5,28,33
79,2023-08-11T23:20:00+10:00,2023-08-11,23:20,5,25,30
79,2023-08-11T23:22:00+10:00,2023-08-11,23:22,4,24,28
79,2023-08-11T23:23:00+10:00,2023-08-11,23:23,5,21,26
79,2023-08-11T23:24:00+10:00,2023-08-11,23:24,14,32,46
85,2023-08-11T23:11:00+10:00,2023-08-11,23:11,0,1,1
85,2023-08-11T23:18:00+10:00,2023-08-11,23:18,1,0,1
85,2023-08-11T23:21:00+10:00,2023-08-11,23:21,0,4,4
86,2023-08-11T23:11:00+10:00,2023-08-11,23:11,1,0,1
86,2023-08-11T23:22:00+10:00,2023-08-11,23:22,0,1,1
109,2023-08-11T23:10:00+10:00,2023-08-11,23:10,5,2,7
117,2023-08-11T23:15:00+10:00,2023-08-11,23:15,21,85,106
117,2023-08-11T23:20:00+10:00,2023-08-11,23:20,22,37,59
122,2023-08-11T23:14:00+10:00,2023-08-11,23:14,0,5,5
122,2023-08-11T23:18:00+10:00,2023-08-11,23:18,0,1,1
122,2023-08-11T23:19:00+10:00,2023-08-11,23:19,0,1,1
122,2023-08-11T23:23:00+10:00,2023-08-11,23:23,0,4,4
3,2023-08-11T23:34:00+10:00,2023-08-11,23:34,1,9,10
3,2023-08-11T23:35:00+10:00,2023-08-11,23:35,9,11,20
4,2023-08-11T23:27:00+10:00,2023-08-11,23:27,21,19,40
4,2023-08-11T23:29:00+10:00,2023-08-11,23:29,13,5,18
4,2023-08-11T23:30:00+10:00,2023-08-11,23:30,9,8,17
4,2023-08-11T23:31:00+10:00,2023-08-11,23:31,10,13,23
4,2023-08-11T23:35:00+10:00,2023-08-11,23:35,11,11,22
4,2023-08-11T23:37:00+10:00,2023-08-11,23:37,16,8,24
6,2023-08-11T23:25:00+10:00,2023-08-11,23:25,7,1,8
6,2023-08-11T23:26:00+10:00,2023-08-11,23:26,3,12,15
6,2023-08-11T23:30:00+10:00,2023-08-11,23:30,1,5,6
6,2023-08-11T23:31:00+10:00,2023-08-11,23:31,3,4,7
6,2023-08-11T23:32:00+10:00,2023-08-11,23:32,2,3,5
6,2023-08-11T23:33:00+10:00,2023-08-11,23:33,8,6,14
6,2023-08-11T23:35:00+10:00,2023-08-11,23:35,27,7,34
6,2023-08-11T23:36:00+10:00,2023-08-11,23:36,5,2,7
6,2023-08-11T23:37:00+10:00,2023-08-11,23:37,7,12,19
6,2023-08-11T23:39:00+10:00,2023-08-11,23:39,9,4,13
8,2023-08-11T23:31:00+10:00,2023-08-11,23:31,2,1,3
8,2023-08-11T23:35:00+10:00,2023-08-11,23:35,0,1,1
8,2023-08-11T23:38:00+10:00,2023-08-11,23:38,0,4,4
14,2023-08-11T23:29:00+10:00,2023-08-11,23:29,2,0,2
14,2023-08-11T23:30:00+10:00,2023-08-11,23:30,5,2,7
14,2023-08-11T23:33:00+10:00,2023-08-11,23:33,4,2,6
14,2023-08-11T23:39:00+10:00,2023-08-11,23:39,18,4,22
21,2023-08-11T23:30:00+10:00,2023-08-11,23:30,6,6,12
21,2023-08-11T23:31:00+10:00,2023-08-11,23:31,3,5,8
21,2023-08-11T23:38:00+10:00,2023-08-11,23:38,6,1,7
21,2023-08-11T23:39:00+10:00,2023-08-11,23:39,6,0,6
28,2023-08-11T23:25:00+10:00,2023-08-11,23:25,2,0,2
28,2023-08-11T23:27:00+10:00,2023-08-11,23:27,2,1,3
28,2023-08-11T23:28:00+10:00,2023-08-11,23:28,6,2,8
28,2023-08-11T23:31:00+10:00,2023-08-11,23:31,3,6,9
28,2023-08-11T23:33:00+10:00,2023-08-11,23:33,4,0,4
28,2023-08-11T23:35:00+10:00,2023-08-11,23:35,10,0,10
28,2023-08-11T23:36:00+10:00,2023-08-11,23:36,2,6,8
28,2023-08-11T23:38:00+10:00,2023-08-11,23:38,2,3,5
28,2023-08-11T23:39:00+10:00,2023-08-11,23:39,2,0,2
29,2023-08-11T23:25:00+10:00,2023-08-11,23:25,0,7,7
29,2023-08-11T23:27:00+10:00,2023-08-11,23:27,0,2,2
29,2023-08-11T23:35:00+10:00,2023-08-11,23:35,3,0,3
29,2023-08-11T23:36:00+10:00,2023-08-11,23:36,0,2,2
29,2023-08-11T23:38:00+10:00,2023-08-11,23:38,0,2,2
39,2023-08-11T23:29:00+10:00,2023-08-11,23:29,1,0,1
39,2023-08-11T23:30:00+10:00,2023-08-11,23:30,1,1,2
39,2023-08-11T23:33:00+10:00,2023-08-11,23:33,1,1,2
41,2023-08-11T23:25:00+10:00,2023-08-11,23:25,9,11,20
41,2023-08-11T23:26:00+10:00,2023-08-11,23:26,9,10,19
41,2023-08-11T23:29:00+10:00,2023-08-11,23:29,17,16,33
41,2023-08-11T23:31:00+10:00,2023-08-11,23:31,17,11,28
54,2023-08-11T23:39:00+10:00,2023-08-11,23:39,1,0,1
55,2023-08-11T23:25:00+10:00,2023-08-11,23:25,0,12,12
55,2023-08-11T23:29:00+10:00,2023-08-11,23:29,11,4,15
55,2023-08-11T23:33:00+10:00,2023-08-11,23:33,17,6,23
59,2023-08-11T23:30:00+10:00,2023-08-11,23:30,33,13,46
61,2023-08-11T23:26:00+10:00,2023-08-11,23:26,5,1,6
61,2023-08-11T23:29:00+10:00,2023-08-11,23:29,3,0,3
61,2023-08-11T23:30:00+10:00,2023-08-11,23:30,2,0,2
61,2023-08-11T23:35:00+10:00,2023-08-11,23:35,7,0,7
65,2023-08-11T23:29:00+10:00,2023-08-11,23:29,5,4,9
65,2023-08-11T23:32:00+10:00,2023-08-11,23:32,2,1,3
65,2023-08-11T23:35:00+10:00,2023-08-11,23:35,5,1,6
65,2023-08-11T23:37:00+10:00,2023-08-11,23:37,1,2,3
65,2023-08-11T23:39:00+10:00,2023-08-11,23:39,0,13,13
66,2023-08-11T23:25:00+10:00,2023-08-11,23:25,3,5,8
66,2023-08-11T23:32:00+10:00,2023-08-11,23:32,5,7,12
66,2023-08-11T23:34:00+10:00,2023-08-11,23:34,4,1,5
66,2023-08-11T23:35:00+10:00,2023-08-11,23:35,1,15,16
66,2023-08-11T23:36:00+10:00,2023-08-11,23:36,7,6,13
66,2023-08-11T23:38:00+10:00,2023-08-11,23:38,1,10,11
69,2023-08-11T23:27:00+10:00,2023-08-11,23:27,1,0,1
69,2023-08-11T23:32:00+10:00,2023-08-11,23:32,1,0,1
69,2023-08-11T23:35:00+10:00,2023-08-11,23:35,2,0,2
69,2023-08-11T23:38:00+10:00,2023-08-11,23:38,2,1,3
75,2023-08-11T23:33:00+10:00,2023-08-11,23:33,0,3,3
77,2023-08-11T23:32:00+10:00,2023-08-11,23:32,2,0,2
77,2023-08-11T23:33:00+10:00,2023-08-11,23:33,0,1,1
77,2023-08-11T23:34:00+10:00,2023-08-11,23:34,1,1,2
77,2023-08-11T23:36:00+10:00,2023-08-11,23:36,0,2,2
77,2023-08-11T23:37:00+10:00,2023-08-11,23:37,1,0,1
84,2023-08-11T23:35:00+10:00,2023-08-11,23:35,37,71,108
87,2023-08-11T23:27:00+10:00,2023-08-11,23:27,1,0,1
107,2023-08-11T23:25:00+10:00,2023-08-11,23:25,3,7,10
107,2023-08-11T23:30:00+10:00,2023-08-11,23:30,0,2,2
118,2023-08-11T23:25:00+10:00,2023-08-11,23:25,2,0,2
118,2023-08-11T23:35:00+10:00,2023-08-11,23:35,5,0,5
1,2023-08-11T23:26:00+10:00,2023-08-11,23:26,1,0,1
1,2023-08-11T23:32:00+10:00,2023-08-11,23:32,1,2,3
1,2023-08-11T23:33:00+10:00,2023-08-11,23:33,3,1,4
1,2023-08-11T23:34:00+10:00,2023-08-11,23:34,2,2,4
1,2023-08-11T23:35:00+10:00,2023-08-11,23:35,1,1,2
1,2023-08-11T23:37:00+10:00,2023-08-11,23:37,4,10,14
1,2023-08-11T23:39:00+10:00,2023-08-11,23:39,1,8,9
2,2023-08-11T23:25:00+10:00,2023-08-11,23:25,0,15,15
2,2023-08-11T23:38:00+10:00,2023-08-11,23:38,0,2,2
7,2023-08-11T23:30:00+10:00,2023-08-11,23:30,0,14,14
7,2023-08-11T23:38:00+10:00,2023-08-11,23:38,0,15,15
7,2023-08-11T23:39:00+10:00,2023-08-11,23:39,1,8,9
9,2023-08-11T23:25:00+10:00,2023-08-11,23:25,2,0,2
9,2023-08-11T23:30:00+10:00,2023-08-11,23:30,0,4,4
9,2023-08-11T23:31:00+10:00,2023-08-11,23:31,0,1,1
9,2023-08-11T23:37:00+10:00,2023-08-11,23:37,2,2,4
9,2023-08-11T23:38:00+10:00,2023-08-11,23:38,1,0,1
11,2023-08-11T23:25:00+10:00,2023-08-11,23:25,0,2,2
11,2023-08-11T23:26:00+10:00,2023-08-11,23:26,0,2,2
11,2023-08-11T23:34:00+10:00,2023-08-11,23:34,3,0,3
11,2023-08-11T23:35:00+10:00,2023-08-11,23:35,1,0,1
12,2023-08-11T23:30:00+10:00,2023-08-11,23:30,0,1,1
12,2023-08-11T23:33:00+10:00,2023-08-11,23:33,1,0,1
12,2023-08-11T23:34:00+10:00,2023-08-11,23:34,4,0,4
12,2023-08-11T23:37:00+10:00,2023-08-11,23:37,0,1,1
12,2023-08-11T23:38:00+10:00,2023-08-11,23:38,0,3,3
17,2023-08-11T23:26:00+10:00,2023-08-11,23:26,0,1,1
17,2023-08-11T23:27:00+10:00,2023-08-11,23:27,5,0,5
17,2023-08-11T23:28:00+10:00,2023-08-11,23:28,1,0,1
17,2023-08-11T23:31:00+10:00,2023-08-11,23:31,3,7,10
17,2023-08-11T23:35:00+10:00,2023-08-11,23:35,2,3,5
17,2023-08-11T23:37:00+10:00,2023-08-11,23:37,2,0,2
18,2023-08-11T23:28:00+10:00,2023-08-11,23:28,0,2,2
18,2023-08-11T23:33:00+10:00,2023-08-11,23:33,1,1,2
24,2023-08-11T23:25:00+10:00,2023-08-11,23:25,3,10,13
24,2023-08-11T23:26:00+10:00,2023-08-11,23:26,1,7,8
24,2023-08-11T23:27:00+10:00,2023-08-11,23:27,3,8,11
24,2023-08-11T23:30:00+10:00,2023-08-11,23:30,5,28,33
24,2023-08-11T23:33:00+10:00,2023-08-11,23:33,6,21,27
24,2023-08-11T23:37:00+10:00,2023-08-11,23:37,10,1,11
24,2023-08-11T23:38:00+10:00,2023-08-11,23:38,8,6,14
27,2023-08-11T23:26:00+10:00,2023-08-11,23:26,1,0,1
27,2023-08-11T23:33:00+10:00,2023-08-11,23:33,0,1,1
35,2023-08-11T23:26:00+10:00,2023-08-11,23:26,12,46,58
35,2023-08-11T23:29:00+10:00,2023-08-11,23:29,9,30,39
35,2023-08-11T23:30:00+10:00,2023-08-11,23:30,6,26,32
35,2023-08-11T23:34:00+10:00,2023-08-11,23:34,4,10,14
35,2023-08-11T23:35:00+10:00,2023-08-11,23:35,5,13,18
35,2023-08-11T23:36:00+10:00,2023-08-11,23:36,6,15,21
35,2023-08-11T23:37:00+10:00,2023-08-11,23:37,3,17,20
35,2023-08-11T23:39:00+10:00,2023-08-11,23:39,5,20,25
53,2023-08-11T23:32:00+10:00,2023-08-11,23:32,5,0,5
53,2023-08-11T23:36:00+10:00,2023-08-11,23:36,0,1,1
56,2023-08-11T23:28:00+10:00,2023-08-11,23:28,1,0,1
56,2023-08-11T23:29:00+10:00,2023-08-11,23:29,1,1,2
56,2023-08-11T23:31:00+10:00,2023-08-11,23:31,5,2,7
56,2023-08-11T23:33:00+10:00,2023-08-11,23:33,0,1,1
56,2023-08-11T23:34:00+10:00,2023-08-11,23:34,4,2,6
56,2023-08-11T23:35:00+10:00,2023-08-11,23:35,3,0,3
56,2023-08-11T23:37:00+10:00,2023-08-11,23:37,0,1,1
57,2023-08-11T23:37:00+10:00,2023-08-11,23:37,0,2,2
58,2023-08-11T23:25:00+10:00,2023-08-11,23:25,1,2,3
58,2023-08-11T23:26:00+10:00,2023-08-11,23:26,5,0,5
58,2023-08-11T23:27:00+10:00,2023-08-11,23:27,9,3,12
58,2023-08-11T23:30:00+10:00,2023-08-11,23:30,2,7,9
58,2023-08-11T23:31:00+10:00,2023-08-11,23:31,4,2,6
58,2023-08-11T23:36:00+10:00,2023-08-11,23:36,3,4,7
58,2023-08-11T23:37:00+10:00,2023-08-11,23:37,8,1,9
62,2023-08-11T23:28:00+10:00,2023-08-11,23:28,5,3,8
62,2023-08-11T23:38:00+10:00,2023-08-11,23:38,0,8,8
63,2023-08-11T23:25:00+10:00,2023-08-11,23:25,7,2,9
63,2023-08-11T23:27:00+10:00,2023-08-11,23:27,0,8,8
63,2023-08-11T23:32:00+10:00,2023-08-11,23:32,5,7,12
63,2023-08-11T23:38:00+10:00,2023-08-11,23:38,1,2,3
67,2023-08-11T23:26:00+10:00,2023-08-11,23:26,0,7,7
67,2023-08-11T23:28:00+10:00,2023-08-11,23:28,4,7,11
67,2023-08-11T23:30:00+10:00,2023-08-11,23:30,1,10,11
67,2023-08-11T23:31:00+10:00,2023-08-11,23:31,0,1,1
67,2023-08-11T23:33:00+10:00,2023-08-11,23:33,0,3,3
67,2023-08-11T23:38:00+10:00,2023-08-11,23:38,1,6,7
68,2023-08-11T23:27:00+10:00,2023-08-11,23:27,1,0,1
68,2023-08-11T23:29:00+10:00,2023-08-11,23:29,2,0,2
68,2023-08-11T23:30:00+10:00,2023-08-11,23:30,1,0,1
68,2023-08-11T23:36:00+10:00,2023-08-11,23:36,3,0,3
72,2023-08-11T23:26:00+10:00,2023-08-11,23:26,1,14,15
72,2023-08-11T23:27:00+10:00,2023-08-11,23:27,5,9,14
72,2023-08-11T23:33:00+10:00,2023-08-11,23:33,1,5,6
72,2023-08-11T23:36:00+10:00,2023-08-11,23:36,8,16,24
72,2023-08-11T23:37:00+10:00,2023-08-11,23:37,4,3,7
72,2023-08-11T23:39:00+10:00,2023-08-11,23:39,1,1,2
79,2023-08-11T23:30:00+10:00,2023-08-11,23:30,8,17,25
79,2023-08-11T23:31:00+10:00,2023-08-11,23:31,3,13,16
79,2023-08-11T23:33:00+10:00,2023-08-11,23:33,0,10,10
79,2023-08-11T23:35:00+10:00,2023-08-11,23:35,12,5,17
79,2023-08-11T23:39:00+10:00,2023-08-11,23:39,0,12,12
85,2023-08-11T23:31:00+10:00,2023-08-11,23:31,1,1,2
86,2023-08-11T23:32:00+10:00,2023-08-11,23:32,0,2,2
109,2023-08-11T23:25:00+10:00,2023-08-11,23:25,1,4,5
117,2023-08-11T23:30:00+10:00,2023-08-11,23:30,5,27,32
122,2023-08-11T23:37:00+10:00,2023-08-11,23:37,0,1,1
122,2023-08-11T23:39:00+10:00,2023-08-11,23:39,0,1,1
3,2023-08-12T00:30:00+10:00,2023-08-12,00:30,4,4,8
3,2023-08-12T00:31:00+10:00,2023-08-12,00:31,19,3,22
3,2023-08-12T00:33:00+10:00,2023-08-12,00:33,0,7,7
3,2023-08-12T00:35:00+10:00,2023-08-12,00:35,3,9,12
3,2023-08-12T00:37:00+10:00,2023-08-12,00:37,3,11,14
4,2023-08-12T00:31:00+10:00,2023-08-12,00:31,0,4,4
4,2023-08-12T00:32:00+10:00,2023-08-12,00:32,4,8,12
4,2023-08-12T00:36:00+10:00,2023-08-12,00:36,1,2,3
6,2023-08-12T00:26:00+10:00,2023-08-12,00:26,3,1,4
6,2023-08-12T00:27:00+10:00,2023-08-12,00:27,3,2,5
6,2023-08-12T00:28:00+10:00,2023-08-12,00:28,6,1,7
6,2023-08-12T00:29:00+10:00,2023-08-12,00:29,2,1,3
6,2023-08-12T00:32:00+10:00,2023-08-12,00:32,9,5,14
6,2023-08-12T00:34:00+10:00,2023-08-12,00:34,4,0,4
8,2023-08-12T00:27:00+10:00,2023-08-12,00:27,0,2,2
14,2023-08-12T00:31:00+10:00,2023-08-12,00:31,8,0,8
14,2023-08-12T00:35:00+10:00,2023-08-12,00:35,2,0,2
14,2023-08-12T00:38:00+10:00,2023-08-12,00:38,5,0,5
14,2023-08-12T00:39:00+10:00,2023-08-12,00:39,1,0,1
21,2023-08-12T00:26:00+10:00,2023-08-12,00:26,7,5,12
21,2023-08-12T00:27:00+10:00,2023-08-12,00:27,6,5,11
21,2023-08-12T00:31:00+10:00,2023-08-12,00:31,7,7,14
21,2023-08-12T00:39:00+10:00,2023-08-12,00:39,6,3,9
28,2023-08-12T00:25:00+10:00,2023-08-12,00:25,0,1,1
28,2023-08-12T00:27:00+10:00,2023-08-12,00:27,2,1,3
28,2023-08-12T00:28:00+10:00,2023-08-12,00:28,4,0,4
29,2023-08-12T00:26:00+10:00,2023-08-12,00:26,3,4,7
29,2023-08-12T00:31:00+10:00,2023-08-12,00:31,3,0,3
29,2023-08-12T00:39:00+10:00,2023-08-12,00:39,3,0,3
39,2023-08-12T00:25:00+10:00,2023-08-12,00:25,0,4,4
39,2023-08-12T00:35:00+10:00,2023-08-12,00:35,0,1,1
41,2023-08-12T00:26:00+10:00,2023-08-12,00:26,7,14,21
41,2023-08-12T00:27:00+10:00,2023-08-12,00:27,6,15,21
55,2023-08-12T00:30:00+10:00,2023-08-12,00:30,3,3,6
55,2023-08-12T00:31:00+10:00,2023-08-12,00:31,9,6,15
55,2023-08-12T00:34:00+10:00,2023-08-12,00:34,5,3,8
55,2023-08-12T00:35:00+10:00,2023-08-12,00:35,2,2,4
55,2023-08-12T00:36:00+10:00,2023-08-12,00:36,13,2,15
55,2023-08-12T00:37:00+10:00,2023-08-12,00:37,6,8,14
59,2023-08-12T00:25:00+10:00,2023-08-12,00:25,4,6,10
61,2023-08-12T00:26:00+10:00,2023-08-12,00:26,0,2,2
61,2023-08-12T00:33:00+10:00,2023-08-12,00:33,4,0,4
61,2023-08-12T00:35:00+10:00,2023-08-12,00:35,1,0,1
61,2023-08-12T00:39:00+10:00,2023-08-12,00:39,0,1,1
65,2023-08-12T00:26:00+10:00,2023-08-12,00:26,0,5,5
65,2023-08-12T00:28:00+10:00,2023-08-12,00:28,2,1,3
65,2023-08-12T00:29:00+10:00,2023-08-12,00:29,1,8,9
65,2023-08-12T00:35:00+10:00,2023-08-12,00:35,0,7,7
65,2023-08-12T00:37:00+10:00,2023-08-12,00:37,0,2,2
66,2023-08-12T00:30:00+10:00,2023-08-12,00:30,0,3,3
66,2023-08-12T00:32:00+10:00,2023-08-12,00:32,0,5,5
66,2023-08-12T00:35:00+10:00,2023-08-12,00:35,1,2,3
66,2023-08-12T00:36:00+10:00,2023-08-12,00:36,3,2,5
66,2023-08-12T00:37:00+10:00,2023-08-12,00:37,2,1,3
69,2023-08-12T00:33:00+10:00,2023-08-12,00:33,0,2,2
69,2023-08-12T00:37:00+10:00,2023-08-12,00:37,1,0,1
70,2023-08-12T00:33:00+10:00,2023-08-12,00:33,0,1,1
75,2023-08-12T00:36:00+10:00,2023-08-12,00:36,0,1,1
77,2023-08-12T00:31:00+10:00,2023-08-12,00:31,0,1,1
77,2023-08-12T00:32:00+10:00,2023-08-12,00:32,0,1,1
77,2023-08-12T00:37:00+10:00,2023-08-12,00:37,0,1,1
77,2023-08-12T00:38:00+10:00,2023-08-12,00:38,1,2,3
78,2023-08-12T00:29:00+10:00,2023-08-12,00:29,0,2,2
78,2023-08-12T00:32:00+10:00,2023-08-12,00:32,0,1,1
84,2023-08-12T00:30:00+10:00,2023-08-12,00:30,7,18,25
87,2023-08-12T00:29:00+10:00,2023-08-12,00:29,1,1,2
87,2023-08-12T00:30:00+10:00,2023-08-12,00:30,1,0,1
107,2023-08-12T00:35:00+10:00,2023-08-12,00:35,1,3,4
108,2023-08-12T00:32:00+10:00,2023-08-12,00:32,0,2,2
108,2023-08-12T00:34:00+10:00,2023-08-12,00:34,0,2,2
118,2023-08-12T00:25:00+10:00,2023-08-12,00:25,0,2,2
1,2023-08-12T00:28:00+10:00,2023-08-12,00:28,1,0,1
1,2023-08-12T00:32:00+10:00,2023-08-12,00:32,1,2,3
1,2023-08-12T00:33:00+10:00,2023-08-12,00:33,1,1,2
1,2023-08-12T00:34:00+10:00,2023-08-12,00:34,0,4,4
1,2023-08-12T00:36:00+10:00,2023-08-12,00:36,0,2,2
1,2023-08-12T00:37:00+10:00,2023-08-12,00:37,3,0,3
1,2023-08-12T00:39:00+10:00,2023-08-12,00:39,0,2,2
2,2023-08-12T00:29:00+10:00,2023-08-12,00:29,1,0,1
2,2023-08-12T00:35:00+10:00,2023-08-12,00:35,0,4,4
2,2023-08-12T00:38:00+10:00,2023-08-12,00:38,0,3,3
7,2023-08-12T00:25:00+10:00,2023-08-12,00:25,0,1,1
7,2023-08-12T00:37:00+10:00,2023-08-12,00:37,0,1,1
9,2023-08-12T00:27:00+10:00,2023-08-12,00:27,0,1,1
9,2023-08-12T00:34:00+10:00,2023-08-12,00:34,1,2,3
10,2023-08-12T00:26:00+10:00,2023-08-12,00:26,0,2,2
10,2023-08-12T00:27:00+10:00,2023-08-12,00:27,1,3,4
10,2023-08-12T00:32:00+10:00,2023-08-12,00:32,0,2,2
10,2023-08-12T00:33:00+10:00,2023-08-12,00:33,0,1,1
10,2023-08-12T00:35:00+10:00,2023-08-12,00:35,1,0,1
10,2023-08-12T00:36:00+10:00,2023-08-12,00:36,1,0,1
10,2023-08-12T00:37:00+10:00,2023-08-12,00:37,1,0,1
11,2023-08-12T00:30:00+10:00,2023-08-12,00:30,3,0,3
12,2023-08-12T00:27:00+10:00,2023-08-12,00:27,2,0,2
12,2023-08-12T00:29:00+10:00,2023-08-12,00:29,0,1,1
12,2023-08-12T00:34:00+10:00,2023-08-12,00:34,5,0,5
12,2023-08-12T00:35:00+10:00,2023-08-12,00:35,1,0,1
17,2023-08-12T00:32:00+10:00,2023-08-12,00:32,0,5,5
17,2023-08-12T00:33:00+10:00,2023-08-12,00:33,1,0,1
17,2023-08-12T00:39:00+10:00,2023-08-12,00:39,0,2,2
24,2023-08-12T00:30:00+10:00,2023-08-12,00:30,0,1,1
24,2023-08-12T00:36:00+10:00,2023-08-12,00:36,3,1,4
27,2023-08-12T00:28:00+10:00,2023-08-12,00:28,1,0,1
27,2023-08-12T00:29:00+10:00,2023-08-12,00:29,0,1,1
27,2023-08-12T00:30:00+10:00,2023-08-12,00:30,1,0,1
27,2023-08-12T00:34:00+10:00,2023-08-12,00:34,2,0,2
27,2023-08-12T00:35:00+10:00,2023-08-12,00:35,1,3,4
27,2023-08-12T00:36:00+10:00,2023-08-12,00:36,1,0,1
27,2023-08-12T00:37:00+10:00,2023-08-12,00:37,1,0,1
35,2023-08-12T00:28:00+10:00,2023-08-12,00:28,13,1,14
35,2023-08-12T00:29:00+10:00,2023-08-12,00:29,8,12,20
35,2023-08-12T00:30:00+10:00,2023-08-12,00:30,3,8,11
35,2023-08-12T00:38:00+10:00,2023-08-12,00:38,0,12,12
53,2023-08-12T00:29:00+10:00,2023-08-12,00:29,0,5,5
53,2023-08-12T00:31:00+10:00,2023-08-12,00:31,2,1,3
56,2023-08-12T00:29:00+10:00,2023-08-12,00:29,1,0,1
56,2023-08-12T00:30:00+10:00,2023-08-12,00:30,6,0,6
56,2023-08-12T00:38:00+10:00,2023-08-12,00:38,1,2,3
57,2023-08-12T00:27:00+10:00,2023-08-12,00:27,0,1,1
57,2023-08-12T00:29:00+10:00,2023-08-12,00:29,0,2,2
58,2023-08-12T00:29:00+10:00,2023-08-12,00:29,1,2,3
62,2023-08-12T00:25:00+10:00,2023-08-12,00:25,2,2,4
62,2023-08-12T00:28:00+10:00,2023-08-12,00:28,0,4,4
62,2023-08-12T00:31:00+10:00,2023-08-12,00:31,2,2,4
62,2023-08-12T00:34:00+10:00,2023-08-12,00:34,1,0,1
62,2023-08-12T00:39:00+10:00,2023-08-12,00:39,2,1,3
63,2023-08-12T00:25:00+10:00,2023-08-12,00:25,7,5,12
63,2023-08-12T00:26:00+10:00,2023-08-12,00:26,2,0,2
63,2023-08-12T00:27:00+10:00,2023-08-12,00:27,6,6,12
63,2023-08-12T00:28:00+10:00,2023-08-12,00:28,4,3,7
63,2023-08-12T00:30:00+10:00,2023-08-12,00:30,1,3,4
63,2023-08-12T00:31:00+10:00,2023-08-12,00:31,1,4,5
63,2023-08-12T00:34:00+10:00,2023-08-12,00:34,1,4,5
63,2023-08-12T00:35:00+10:00,2023-08-12,00:35,5,4,9
67,2023-08-12T00:26:00+10:00,2023-08-12,00:26,4,2,6
67,2023-08-12T00:28:00+10:00,2023-08-12,00:28,2,5,7
67,2023-08-12T00:32:00+10:00,2023-08-12,00:32,0,6,6
67,2023-08-12T00:35:00+10:00,2023-08-12,00:35,2,4,6
68,2023-08-12T00:29:00+10:00,2023-08-12,00:29,1,0,1
72,2023-08-12T00:36:00+10:00,2023-08-12,00:36,4,2,6
76,2023-08-12T00:34:00+10:00,2023-08-12,00:34,1,0,1
79,2023-08-12T00:33:00+10:00,2023-08-12,00:33,0,4,4
79,2023-08-12T00:36:00+10:00,2023-08-12,00:36,6,1,7
86,2023-08-12T00:34:00+10:00,2023-08-12,00:34,0,1,1
86,2023-08-12T00:37:00+10:00,2023-08-12,00:37,0,1,1
109,2023-08-12T00:35:00+10:00,2023-08-12,00:35,0,3,3
122,2023-08-12T00:31:00+10:00,2023-08-12,00:31,1,0,1
3,2023-08-12T00:11:00+10:00,2023-08-12,00:11,14,3,17
3,2023-08-12T00:14:00+10:00,2023-08-12,00:14,9,3,12
3,2023-08-12T00:19:00+10:00,2023-08-12,00:19,14,10,24
3,2023-08-12T00:21:00+10:00,2023-08-12,00:21,2,8,10
3,2023-08-12T00:23:00+10:00,2023-08-12,00:23,5,10,15
4,2023-08-12T00:14:00+10:00,2023-08-12,00:14,4,20,24
4,2023-08-12T00:16:00+10:00,2023-08-12,00:16,5,3,8
6,2023-08-12T00:11:00+10:00,2023-08-12,00:11,3,2,5
6,2023-08-12T00:13:00+10:00,2023-08-12,00:13,7,7,14
6,2023-08-12T00:16:00+10:00,2023-08-12,00:16,2,4,6
6,2023-08-12T00:21:00+10:00,2023-08-12,00:21,2,3,5
6,2023-08-12T00:22:00+10:00,2023-08-12,00:22,8,6,14
14,2023-08-12T00:10:00+10:00,2023-08-12,00:10,8,3,11
14,2023-08-12T00:11:00+10:00,2023-08-12,00:11,0,1,1
14,2023-08-12T00:16:00+10:00,2023-08-12,00:16,2,2,4
14,2023-08-12T00:17:00+10:00,2023-08-12,00:17,1,1,2
14,2023-08-12T00:22:00+10:00,2023-08-12,00:22,3,1,4
14,2023-08-12T00:24:00+10:00,2023-08-12,00:24,7,0,7
21,2023-08-12T00:17:00+10:00,2023-08-12,00:17,0,4,4
21,2023-08-12T00:18:00+10:00,2023-08-12,00:18,1,8,9
21,2023-08-12T00:19:00+10:00,2023-08-12,00:19,0,5,5
21,2023-08-12T00:22:00+10:00,2023-08-12,00:22,0,9,9
21,2023-08-12T00:24:00+10:00,2023-08-12,00:24,0,1,1
28,2023-08-12T00:11:00+10:00,2023-08-12,00:11,4,0,4
29,2023-08-12T00:13:00+10:00,2023-08-12,00:13,1,0,1
29,2023-08-12T00:15:00+10:00,2023-08-12,00:15,2,1,3
29,2023-08-12T00:18:00+10:00,2023-08-12,00:18,1,5,6
29,2023-08-12T00:22:00+10:00,2023-08-12,00:22,1,1,2
29,2023-08-12T00:24:00+10:00,2023-08-12,00:24,0,1,1
39,2023-08-12T00:15:00+10:00,2023-08-12,00:15,0,3,3
39,2023-08-12T00:22:00+10:00,2023-08-12,00:22,2,0,2
41,2023-08-12T00:20:00+10:00,2023-08-12,00:20,2,11,13
54,2023-08-12T00:12:00+10:00,2023-08-12,00:12,0,2,2
54,2023-08-12T00:17:00+10:00,2023-08-12,00:17,0,1,1
55,2023-08-12T00:11:00+10:00,2023-08-12,00:11,5,10,15
55,2023-08-12T00:12:00+10:00,2023-08-12,00:12,7,8,15
55,2023-08-12T00:14:00+10:00,2023-08-12,00:14,3,7,10
55,2023-08-12T00:15:00+10:00,2023-08-12,00:15,3,10,13
55,2023-08-12T00:18:00+10:00,2023-08-12,00:18,5,4,9
55,2023-08-12T00:23:00+10:00,2023-08-12,00:23,4,6,10
61,2023-08-12T00:14:00+10:00,2023-08-12,00:14,5,0,5
61,2023-08-12T00:19:00+10:00,2023-08-12,00:19,2,1,3
61,2023-08-12T00:22:00+10:00,2023-08-12,00:22,3,4,7
61,2023-08-12T00:24:00+10:00,2023-08-12,00:24,1,0,1
65,2023-08-12T00:20:00+10:00,2023-08-12,00:20,1,2,3
65,2023-08-12T00:21:00+10:00,2023-08-12,00:21,0,5,5
66,2023-08-12T00:11:00+10:00,2023-08-12,00:11,4,3,7
66,2023-08-12T00:14:00+10:00,2023-08-12,00:14,6,1,7
66,2023-08-12T00:15:00+10:00,2023-08-12,00:15,5,5,10
66,2023-08-12T00:20:00+10:00,2023-08-12,00:20,2,0,2
66,2023-08-12T00:22:00+10:00,2023-08-12,00:22,1,0,1
66,2023-08-12T00:24:00+10:00,2023-08-12,00:24,1,3,4
70,2023-08-12T00:21:00+10:00,2023-08-12,00:21,1,0,1
75,2023-08-12T00:20:00+10:00,2023-08-12,00:20,0,1,1
75,2023-08-12T00:24:00+10:00,2023-08-12,00:24,1,0,1
77,2023-08-12T00:10:00+10:00,2023-08-12,00:10,0,1,1
78,2023-08-12T00:16:00+10:00,2023-08-12,00:16,1,0,1
84,2023-08-12T00:15:00+10:00,2023-08-12,00:15,15,25,40
87,2023-08-12T00:17:00+10:00,2023-08-12,00:17,0,1,1
87,2023-08-12T00:24:00+10:00,2023-08-12,00:24,0,1,1
107,2023-08-12T00:10:00+10:00,2023-08-12,00:10,4,1,5
108,2023-08-12T00:15:00+10:00,2023-08-12,00:15,0,1,1
108,2023-08-12T00:16:00+10:00,2023-08-12,00:16,0,2,2
108,2023-08-12T00:22:00+10:00,2023-08-12,00:22,0,1,1
108,2023-08-12T00:23:00+10:00,2023-08-12,00:23,0,2,2
1,2023-08-12T00:13:00+10:00,2023-08-12,00:13,0,1,1
1,2023-08-12T00:15:00+10:00,2023-08-12,00:15,7,1,8
1,2023-08-12T00:16:00+10:00,2023-08-12,00:16,3,0,3
1,2023-08-12T00:18:00+10:00,2023-08-12,00:18,1,1,2
2,2023-08-12T00:10:00+10:00,2023-08-12,00:10,0,1,1
2,2023-08-12T00:12:00+10:00,2023-08-12,00:12,1,0,1
2,2023-08-12T00:15:00+10:00,2023-08-12,00:15,0,3,3
2,2023-08-12T00:20:00+10:00,2023-08-12,00:20,0,2,2
7,2023-08-12T00:24:00+10:00,2023-08-12,00:24,0,3,3
11,2023-08-12T00:15:00+10:00,2023-08-12,00:15,0,1,1
12,2023-08-12T00:16:00+10:00,2023-08-12,00:16,6,0,6
17,2023-08-12T00:10:00+10:00,2023-08-12,00:10,0,1,1
17,2023-08-12T00:12:00+10:00,2023-08-12,00:12,0,2,2
17,2023-08-12T00:19:00+10:00,2023-08-12,00:19,2,0,2
17,2023-08-12T00:22:00+10:00,2023-08-12,00:22,0,2,2
24,2023-08-12T00:10:00+10:00,2023-08-12,00:10,3,7,10
24,2023-08-12T00:12:00+10:00,2023-08-12,00:12,3,2,5
24,2023-08-12T00:13:00+10:00,2023-08-12,00:13,7,0,7
24,2023-08-12T00:15:00+10:00,2023-08-12,00:15,6,2,8
24,2023-08-12T00:18:00+10:00,2023-08-12,00:18,3,1,4
24,2023-08-12T00:19:00+10:00,2023-08-12,00:19,0,1,1
24,2023-08-12T00:21:00+10:00,2023-08-12,00:21,2,2,4
27,2023-08-12T00:17:00+10:00,2023-08-12,00:17,1,1,2
27,2023-08-12T00:19:00+10:00,2023-08-12,00:19,1,0,1
35,2023-08-12T00:10:00+10:00,2023-08-12,00:10,6,8,14
35,2023-08-12T00:12:00+10:00,2023-08-12,00:12,7,4,11
35,2023-08-12T00:13:00+10:00,2023-08-12,00:13,5,6,11
35,2023-08-12T00:17:00+10:00,2023-08-12,00:17,5,7,12
35,2023-08-12T00:22:00+10:00,2023-08-12,00:22,5,3,8
53,2023-08-12T00:11:00+10:00,2023-08-12,00:11,0,5,5
53,2023-08-12T00:16:00+10:00,2023-08-12,00:16,0,5,5
56,2023-08-12T00:13:00+10:00,2023-08-12,00:13,1,1,2
56,2023-08-12T00:17:00+10:00,2023-08-12,00:17,1,3,4
56,2023-08-12T00:19:00+10:00,2023-08-12,00:19,3,0,3
57,2023-08-12T00:22:00+10:00,2023-08-12,00:22,0,1,1
58,2023-08-12T00:15:00+10:00,2023-08-12,00:15,2,1,3
58,2023-08-12T00:16:00+10:00,2023-08-12,00:16,2,5,7
58,2023-08-12T00:17:00+10:00,2023-08-12,00:17,2,3,5
58,2023-08-12T00:19:00+10:00,2023-08-12,00:19,7,2,9
58,2023-08-12T00:20:00+10:00,2023-08-12,00:20,1,2,3
58,2023-08-12T00:24:00+10:00,2023-08-12,00:24,2,0,2
62,2023-08-12T00:10:00+10:00,2023-08-12,00:10,1,0,1
62,2023-08-12T00:14:00+10:00,2023-08-12,00:14,11,0,11
62,2023-08-12T00:20:00+10:00,2023-08-12,00:20,0,2,2
62,2023-08-12T00:23:00+10:00,2023-08-12,00:23,3,0,3
63,2023-08-12T00:15:00+10:00,2023-08-12,00:15,4,6,10
63,2023-08-12T00:16:00+10:00,2023-08-12,00:16,3,7,10
63,2023-08-12T00:21:00+10:00,2023-08-12,00:21,0,2,2
67,2023-08-12T00:12:00+10:00,2023-08-12,00:12,0,2,2
67,2023-08-12T00:13:00+10:00,2023-08-12,00:13,0,4,4
67,2023-08-12T00:14:00+10:00,2023-08-12,00:14,4,0,4
67,2023-08-12T00:24:00+10:00,2023-08-12,00:24,0,1,1
68,2023-08-12T00:10:00+10:00,2023-08-12,00:10,1,1,2
68,2023-08-12T00:23:00+10:00,2023-08-12,00:23,3,0,3
72,2023-08-12T00:10:00+10:00,2023-08-12,00:10,0,2,2
72,2023-08-12T00:11:00+10:00,2023-08-12,00:11,0,1,1
72,2023-08-12T00:13:00+10:00,2023-08-12,00:13,0,1,1
72,2023-08-12T00:16:00+10:00,2023-08-12,00:16,1,1,2
72,2023-08-12T00:19:00+10:00,2023-08-12,00:19,1,4,5
72,2023-08-12T00:21:00+10:00,2023-08-12,00:21,5,4,9
72,2023-08-12T00:23:00+10:00,2023-08-12,00:23,0,1,1
79,2023-08-12T00:10:00+10:00,2023-08-12,00:10,3,13,16
79,2023-08-12T00:13:00+10:00,2023-08-12,00:13,5,4,9
79,2023-08-12T00:14:00+10:00,2023-08-12,00:14,2,3,5
86,2023-08-12T00:19:00+10:00,2023-08-12,00:19,1,0,1
109,2023-08-12T00:15:00+10:00,2023-08-12,00:15,0,1,1
122,2023-08-12T00:14:00+10:00,2023-08-12,00:14,1,0,1
122,2023-08-12T00:23:00+10:00,2023-08-12,00:23,0,1,1
3,2023-08-12T00:41:00+10:00,2023-08-12,00:41,10,9,19
3,2023-08-12T00:43:00+10:00,2023-08-12,00:43,1,0,1
3,2023-08-12T00:44:00+10:00,2023-08-12,00:44,2,15,17
4,2023-08-12T00:41:00+10:00,2023-08-12,00:41,0,4,4
4,2023-08-12T00:42:00+10:00,2023-08-12,00:42,1,4,5
4,2023-08-12T00:43:00+10:00,2023-08-12,00:43,2,13,15
4,2023-08-12T00:47:00+10:00,2023-08-12,00:47,1,6,7
4,2023-08-12T00:48:00+10:00,2023-08-12,00:48,5,6,11
4,2023-08-12T00:49:00+10:00,2023-08-12,00:49,11,1,12
4,2023-08-12T00:50:00+10:00,2023-08-12,00:50,0,8,8
4,2023-08-12T00:52:00+10:00,2023-08-12,00:52,0,5,5
6,2023-08-12T00:43:00+10:00,2023-08-12,00:43,3,4,7
6,2023-08-12T00:45:00+10:00,2023-08-12,00:45,3,2,5
6,2023-08-12T00:46:00+10:00,2023-08-12,00:46,1,2,3
6,2023-08-12T00:47:00+10:00,2023-08-12,00:47,0,6,6
6,2023-08-12T00:51:00+10:00,2023-08-12,00:51,6,1,7
14,2023-08-12T00:42:00+10:00,2023-08-12,00:42,1,0,1
14,2023-08-12T00:43:00+10:00,2023-08-12,00:43,4,2,6
14,2023-08-12T00:44:00+10:00,2023-08-12,00:44,2,0,2
14,2023-08-12T00:47:00+10:00,2023-08-12,00:47,1,2,3
14,2023-08-12T00:48:00+10:00,2023-08-12,00:48,2,1,3
21,2023-08-12T00:43:00+10:00,2023-08-12,00:43,0,4,4
21,2023-08-12T00:45:00+10:00,2023-08-12,00:45,3,4,7
28,2023-08-12T00:41:00+10:00,2023-08-12,00:41,6,0,6
28,2023-08-12T00:42:00+10:00,2023-08-12,00:42,1,0,1
28,2023-08-12T00:44:00+10:00,2023-08-12,00:44,1,0,1
28,2023-08-12T00:47:00+10:00,2023-08-12,00:47,3,3,6
29,2023-08-12T00:41:00+10:00,2023-08-12,00:41,0,1,1
29,2023-08-12T00:51:00+10:00,2023-08-12,00:51,0,1,1
29,2023-08-12T00:53:00+10:00,2023-08-12,00:53,0,1,1
39,2023-08-12T00:41:00+10:00,2023-08-12,00:41,0,1,1
39,2023-08-12T00:47:00+10:00,2023-08-12,00:47,0,2,2
41,2023-08-12T00:40:00+10:00,2023-08-12,00:40,8,6,14
41,2023-08-12T00:49:00+10:00,2023-08-12,00:49,4,6,10
41,2023-08-12T00:51:00+10:00,2023-08-12,00:51,1,9,10
41,2023-08-12T00:53:00+10:00,2023-08-12,00:53,3,12,15
54,2023-08-12T00:48:00+10:00,2023-08-12,00:48,5,2,7
54,2023-08-12T00:52:00+10:00,2023-08-12,00:52,0,1,1
55,2023-08-12T00:40:00+10:00,2023-08-12,00:40,4,2,6
55,2023-08-12T00:41:00+10:00,2023-08-12,00:41,7,0,7
55,2023-08-12T00:48:00+10:00,2023-08-12,00:48,14,4,18
55,2023-08-12T00:52:00+10:00,2023-08-12,00:52,3,3,6
59,2023-08-12T00:50:00+10:00,2023-08-12,00:50,12,2,14
61,2023-08-12T00:41:00+10:00,2023-08-12,00:41,0,1,1
61,2023-08-12T00:50:00+10:00,2023-08-12,00:50,2,1,3
61,2023-08-12T00:53:00+10:00,2023-08-12,00:53,1,2,3
65,2023-08-12T00:43:00+10:00,2023-08-12,00:43,2,6,8
65,2023-08-12T00:44:00+10:00,2023-08-12,00:44,4,3,7
65,2023-08-12T00:47:00+10:00,2023-08-12,00:47,0,1,1
65,2023-08-12T00:49:00+10:00,2023-08-12,00:49,0,12,12
66,2023-08-12T00:40:00+10:00,2023-08-12,00:40,1,7,8
66,2023-08-12T00:42:00+10:00,2023-08-12,00:42,1,0,1
66,2023-08-12T00:43:00+10:00,2023-08-12,00:43,0,7,7
66,2023-08-12T00:45:00+10:00,2023-08-12,00:45,1,0,1
66,2023-08-12T00:46:00+10:00,2023-08-12,00:46,6,7,13
66,2023-08-12T00:47:00+10:00,2023-08-12,00:47,3,3,6
66,2023-08-12T00:49:00+10:00,2023-08-12,00:49,1,4,5
70,2023-08-12T00:52:00+10:00,2023-08-12,00:52,0,1,1
75,2023-08-12T00:53:00+10:00,2023-08-12,00:53,0,2,2
77,2023-08-12T00:51:00+10:00,2023-08-12,00:51,2,0,2
77,2023-08-12T00:52:00+10:00,2023-08-12,00:52,0,1,1
84,2023-08-12T00:45:00+10:00,2023-08-12,00:45,20,21,41
87,2023-08-12T00:50:00+10:00,2023-08-12,00:50,1,0,1
108,2023-08-12T00:41:00+10:00,2023-08-12,00:41,0,1,1
108,2023-08-12T00:42:00+10:00,2023-08-12,00:42,2,1,3
108,2023-08-12T00:44:00+10:00,2023-08-12,00:44,1,0,1
118,2023-08-12T00:50:00+10:00,2023-08-12,00:50,0,1,1
1,2023-08-12T00:41:00+10:00,2023-08-12,00:41,0,2,2
1,2023-08-12T00:49:00+10:00,2023-08-12,00:49,1,0,1
1,2023-08-12T00:51:00+10:00,2023-08-12,00:51,2,0,2
1,2023-08-12T00:52:00+10:00,2023-08-12,00:52,1,0,1
1,2023-08-12T00:53:00+10:00,2023-08-12,00:53,6,0,6
2,2023-08-12T00:43:00+10:00,2023-08-12,00:43,0,3,3
7,2023-08-12T00:46:00+10:00,2023-08-12,00:46,0,1,1
7,2023-08-12T00:47:00+10:00,2023-08-12,00:47,1,1,2
7,2023-08-12T00:53:00+10:00,2023-08-12,00:53,1,0,1
9,2023-08-12T00:41:00+10:00,2023-08-12,00:41,0,1,1
9,2023-08-12T00:49:00+10:00,2023-08-12,00:49,0,1,1
10,2023-08-12T00:43:00+10:00,2023-08-12,00:43,4,0,4
11,2023-08-12T00:50:00+10:00,2023-08-12,00:50,0,1,1
17,2023-08-12T00:47:00+10:00,2023-08-12,00:47,1,1,2
17,2023-08-12T00:50:00+10:00,2023-08-12,00:50,1,0,1
18,2023-08-12T00:40:00+10:00,2023-08-12,00:40,0,1,1
24,2023-08-12T00:40:00+10:00,2023-08-12,00:40,1,7,8
24,2023-08-12T00:42:00+10:00,2023-08-12,00:42,1,0,1
24,2023-08-12T00:47:00+10:00,2023-08-12,00:47,2,12,14
24,2023-08-12T00:49:00+10:00,2023-08-12,00:49,0,1,1
24,2023-08-12T00:50:00+10:00,2023-08-12,00:50,0,7,7
24,2023-08-12T00:52:00+10:00,2023-08-12,00:52,1,0,1
24,2023-08-12T00:53:00+10:00,2023-08-12,00:53,3,2,5
24,2023-08-12T00:54:00+10:00,2023-08-12,00:54,2,14,16
27,2023-08-12T00:48:00+10:00,2023-08-12,00:48,1,0,1
35,2023-08-12T00:41:00+10:00,2023-08-12,00:41,1,1,2
35,2023-08-12T00:46:00+10:00,2023-08-12,00:46,2,2,4
53,2023-08-12T00:46:00+10:00,2023-08-12,00:46,0,1,1
56,2023-08-12T00:40:00+10:00,2023-08-12,00:40,0,3,3
56,2023-08-12T00:42:00+10:00,2023-08-12,00:42,0,1,1
56,2023-08-12T00:43:00+10:00,2023-08-12,00:43,6,0,6
58,2023-08-12T00:42:00+10:00,2023-08-12,00:42,1,1,2
58,2023-08-12T00:47:00+10:00,2023-08-12,00:47,2,1,3
58,2023-08-12T00:48:00+10:00,2023-08-12,00:48,3,2,5
58,2023-08-12T00:50:00+10:00,2023-08-12,00:50,8,4,12
62,2023-08-12T00:46:00+10:00,2023-08-12,00:46,1,2,3
62,2023-08-12T00:50:00+10:00,2023-08-12,00:50,0,1,1
62,2023-08-12T00:51:00+10:00,2023-08-12,00:51,0,2,2
63,2023-08-12T00:44:00+10:00,2023-08-12,00:44,0,3,3
63,2023-08-12T00:46:00+10:00,2023-08-12,00:46,2,2,4
63,2023-08-12T00:50:00+10:00,2023-08-12,00:50,1,2,3
63,2023-08-12T00:51:00+10:00,2023-08-12,00:51,3,3,6
63,2023-08-12T00:53:00+10:00,2023-08-12,00:53,0,5,5
67,2023-08-12T00:41:00+10:00,2023-08-12,00:41,2,0,2
67,2023-08-12T00:42:00+10:00,2023-08-12,00:42,1,4,5
67,2023-08-12T00:53:00+10:00,2023-08-12,00:53,0,2,2
68,2023-08-12T00:42:00+10:00,2023-08-12,00:42,1,1,2
68,2023-08-12T00:47:00+10:00,2023-08-12,00:47,1,0,1
72,2023-08-12T00:44:00+10:00,2023-08-12,00:44,1,4,5
72,2023-08-12T00:46:00+10:00,2023-08-12,00:46,0,5,5
72,2023-08-12T00:47:00+10:00,2023-08-12,00:47,0,1,1
72,2023-08-12T00:48:00+10:00,2023-08-12,00:48,0,2,2
72,2023-08-12T00:50:00+10:00,2023-08-12,00:50,0,2,2
72,2023-08-12T00:51:00+10:00,2023-08-12,00:51,0,1,1
72,2023-08-12T00:52:00+10:00,2023-08-12,00:52,0,5,5
79,2023-08-12T00:40:00+10:00,2023-08-12,00:40,4,4,8
79,2023-08-12T00:42:00+10:00,2023-08-12,00:42,4,0,4
79,2023-08-12T00:45:00+10:00,2023-08-12,00:45,6,3,9
79,2023-08-12T00:53:00+10:00,2023-08-12,00:53,2,9,11
85,2023-08-12T00:49:00+10:00,2023-08-12,00:49,0,1,1
86,2023-08-12T00:52:00+10:00,2023-08-12,00:52,0,1,1
86,2023-08-12T00:54:00+10:00,2023-08-12,00:54,0,1,1
109,2023-08-12T00:50:00+10:00,2023-08-12,00:50,2,0,2
117,2023-08-12T00:40:00+10:00,2023-08-12,00:40,8,1,9
117,2023-08-12T00:50:00+10:00,2023-08-12,00:50,5,4,9
122,2023-08-12T00:52:00+10:00,2023-08-12,00:52,1,0,1
122,2023-08-12T00:53:00+10:00,2023-08-12,00:53,0,1,1
3,2023-08-12T00:55:00+10:00,2023-08-12,00:55,7,7,14
3,2023-08-12T00:56:00+10:00,2023-08-12,00:56,3,10,13
3,2023-08-12T00:57:00+10:00,2023-08-12,00:57,9,3,12
3,2023-08-12T01:00:00+10:00,2023-08-12,01:00,7,4,11
3,2023-08-12T01:02:00+10:00,2023-08-12,01:02,2,19,21
3,2023-08-12T01:03:00+10:00,2023-08-12,01:03,4,17,21
3,2023-08-12T01:05:00+10:00,2023-08-12,01:05,3,8,11
3,2023-08-12T01:06:00+10:00,2023-08-12,01:06,2,5,7
4,2023-08-12T01:00:00+10:00,2023-08-12,01:00,6,8,14
4,2023-08-12T01:01:00+10:00,2023-08-12,01:01,7,7,14
4,2023-08-12T01:04:00+10:00,2023-08-12,01:04,1,5,6
6,2023-08-12T00:57:00+10:00,2023-08-12,00:57,2,0,2
6,2023-08-12T00:59:00+10:00,2023-08-12,00:59,2,2,4
6,2023-08-12T01:01:00+10:00,2023-08-12,01:01,7,2,9
8,2023-08-12T00:56:00+10:00,2023-08-12,00:56,2,0,2
8,2023-08-12T01:05:00+10:00,2023-08-12,01:05,0,1,1
14,2023-08-12T00:55:00+10:00,2023-08-12,00:55,5,2,7
14,2023-08-12T00:58:00+10:00,2023-08-12,00:58,0,1,1
14,2023-08-12T01:06:00+10:00,2023-08-12,01:06,0,3,3
14,2023-08-12T01:08:00+10:00,2023-08-12,01:08,0,1,1
21,2023-08-12T01:01:00+10:00,2023-08-12,01:01,2,3,5
21,2023-08-12T01:07:00+10:00,2023-08-12,01:07,3,0,3
28,2023-08-12T01:01:00+10:00,2023-08-12,01:01,1,0,1
29,2023-08-12T01:01:00+10:00,2023-08-12,01:01,1,1,2
29,2023-08-12T01:02:00+10:00,2023-08-12,01:02,0,1,1
39,2023-08-12T00:55:00+10:00,2023-08-12,00:55,0,1,1
39,2023-08-12T00:59:00+10:00,2023-08-12,00:59,0,1,1
39,2023-08-12T01:01:00+10:00,2023-08-12,01:01,1,0,1
41,2023-08-12T00:55:00+10:00,2023-08-12,00:55,4,12,16
41,2023-08-12T00:59:00+10:00,2023-08-12,00:59,2,12,14
41,2023-08-12T01:03:00+10:00,2023-08-12,01:03,4,11,15
41,2023-08-12T01:07:00+10:00,2023-08-12,01:07,0,3,3
41,2023-08-12T01:08:00+10:00,2023-08-12,01:08,2,10,12
41,2023-08-12T01:09:00+10:00,2023-08-12,01:09,10,2,12
54,2023-08-12T00:55:00+10:00,2023-08-12,00:55,0,1,1
54,2023-08-12T00:56:00+10:00,2023-08-12,00:56,2,0,2
54,2023-08-12T01:01:00+10:00,2023-08-12,01:01,5,3,8
54,2023-08-12T01:03:00+10:00,2023-08-12,01:03,0,2,2
54,2023-08-12T01:08:00+10:00,2023-08-12,01:08,0,2,2
55,2023-08-12T00:55:00+10:00,2023-08-12,00:55,3,3,6
55,2023-08-12T00:57:00+10:00,2023-08-12,00:57,2,1,3
55,2023-08-12T00:58:00+10:00,2023-08-12,00:58,1,1,2
55,2023-08-12T00:59:00+10:00,2023-08-12,00:59,8,4,12
55,2023-08-12T01:01:00+10:00,2023-08-12,01:01,4,4,8
55,2023-08-12T01:04:00+10:00,2023-08-12,01:04,1,4,5
55,2023-08-12T01:09:00+10:00,2023-08-12,01:09,4,1,5
59,2023-08-12T00:55:00+10:00,2023-08-12,00:55,7,1,8
61,2023-08-12T00:55:00+10:00,2023-08-12,00:55,3,0,3
61,2023-08-12T00:57:00+10:00,2023-08-12,00:57,1,0,1
61,2023-08-12T00:59:00+10:00,2023-08-12,00:59,3,0,3
61,2023-08-12T01:03:00+10:00,2023-08-12,01:03,2,2,4
61,2023-08-12T01:05:00+10:00,2023-08-12,01:05,0,1,1
65,2023-08-12T00:57:00+10:00,2023-08-12,00:57,4,6,10
65,2023-08-12T00:58:00+10:00,2023-08-12,00:58,2,2,4
65,2023-08-12T00:59:00+10:00,2023-08-12,00:59,0,4,4
65,2023-08-12T01:00:00+10:00,2023-08-12,01:00,0,1,1
65,2023-08-12T01:01:00+10:00,2023-08-12,01:01,0,5,5
65,2023-08-12T01:02:00+10:00,2023-08-12,01:02,0,2,2
65,2023-08-12T01:07:00+10:00,2023-08-12,01:07,4,7,11
66,2023-08-12T00:55:00+10:00,2023-08-12,00:55,6,9,15
66,2023-08-12T00:56:00+10:00,2023-08-12,00:56,10,3,13
66,2023-08-12T01:05:00+10:00,2023-08-12,01:05,1,0,1
66,2023-08-12T01:08:00+10:00,2023-08-12,01:08,4,4,8
69,2023-08-12T01:06:00+10:00,2023-08-12,01:06,3,2,5
70,2023-08-12T00:58:00+10:00,2023-08-12,00:58,0,1,1
77,2023-08-12T01:03:00+10:00,2023-08-12,01:03,0,5,5
77,2023-08-12T01:05:00+10:00,2023-08-12,01:05,0,2,2
107,2023-08-12T00:55:00+10:00,2023-08-12,00:55,6,3,9
108,2023-08-12T00:56:00+10:00,2023-08-12,00:56,0,1,1
108,2023-08-12T00:57:00+10:00,2023-08-12,00:57,1,1,2
1,2023-08-12T00:57:00+10:00,2023-08-12,00:57,7,0,7
1,2023-08-12T01:01:00+10:00,2023-08-12,01:01,1,0,1
2,2023-08-12T00:57:00+10:00,2023-08-12,00:57,6,0,6
2,2023-08-12T01:06:00+10:00,2023-08-12,01:06,5,0,5
2,2023-08-12T01:07:00+10:00,2023-08-12,01:07,0,2,2
2,2023-08-12T01:09:00+10:00,2023-08-12,01:09,1,0,1
11,2023-08-12T01:05:00+10:00,2023-08-12,01:05,2,0,2
17,2023-08-12T00:55:00+10:00,2023-08-12,00:55,1,0,1
24,2023-08-12T01:00:00+10:00,2023-08-12,01:00,5,1,6
24,2023-08-12T01:01:00+10:00,2023-08-12,01:01,1,0,1
24,2023-08-12T01:05:00+10:00,2023-08-12,01:05,0,1,1
24,2023-08-12T01:06:00+10:00,2023-08-12,01:06,0,4,4
27,2023-08-12T01:07:00+10:00,2023-08-12,01:07,2,1,3
35,2023-08-12T00:55:00+10:00,2023-08-12,00:55,3,1,4
35,2023-08-12T01:03:00+10:00,2023-08-12,01:03,1,9,10
35,2023-08-12T01:09:00+10:00,2023-08-12,01:09,1,4,5
53,2023-08-12T00:58:00+10:00,2023-08-12,00:58,3,0,3
56,2023-08-12T00:56:00+10:00,2023-08-12,00:56,4,0,4
56,2023-08-12T00:57:00+10:00,2023-08-12,00:57,1,1,2
56,2023-08-12T00:59:00+10:00,2023-08-12,00:59,0,1,1
58,2023-08-12T00:59:00+10:00,2023-08-12,00:59,2,4,6
58,2023-08-12T01:00:00+10:00,2023-08-12,01:00,1,5,6
58,2023-08-12T01:04:00+10:00,2023-08-12,01:04,1,0,1
58,2023-08-12T01:06:00+10:00,2023-08-12,01:06,2,0,2
62,2023-08-12T01:01:00+10:00,2023-08-12,01:01,1,4,5
63,2023-08-12T00:58:00+10:00,2023-08-12,00:58,1,16,17
63,2023-08-12T00:59:00+10:00,2023-08-12,00:59,0,4,4
63,2023-08-12T01:03:00+10:00,2023-08-12,01:03,7,8,15
63,2023-08-12T01:05:00+10:00,2023-08-12,01:05,2,0,2
63,2023-08-12T01:09:00+10:00,2023-08-12,01:09,0,1,1
67,2023-08-12T01:08:00+10:00,2023-08-12,01:08,2,2,4
68,2023-08-12T01:05:00+10:00,2023-08-12,01:05,1,0,1
72,2023-08-12T00:57:00+10:00,2023-08-12,00:57,0,4,4
72,2023-08-12T00:58:00+10:00,2023-08-12,00:58,4,6,10
72,2023-08-12T00:59:00+10:00,2023-08-12,00:59,0,2,2
72,2023-08-12T01:03:00+10:00,2023-08-12,01:03,1,0,1
72,2023-08-12T01:04:00+10:00,2023-08-12,01:04,0,1,1
79,2023-08-12T01:01:00+10:00,2023-08-12,01:01,2,3,5
79,2023-08-12T01:02:00+10:00,2023-08-12,01:02,3,4,7
79,2023-08-12T01:03:00+10:00,2023-08-12,01:03,1,2,3
79,2023-08-12T01:08:00+10:00,2023-08-12,01:08,1,5,6
79,2023-08-12T01:09:00+10:00,2023-08-12,01:09,2,2,4
85,2023-08-12T00:58:00+10:00,2023-08-12,00:58,0,2,2
109,2023-08-12T01:05:00+10:00,2023-08-12,01:05,1,3,4
117,2023-08-12T01:05:00+10:00,2023-08-12,01:05,3,6,9
3,2023-08-12T01:12:00+10:00,2023-08-12,01:12,8,12,20
3,2023-08-12T01:14:00+10:00,2023-08-12,01:14,1,9,10
3,2023-08-12T01:16:00+10:00,2023-08-12,01:16,5,17,22
3,2023-08-12T01:19:00+10:00,2023-08-12,01:19,7,7,14
3,2023-08-12T01:22:00+10:00,2023-08-12,01:22,0,7,7
3,2023-08-12T01:23:00+10:00,2023-08-12,01:23,8,9,17
3,2023-08-12T01:24:00+10:00,2023-08-12,01:24,19,9,28
4,2023-08-12T01:10:00+10:00,2023-08-12,01:10,9,3,12
4,2023-08-12T01:15:00+10:00,2023-08-12,01:15,3,1,4
4,2023-08-12T01:20:00+10:00,2023-08-12,01:20,4,5,9
4,2023-08-12T01:21:00+10:00,2023-08-12,01:21,2,1,3
6,2023-08-12T01:10:00+10:00,2023-08-12,01:10,1,0,1
6,2023-08-12T01:15:00+10:00,2023-08-12,01:15,2,0,2
6,2023-08-12T01:17:00+10:00,2023-08-12,01:17,1,4,5
6,2023-08-12T01:18:00+10:00,2023-08-12,01:18,1,0,1
14,2023-08-12T01:12:00+10:00,2023-08-12,01:12,1,1,2
14,2023-08-12T01:18:00+10:00,2023-08-12,01:18,6,0,6
14,2023-08-12T01:24:00+10:00,2023-08-12,01:24,0,2,2
21,2023-08-12T01:11:00+10:00,2023-08-12,01:11,6,4,10
21,2023-08-12T01:13:00+10:00,2023-08-12,01:13,2,6,8
21,2023-08-12T01:16:00+10:00,2023-08-12,01:16,3,5,8
21,2023-08-12T01:19:00+10:00,2023-08-12,01:19,4,3,7
21,2023-08-12T01:20:00+10:00,2023-08-12,01:20,1,4,5
21,2023-08-12T01:23:00+10:00,2023-08-12,01:23,2,0,2
28,2023-08-12T01:14:00+10:00,2023-08-12,01:14,2,0,2
28,2023-08-12T01:16:00+10:00,2023-08-12,01:16,1,0,1
28,2023-08-12T01:22:00+10:00,2023-08-12,01:22,0,2,2
29,2023-08-12T01:22:00+10:00,2023-08-12,01:22,0,4,4
39,2023-08-12T01:13:00+10:00,2023-08-12,01:13,1,0,1
39,2023-08-12T01:19:00+10:00,2023-08-12,01:19,0,1,1
41,2023-08-12T01:11:00+10:00,2023-08-12,01:11,2,1,3
41,2023-08-12T01:12:00+10:00,2023-08-12,01:12,14,6,20
41,2023-08-12T01:13:00+10:00,2023-08-12,01:13,1,5,6
41,2023-08-12T01:14:00+10:00,2023-08-12,01:14,0,1,1
41,2023-08-12T01:17:00+10:00,2023-08-12,01:17,10,3,13
54,2023-08-12T01:15:00+10:00,2023-08-12,01:15,2,0,2
55,2023-08-12T01:11:00+10:00,2023-08-12,01:11,6,0,6
55,2023-08-12T01:12:00+10:00,2023-08-12,01:12,4,3,7
55,2023-08-12T01:14:00+10:00,2023-08-12,01:14,10,2,12
55,2023-08-12T01:19:00+10:00,2023-08-12,01:19,5,0,5
55,2023-08-12T01:24:00+10:00,2023-08-12,01:24,2,9,11
61,2023-08-12T01:11:00+10:00,2023-08-12,01:11,2,0,2
61,2023-08-12T01:16:00+10:00,2023-08-12,01:16,0,1,1
65,2023-08-12T01:16:00+10:00,2023-08-12,01:16,2,5,7
65,2023-08-12T01:17:00+10:00,2023-08-12,01:17,0,1,1
65,2023-08-12T01:19:00+10:00,2023-08-12,01:19,2,4,6
65,2023-08-12T01:23:00+10:00,2023-08-12,01:23,1,0,1
65,2023-08-12T01:24:00+10:00,2023-08-12,01:24,0,5,5
66,2023-08-12T01:10:00+10:00,2023-08-12,01:10,0,1,1
66,2023-08-12T01:11:00+10:00,2023-08-12,01:11,6,6,12
66,2023-08-12T01:14:00+10:00,2023-08-12,01:14,2,0,2
66,2023-08-12T01:15:00+10:00,2023-08-12,01:15,0,5,5
66,2023-08-12T01:20:00+10:00,2023-08-12,01:20,6,4,10
66,2023-08-12T01:22:00+10:00,2023-08-12,01:22,0,3,3
66,2023-08-12T01:24:00+10:00,2023-08-12,01:24,2,0,2
75,2023-08-12T01:21:00+10:00,2023-08-12,01:21,0,1,1
77,2023-08-12T01:17:00+10:00,2023-08-12,01:17,0,1,1
77,2023-08-12T01:18:00+10:00,2023-08-12,01:18,3,0,3
84,2023-08-12T01:10:00+10:00,2023-08-12,01:10,13,20,33
87,2023-08-12T01:12:00+10:00,2023-08-12,01:12,0,1,1
107,2023-08-12T01:15:00+10:00,2023-08-12,01:15,2,0,2
108,2023-08-12T01:23:00+10:00,2023-08-12,01:23,0,1,1
118,2023-08-12T01:15:00+10:00,2023-08-12,01:15,1,0,1
1,2023-08-12T01:13:00+10:00,2023-08-12,01:13,2,0,2
1,2023-08-12T01:21:00+10:00,2023-08-12,01:21,1,1,2
1,2023-08-12T01:23:00+10:00,2023-08-12,01:23,4,2,6
7,2023-08-12T01:11:00+10:00,2023-08-12,01:11,0,1,1
7,2023-08-12T01:21:00+10:00,2023-08-12,01:21,1,2,3
9,2023-08-12T01:24:00+10:00,2023-08-12,01:24,0,3,3
12,2023-08-12T01:10:00+10:00,2023-08-12,01:10,3,0,3
17,2023-08-12T01:13:00+10:00,2023-08-12,01:13,1,1,2
18,2023-08-12T01:15:00+10:00,2023-08-12,01:15,1,0,1
18,2023-08-12T01:20:00+10:00,2023-08-12,01:20,0,1,1
24,2023-08-12T01:10:00+10:00,2023-08-12,01:10,1,3,4
24,2023-08-12T01:11:00+10:00,2023-08-12,01:11,2,3,5
24,2023-08-12T01:12:00+10:00,2023-08-12,01:12,1,3,4
24,2023-08-12T01:16:00+10:00,2023-08-12,01:16,0,1,1
24,2023-08-12T01:23:00+10:00,2023-08-12,01:23,1,1,2
24,2023-08-12T01:24:00+10:00,2023-08-12,01:24,0,1,1
27,2023-08-12T01:15:00+10:00,2023-08-12,01:15,2,0,2
35,2023-08-12T01:12:00+10:00,2023-08-12,01:12,3,2,5
35,2023-08-12T01:13:00+10:00,2023-08-12,01:13,2,1,3
35,2023-08-12T01:14:00+10:00,2023-08-12,01:14,1,0,1
35,2023-08-12T01:19:00+10:00,2023-08-12,01:19,1,1,2
35,2023-08-12T01:22:00+10:00,2023-08-12,01:22,0,2,2
53,2023-08-12T01:14:00+10:00,2023-08-12,01:14,2,0,2
53,2023-08-12T01:19:00+10:00,2023-08-12,01:19,0,2,2
53,2023-08-12T01:20:00+10:00,2023-08-12,01:20,1,2,3
56,2023-08-12T01:12:00+10:00,2023-08-12,01:12,1,2,3
56,2023-08-12T01:17:00+10:00,2023-08-12,01:17,1,1,2
56,2023-08-12T01:22:00+10:00,2023-08-12,01:22,0,3,3
57,2023-08-12T01:14:00+10:00,2023-08-12,01:14,0,2,2
58,2023-08-12T01:10:00+10:00,2023-08-12,01:10,0,7,7
58,2023-08-12T01:13:00+10:00,2023-08-12,01:13,1,0,1
58,2023-08-12T01:14:00+10:00,2023-08-12,01:14,3,2,5
58,2023-08-12T01:23:00+10:00,2023-08-12,01:23,1,1,2
58,2023-08-12T01:24:00+10:00,2023-08-12,01:24,2,0,2
62,2023-08-12T01:11:00+10:00,2023-08-12,01:11,0,4,4
62,2023-08-12T01:22:00+10:00,2023-08-12,01:22,1,0,1
63,2023-08-12T01:18:00+10:00,2023-08-12,01:18,1,2,3
63,2023-08-12T01:20:00+10:00,2023-08-12,01:20,0,1,1
63,2023-08-12T01:23:00+10:00,2023-08-12,01:23,2,0,2
63,2023-08-12T01:24:00+10:00,2023-08-12,01:24,3,3,6
67,2023-08-12T01:13:00+10:00,2023-08-12,01:13,1,0,1
67,2023-08-12T01:23:00+10:00,2023-08-12,01:23,0,1,1
72,2023-08-12T01:12:00+10:00,2023-08-12,01:12,1,3,4
72,2023-08-12T01:14:00+10:00,2023-08-12,01:14,1,0,1
72,2023-08-12T01:17:00+10:00,2023-08-12,01:17,1,0,1
72,2023-08-12T01:22:00+10:00,2023-08-12,01:22,1,0,1
72,2023-08-12T01:23:00+10:00,2023-08-12,01:23,2,1,3
72,2023-08-12T01:24:00+10:00,2023-08-12,01:24,3,0,3
79,2023-08-12T01:10:00+10:00,2023-08-12,01:10,0,11,11
79,2023-08-12T01:16:00+10:00,2023-08-12,01:16,5,4,9
79,2023-08-12T01:24:00+10:00,2023-08-12,01:24,0,10,10
3,2023-08-12T01:31:00+10:00,2023-08-12,01:31,4,4,8
3,2023-08-12T01:34:00+10:00,2023-08-12,01:34,1,2,3
3,2023-08-12T01:35:00+10:00,2023-08-12,01:35,6,11,17
3,2023-08-12T01:36:00+10:00,2023-08-12,01:36,2,5,7
3,2023-08-12T01:37:00+10:00,2023-08-12,01:37,6,0,6
4,2023-08-12T01:26:00+10:00,2023-08-12,01:26,5,6,11
4,2023-08-12T01:27:00+10:00,2023-08-12,01:27,14,0,14
4,2023-08-12T01:28:00+10:00,2023-08-12,01:28,1,2,3
4,2023-08-12T01:29:00+10:00,2023-08-12,01:29,3,11,14
4,2023-08-12T01:32:00+10:00,2023-08-12,01:32,6,6,12
4,2023-08-12T01:34:00+10:00,2023-08-12,01:34,0,7,7
4,2023-08-12T01:36:00+10:00,2023-08-12,01:36,2,5,7
4,2023-08-12T01:37:00+10:00,2023-08-12,01:37,3,0,3
6,2023-08-12T01:29:00+10:00,2023-08-12,01:29,0,1,1
6,2023-08-12T01:31:00+10:00,2023-08-12,01:31,5,1,6
6,2023-08-12T01:32:00+10:00,2023-08-12,01:32,2,3,5
6,2023-08-12T01:34:00+10:00,2023-08-12,01:34,2,1,3
6,2023-08-12T01:36:00+10:00,2023-08-12,01:36,3,0,3
14,2023-08-12T01:29:00+10:00,2023-08-12,01:29,1,0,1
14,2023-08-12T01:30:00+10:00,2023-08-12,01:30,6,0,6
14,2023-08-12T01:31:00+10:00,2023-08-12,01:31,0,1,1
14,2023-08-12T01:33:00+10:00,2023-08-12,01:33,6,0,6
21,2023-08-12T01:27:00+10:00,2023-08-12,01:27,4,6,10
21,2023-08-12T01:29:00+10:00,2023-08-12,01:29,14,0,14
21,2023-08-12T01:30:00+10:00,2023-08-12,01:30,0,3,3
21,2023-08-12T01:31:00+10:00,2023-08-12,01:31,2,1,3
21,2023-08-12T01:38:00+10:00,2023-08-12,01:38,1,7,8
28,2023-08-12T01:37:00+10:00,2023-08-12,01:37,0,2,2
29,2023-08-12T01:31:00+10:00,2023-08-12,01:31,0,6,6
29,2023-08-12T01:36:00+10:00,2023-08-12,01:36,0,1,1
39,2023-08-12T01:25:00+10:00,2023-08-12,01:25,0,1,1
39,2023-08-12T01:36:00+10:00,2023-08-12,01:36,0,1,1
41,2023-08-12T01:25:00+10:00,2023-08-12,01:25,7,6,13
41,2023-08-12T01:27:00+10:00,2023-08-12,01:27,10,0,10
41,2023-08-12T01:29:00+10:00,2023-08-12,01:29,7,6,13
41,2023-08-12T01:31:00+10:00,2023-08-12,01:31,5,6,11
41,2023-08-12T01:33:00+10:00,2023-08-12,01:33,6,5,11
41,2023-08-12T01:34:00+10:00,2023-08-12,01:34,0,6,6
41,2023-08-12T01:39:00+10:00,2023-08-12,01:39,3,1,4
54,2023-08-12T01:33:00+10:00,2023-08-12,01:33,0,1,1
54,2023-08-12T01:36:00+10:00,2023-08-12,01:36,1,0,1
54,2023-08-12T01:38:00+10:00,2023-08-12,01:38,0,2,2
55,2023-08-12T01:32:00+10:00,2023-08-12,01:32,1,0,1
55,2023-08-12T01:38:00+10:00,2023-08-12,01:38,4,6,10
55,2023-08-12T01:39:00+10:00,2023-08-12,01:39,11,4,15
59,2023-08-12T01:25:00+10:00,2023-08-12,01:25,8,1,9
59,2023-08-12T01:30:00+10:00,2023-08-12,01:30,4,2,6
61,2023-08-12T01:38:00+10:00,2023-08-12,01:38,0,1,1
65,2023-08-12T01:29:00+10:00,2023-08-12,01:29,2,1,3
66,2023-08-12T01:25:00+10:00,2023-08-12,01:25,0,1,1
66,2023-08-12T01:32:00+10:00,2023-08-12,01:32,1,2,3
66,2023-08-12T01:38:00+10:00,2023-08-12,01:38,0,9,9
69,2023-08-12T01:36:00+10:00,2023-08-12,01:36,1,0,1
70,2023-08-12T01:25:00+10:00,2023-08-12,01:25,2,0,2
75,2023-08-12T01:32:00+10:00,2023-08-12,01:32,0,1,1
75,2023-08-12T01:37:00+10:00,2023-08-12,01:37,0,1,1
78,2023-08-12T01:31:00+10:00,2023-08-12,01:31,0,1,1
87,2023-08-12T01:39:00+10:00,2023-08-12,01:39,1,0,1
1,2023-08-12T01:27:00+10:00,2023-08-12,01:27,0,7,7
1,2023-08-12T01:30:00+10:00,2023-08-12,01:30,1,0,1
1,2023-08-12T01:37:00+10:00,2023-08-12,01:37,1,1,2
2,2023-08-12T01:26:00+10:00,2023-08-12,01:26,1,0,1
2,2023-08-12T01:37:00+10:00,2023-08-12,01:37,0,3,3
9,2023-08-12T01:33:00+10:00,2023-08-12,01:33,0,1,1
10,2023-08-12T01:29:00+10:00,2023-08-12,01:29,0,1,1
17,2023-08-12T01:31:00+10:00,2023-08-12,01:31,0,2,2
24,2023-08-12T01:25:00+10:00,2023-08-12,01:25,0,5,5
24,2023-08-12T01:30:00+10:00,2023-08-12,01:30,0,5,5
24,2023-08-12T01:31:00+10:00,2023-08-12,01:31,1,0,1
24,2023-08-12T01:32:00+10:00,2023-08-12,01:32,1,3,4
24,2023-08-12T01:33:00+10:00,2023-08-12,01:33,1,4,5
24,2023-08-12T01:34:00+10:00,2023-08-12,01:34,2,0,2
35,2023-08-12T01:27:00+10:00,2023-08-12,01:27,0,2,2
35,2023-08-12T01:28:00+10:00,2023-08-12,01:28,3,6,9
35,2023-08-12T01:32:00+10:00,2023-08-12,01:32,0,1,1
35,2023-08-12T01:34:00+10:00,2023-08-12,01:34,1,0,1
35,2023-08-12T01:36:00+10:00,2023-08-12,01:36,2,6,8
35,2023-08-12T01:39:00+10:00,2023-08-12,01:39,6,4,10
53,2023-08-12T01:28:00+10:00,2023-08-12,01:28,0,1,1
56,2023-08-12T01:25:00+10:00,2023-08-12,01:25,1,0,1
56,2023-08-12T01:30:00+10:00,2023-08-12,01:30,1,0,1
56,2023-08-12T01:35:00+10:00,2023-08-12,01:35,0,1,1
57,2023-08-12T01:27:00+10:00,2023-08-12,01:27,1,0,1
58,2023-08-12T01:26:00+10:00,2023-08-12,01:26,0,1,1
58,2023-08-12T01:27:00+10:00,2023-08-12,01:27,1,2,3
58,2023-08-12T01:31:00+10:00,2023-08-12,01:31,0,2,2
58,2023-08-12T01:34:00+10:00,2023-08-12,01:34,0,1,1
58,2023-08-12T01:37:00+10:00,2023-08-12,01:37,2,0,2
58,2023-08-12T01:38:00+10:00,2023-08-12,01:38,2,1,3
58,2023-08-12T01:39:00+10:00,2023-08-12,01:39,0,2,2
62,2023-08-12T01:25:00+10:00,2023-08-12,01:25,1,0,1
62,2023-08-12T01:31:00+10:00,2023-08-12,01:31,1,0,1
62,2023-08-12T01:38:00+10:00,2023-08-12,01:38,1,3,4
62,2023-08-12T01:39:00+10:00,2023-08-12,01:39,0,7,7
63,2023-08-12T01:29:00+10:00,2023-08-12,01:29,1,2,3
63,2023-08-12T01:30:00+10:00,2023-08-12,01:30,0,2,2
63,2023-08-12T01:35:00+10:00,2023-08-12,01:35,8,6,14
67,2023-08-12T01:36:00+10:00,2023-08-12,01:36,0,2,2
72,2023-08-12T01:29:00+10:00,2023-08-12,01:29,4,0,4
72,2023-08-12T01:36:00+10:00,2023-08-12,01:36,3,0,3
79,2023-08-12T01:29:00+10:00,2023-08-12,01:29,1,4,5
79,2023-08-12T01:34:00+10:00,2023-08-12,01:34,0,1,1
117,2023-08-12T01:30:00+10:00,2023-08-12,01:30,4,1,5
117,2023-08-12T01:35:00+10:00,2023-08-12,01:35,4,1,5
3,2023-08-12T01:41:00+10:00,2023-08-12,01:41,9,2,11
3,2023-08-12T01:48:00+10:00,2023-08-12,01:48,1,1,2
3,2023-08-12T01:49:00+10:00,2023-08-12,01:49,0,1,1
3,2023-08-12T01:52:00+10:00,2023-08-12,01:52,2,5,7
4,2023-08-12T01:41:00+10:00,2023-08-12,01:41,1,3,4
4,2023-08-12T01:43:00+10:00,2023-08-12,01:43,3,5,8
4,2023-08-12T01:46:00+10:00,2023-08-12,01:46,2,3,5
4,2023-08-12T01:53:00+10:00,2023-08-12,01:53,0,3,3
6,2023-08-12T01:46:00+10:00,2023-08-12,01:46,2,6,8
6,2023-08-12T01:47:00+10:00,2023-08-12,01:47,2,4,6
6,2023-08-12T01:48:00+10:00,2023-08-12,01:48,1,0,1
6,2023-08-12T01:50:00+10:00,2023-08-12,01:50,0,4,4
8,2023-08-12T01:43:00+10:00,2023-08-12,01:43,1,0,1
14,2023-08-12T01:43:00+10:00,2023-08-12,01:43,7,1,8
14,2023-08-12T01:54:00+10:00,2023-08-12,01:54,6,0,6
21,2023-08-12T01:41:00+10:00,2023-08-12,01:41,4,3,7
21,2023-08-12T01:53:00+10:00,2023-08-12,01:53,2,1,3
21,2023-08-12T01:54:00+10:00,2023-08-12,01:54,1,2,3
28,2023-08-12T01:54:00+10:00,2023-08-12,01:54,0,3,3
29,2023-08-12T01:44:00+10:00,2023-08-12,01:44,0,2,2
29,2023-08-12T01:45:00+10:00,2023-08-12,01:45,0,1,1
29,2023-08-12T01:51:00+10:00,2023-08-12,01:51,1,1,2
39,2023-08-12T01:42:00+10:00,2023-08-12,01:42,2,0,2
41,2023-08-12T01:40:00+10:00,2023-08-12,01:40,2,3,5
41,2023-08-12T01:45:00+10:00,2023-08-12,01:45,0,2,2
41,2023-08-12T01:50:00+10:00,2023-08-12,01:50,2,0,2
41,2023-08-12T01:53:00+10:00,2023-08-12,01:53,4,7,11
54,2023-08-12T01:54:00+10:00,2023-08-12,01:54,0,1,1
55,2023-08-12T01:45:00+10:00,2023-08-12,01:45,6,5,11
55,2023-08-12T01:47:00+10:00,2023-08-12,01:47,4,10,14
55,2023-08-12T01:50:00+10:00,2023-08-12,01:50,10,5,15
55,2023-08-12T01:52:00+10:00,2023-08-12,01:52,4,2,6
59,2023-08-12T01:40:00+10:00,2023-08-12,01:40,7,1,8
61,2023-08-12T01:46:00+10:00,2023-08-12,01:46,4,0,4
65,2023-08-12T01:44:00+10:00,2023-08-12,01:44,3,4,7
65,2023-08-12T01:53:00+10:00,2023-08-12,01:53,0,5,5
65,2023-08-12T01:54:00+10:00,2023-08-12,01:54,1,1,2
66,2023-08-12T01:40:00+10:00,2023-08-12,01:40,4,1,5
66,2023-08-12T01:43:00+10:00,2023-08-12,01:43,2,3,5
66,2023-08-12T01:45:00+10:00,2023-08-12,01:45,0,2,2
66,2023-08-12T01:46:00+10:00,2023-08-12,01:46,2,1,3
66,2023-08-12T01:49:00+10:00,2023-08-12,01:49,2,0,2
66,2023-08-12T01:53:00+10:00,2023-08-12,01:53,0,2,2
77,2023-08-12T01:53:00+10:00,2023-08-12,01:53,1,0,1
107,2023-08-12T01:45:00+10:00,2023-08-12,01:45,1,0,1
108,2023-08-12T01:43:00+10:00,2023-08-12,01:43,3,0,3
1,2023-08-12T01:45:00+10:00,2023-08-12,01:45,1,0,1
1,2023-08-12T01:47:00+10:00,2023-08-12,01:47,0,2,2
2,2023-08-12T01:40:00+10:00,2023-08-12,01:40,0,1,1
2,2023-08-12T01:46:00+10:00,2023-08-12,01:46,0,3,3
2,2023-08-12T01:48:00+10:00,2023-08-12,01:48,0,2,2
11,2023-08-12T01:45:00+10:00,2023-08-12,01:45,1,0,1
12,2023-08-12T01:53:00+10:00,2023-08-12,01:53,0,1,1
17,2023-08-12T01:51:00+10:00,2023-08-12,01:51,1,0,1
24,2023-08-12T01:40:00+10:00,2023-08-12,01:40,2,8,10
24,2023-08-12T01:41:00+10:00,2023-08-12,01:41,0,2,2
24,2023-08-12T01:43:00+10:00,2023-08-12,01:43,0,4,4
24,2023-08-12T01:51:00+10:00,2023-08-12,01:51,1,0,1
24,2023-08-12T01:53:00+10:00,2023-08-12,01:53,2,0,2
24,2023-08-12T01:54:00+10:00,2023-08-12,01:54,1,0,1
27,2023-08-12T01:43:00+10:00,2023-08-12,01:43,0,1,1
27,2023-08-12T01:52:00+10:00,2023-08-12,01:52,1,0,1
35,2023-08-12T01:44:00+10:00,2023-08-12,01:44,4,3,7
35,2023-08-12T01:46:00+10:00,2023-08-12,01:46,2,0,2
35,2023-08-12T01:47:00+10:00,2023-08-12,01:47,0,3,3
35,2023-08-12T01:48:00+10:00,2023-08-12,01:48,1,2,3
35,2023-08-12T01:50:00+10:00,2023-08-12,01:50,4,3,7
35,2023-08-12T01:51:00+10:00,2023-08-12,01:51,2,3,5
35,2023-08-12T01:53:00+10:00,2023-08-12,01:53,0,1,1
53,2023-08-12T01:44:00+10:00,2023-08-12,01:44,0,1,1
53,2023-08-12T01:47:00+10:00,2023-08-12,01:47,2,0,2
56,2023-08-12T01:43:00+10:00,2023-08-12,01:43,2,0,2
56,2023-08-12T01:50:00+10:00,2023-08-12,01:50,2,0,2
56,2023-08-12T01:51:00+10:00,2023-08-12,01:51,3,0,3
56,2023-08-12T01:53:00+10:00,2023-08-12,01:53,2,0,2
57,2023-08-12T01:50:00+10:00,2023-08-12,01:50,0,1,1
58,2023-08-12T01:40:00+10:00,2023-08-12,01:40,1,4,5
58,2023-08-12T01:42:00+10:00,2023-08-12,01:42,0,1,1
58,2023-08-12T01:48:00+10:00,2023-08-12,01:48,2,3,5
58,2023-08-12T01:51:00+10:00,2023-08-12,01:51,0,4,4
58,2023-08-12T01:52:00+10:00,2023-08-12,01:52,3,0,3
58,2023-08-12T01:53:00+10:00,2023-08-12,01:53,0,2,2
62,2023-08-12T01:49:00+10:00,2023-08-12,01:49,1,0,1
62,2023-08-12T01:50:00+10:00,2023-08-12,01:50,1,0,1
63,2023-08-12T01:40:00+10:00,2023-08-12,01:40,0,2,2
63,2023-08-12T01:43:00+10:00,2023-08-12,01:43,3,5,8
63,2023-08-12T01:44:00+10:00,2023-08-12,01:44,5,1,6
63,2023-08-12T01:45:00+10:00,2023-08-12,01:45,2,7,9
67,2023-08-12T01:47:00+10:00,2023-08-12,01:47,0,1,1
67,2023-08-12T01:48:00+10:00,2023-08-12,01:48,1,0,1
67,2023-08-12T01:52:00+10:00,2023-08-12,01:52,0,1,1
72,2023-08-12T01:41:00+10:00,2023-08-12,01:41,0,1,1
72,2023-08-12T01:43:00+10:00,2023-08-12,01:43,2,0,2
72,2023-08-12T01:44:00+10:00,2023-08-12,01:44,0,1,1
72,2023-08-12T01:45:00+10:00,2023-08-12,01:45,0,2,2
72,2023-08-12T01:47:00+10:00,2023-08-12,01:47,0,1,1
72,2023-08-12T01:48:00+10:00,2023-08-12,01:48,0,3,3
76,2023-08-12T01:54:00+10:00,2023-08-12,01:54,0,1,1
79,2023-08-12T01:40:00+10:00,2023-08-12,01:40,4,0,4
79,2023-08-12T01:51:00+10:00,2023-08-12,01:51,2,0,2
117,2023-08-12T01:50:00+10:00,2023-08-12,01:50,9,0,9
122,2023-08-12T01:40:00+10:00,2023-08-12,01:40,1,0,1
122,2023-08-12T01:44:00+10:00,2023-08-12,01:44,1,0,1
3,2023-08-12T01:58:00+10:00,2023-08-12,01:58,13,1,14
3,2023-08-12T02:00:00+10:00,2023-08-12,02:00,1,5,6
3,2023-08-12T02:01:00+10:00,2023-08-12,02:01,4,2,6
3,2023-08-12T02:03:00+10:00,2023-08-12,02:03,1,3,4
3,2023-08-12T02:09:00+10:00,2023-08-12,02:09,1,3,4
4,2023-08-12T01:56:00+10:00,2023-08-12,01:56,0,1,1
4,2023-08-12T02:00:00+10:00,2023-08-12,02:00,4,6,10
6,2023-08-12T01:57:00+10:00,2023-08-12,01:57,1,0,1
6,2023-08-12T02:00:00+10:00,2023-08-12,02:00,0,1,1
6,2023-08-12T02:01:00+10:00,2023-08-12,02:01,3,0,3
6,2023-08-12T02:02:00+10:00,2023-08-12,02:02,4,0,4
8,2023-08-12T02:02:00+10:00,2023-08-12,02:02,1,0,1
14,2023-08-12T01:56:00+10:00,2023-08-12,01:56,2,0,2
14,2023-08-12T02:01:00+10:00,2023-08-12,02:01,1,2,3
21,2023-08-12T01:55:00+10:00,2023-08-12,01:55,0,2,2
21,2023-08-12T01:57:00+10:00,2023-08-12,01:57,1,4,5
21,2023-08-12T02:05:00+10:00,2023-08-12,02:05,0,5,5
21,2023-08-12T02:06:00+10:00,2023-08-12,02:06,0,7,7
21,2023-08-12T02:09:00+10:00,2023-08-12,02:09,0,1,1
29,2023-08-12T02:04:00+10:00,2023-08-12,02:04,2,0,2
29,2023-08-12T02:09:00+10:00,2023-08-12,02:09,0,3,3
41,2023-08-12T02:06:00+10:00,2023-08-12,02:06,4,12,16
41,2023-08-12T02:07:00+10:00,2023-08-12,02:07,3,4,7
41,2023-08-12T02:09:00+10:00,2023-08-12,02:09,1,2,3
55,2023-08-12T01:55:00+10:00,2023-08-12,01:55,2,5,7
55,2023-08-12T02:04:00+10:00,2023-08-12,02:04,3,3,6
59,2023-08-12T01:55:00+10:00,2023-08-12,01:55,10,2,12
59,2023-08-12T02:05:00+10:00,2023-08-12,02:05,5,1,6
61,2023-08-12T02:02:00+10:00,2023-08-12,02:02,0,1,1
61,2023-08-12T02:09:00+10:00,2023-08-12,02:09,1,0,1
65,2023-08-12T01:55:00+10:00,2023-08-12,01:55,0,3,3
65,2023-08-12T02:01:00+10:00,2023-08-12,02:01,0,1,1
65,2023-08-12T02:03:00+10:00,2023-08-12,02:03,0,1,1
66,2023-08-12T01:58:00+10:00,2023-08-12,01:58,5,0,5
66,2023-08-12T02:00:00+10:00,2023-08-12,02:00,0,2,2
66,2023-08-12T02:06:00+10:00,2023-08-12,02:06,0,1,1
66,2023-08-12T02:07:00+10:00,2023-08-12,02:07,0,2,2
66,2023-08-12T02:09:00+10:00,2023-08-12,02:09,3,1,4
70,2023-08-12T01:55:00+10:00,2023-08-12,01:55,1,0,1
77,2023-08-12T02:06:00+10:00,2023-08-12,02:06,1,0,1
84,2023-08-12T01:55:00+10:00,2023-08-12,01:55,12,15,27
108,2023-08-12T01:55:00+10:00,2023-08-12,01:55,1,0,1
1,2023-08-12T01:57:00+10:00,2023-08-12,01:57,2,0,2
1,2023-08-12T01:59:00+10:00,2023-08-12,01:59,0,3,3
1,2023-08-12T02:01:00+10:00,2023-08-12,02:01,0,2,2
1,2023-08-12T02:03:00+10:00,2023-08-12,02:03,1,0,1
1,2023-08-12T02:07:00+10:00,2023-08-12,02:07,0,2,2
2,2023-08-12T02:01:00+10:00,2023-08-12,02:01,0,2,2
2,2023-08-12T02:03:00+10:00,2023-08-12,02:03,0,5,5
2,2023-08-12T02:05:00+10:00,2023-08-12,02:05,0,3,3
2,2023-08-12T02:08:00+10:00,2023-08-12,02:08,0,1,1
12,2023-08-12T01:58:00+10:00,2023-08-12,01:58,2,0,2
17,2023-08-12T01:57:00+10:00,2023-08-12,01:57,0,2,2
17,2023-08-12T02:00:00+10:00,2023-08-12,02:00,1,0,1
24,2023-08-12T01:56:00+10:00,2023-08-12,01:56,0,8,8
24,2023-08-12T01:58:00+10:00,2023-08-12,01:58,0,4,4
24,2023-08-12T01:59:00+10:00,2023-08-12,01:59,0,2,2
24,2023-08-12T02:02:00+10:00,2023-08-12,02:02,0,1,1
24,2023-08-12T02:03:00+10:00,2023-08-12,02:03,0,1,1
24,2023-08-12T02:08:00+10:00,2023-08-12,02:08,3,0,3
27,2023-08-12T01:58:00+10:00,2023-08-12,01:58,4,0,4
35,2023-08-12T01:57:00+10:00,2023-08-12,01:57,0,4,4
35,2023-08-12T02:05:00+10:00,2023-08-12,02:05,4,5,9
35,2023-08-12T02:08:00+10:00,2023-08-12,02:08,2,2,4
53,2023-08-12T01:58:00+10:00,2023-08-12,01:58,2,2,4
53,2023-08-12T02:03:00+10:00,2023-08-12,02:03,0,4,4
56,2023-08-12T02:02:00+10:00,2023-08-12,02:02,2,0,2
58,2023-08-12T02:03:00+10:00,2023-08-12,02:03,0,1,1
62,2023-08-12T01:55:00+10:00,2023-08-12,01:55,0,1,1
62,2023-08-12T02:03:00+10:00,2023-08-12,02:03,2,0,2
62,2023-08-12T02:06:00+10:00,2023-08-12,02:06,3,1,4
63,2023-08-12T01:55:00+10:00,2023-08-12,01:55,0,3,3
63,2023-08-12T01:57:00+10:00,2023-08-12,01:57,0,2,2
63,2023-08-12T01:58:00+10:00,2023-08-12,01:58,5,0,5
63,2023-08-12T01:59:00+10:00,2023-08-12,01:59,1,3,4
63,2023-08-12T02:09:00+10:00,2023-08-12,02:09,0,2,2
67,2023-08-12T02:02:00+10:00,2023-08-12,02:02,0,1,1
67,2023-08-12T02:06:00+10:00,2023-08-12,02:06,0,4,4
67,2023-08-12T02:08:00+10:00,2023-08-12,02:08,0,2,2
72,2023-08-12T02:07:00+10:00,2023-08-12,02:07,1,0,1
79,2023-08-12T01:56:00+10:00,2023-08-12,01:56,0,4,4
79,2023-08-12T02:00:00+10:00,2023-08-12,02:00,1,5,6
79,2023-08-12T02:04:00+10:00,2023-08-12,02:04,2,3,5
79,2023-08-12T02:05:00+10:00,2023-08-12,02:05,4,4,8
79,2023-08-12T02:07:00+10:00,2023-08-12,02:07,3,0,3
79,2023-08-12T02:09:00+10:00,2023-08-12,02:09,1,1,2
86,2023-08-12T02:03:00+10:00,2023-08-12,02:03,0,1,1
109,2023-08-12T01:55:00+10:00,2023-08-12,01:55,2,0,2
117,2023-08-12T02:05:00+10:00,2023-08-12,02:05,3,1,4
3,2023-08-12T02:12:00+10:00,2023-08-12,02:12,4,9,13
3,2023-08-12T02:17:00+10:00,2023-08-12,02:17,6,3,9
3,2023-08-12T02:19:00+10:00,2023-08-12,02:19,2,1,3
3,2023-08-12T02:21:00+10:00,2023-08-12,02:21,11,4,15
3,2023-08-12T02:22:00+10:00,2023-08-12,02:22,13,0,13
4,2023-08-12T02:16:00+10:00,2023-08-12,02:16,2,0,2
4,2023-08-12T02:17:00+10:00,2023-08-12,02:17,0,6,6
4,2023-08-12T02:18:00+10:00,2023-08-12,02:18,1,1,2
4,2023-08-12T02:19:00+10:00,2023-08-12,02:19,3,0,3
4,2023-08-12T02:22:00+10:00,2023-08-12,02:22,1,1,2
4,2023-08-12T02:24:00+10:00,2023-08-12,02:24,0,1,1
6,2023-08-12T02:17:00+10:00,2023-08-12,02:17,2,11,13
14,2023-08-12T02:10:00+10:00,2023-08-12,02:10,3,1,4
14,2023-08-12T02:14:00+10:00,2023-08-12,02:14,4,0,4
14,2023-08-12T02:18:00+10:00,2023-08-12,02:18,1,0,1
14,2023-08-12T02:19:00+10:00,2023-08-12,02:19,3,0,3
14,2023-08-12T02:24:00+10:00,2023-08-12,02:24,2,0,2
21,2023-08-12T02:13:00+10:00,2023-08-12,02:13,0,3,3
21,2023-08-12T02:17:00+10:00,2023-08-12,02:17,0,2,2
21,2023-08-12T02:18:00+10:00,2023-08-12,02:18,0,2,2
21,2023-08-12T02:20:00+10:00,2023-08-12,02:20,1,4,5
21,2023-08-12T02:21:00+10:00,2023-08-12,02:21,0,3,3
21,2023-08-12T02:24:00+10:00,2023-08-12,02:24,1,0,1
28,2023-08-12T02:10:00+10:00,2023-08-12,02:10,0,6,6
28,2023-08-12T02:15:00+10:00,2023-08-12,02:15,1,0,1
29,2023-08-12T02:12:00+10:00,2023-08-12,02:12,0,1,1
41,2023-08-12T02:10:00+10:00,2023-08-12,02:10,2,3,5
41,2023-08-12T02:17:00+10:00,2023-08-12,02:17,3,1,4
41,2023-08-12T02:24:00+10:00,2023-08-12,02:24,2,0,2
55,2023-08-12T02:13:00+10:00,2023-08-12,02:13,1,1,2
55,2023-08-12T02:14:00+10:00,2023-08-12,02:14,1,7,8
55,2023-08-12T02:15:00+10:00,2023-08-12,02:15,9,1,10
55,2023-08-12T02:17:00+10:00,2023-08-12,02:17,3,5,8
55,2023-08-12T02:19:00+10:00,2023-08-12,02:19,0,3,3
59,2023-08-12T02:10:00+10:00,2023-08-12,02:10,12,4,16
61,2023-08-12T02:13:00+10:00,2023-08-12,02:13,0,1,1
61,2023-08-12T02:21:00+10:00,2023-08-12,02:21,3,1,4
65,2023-08-12T02:11:00+10:00,2023-08-12,02:11,0,2,2
65,2023-08-12T02:17:00+10:00,2023-08-12,02:17,1,0,1
65,2023-08-12T02:19:00+10:00,2023-08-12,02:19,0,3,3
65,2023-08-12T02:21:00+10:00,2023-08-12,02:21,0,10,10
66,2023-08-12T02:10:00+10:00,2023-08-12,02:10,1,2,3
66,2023-08-12T02:14:00+10:00,2023-08-12,02:14,1,0,1
66,2023-08-12T02:17:00+10:00,2023-08-12,02:17,0,1,1
66,2023-08-12T02:20:00+10:00,2023-08-12,02:20,0,2,2
69,2023-08-12T02:11:00+10:00,2023-08-12,02:11,1,0,1
84,2023-08-12T02:15:00+10:00,2023-08-12,02:15,8,14,22
84,2023-08-12T02:20:00+10:00,2023-08-12,02:20,12,5,17
108,2023-08-12T02:17:00+10:00,2023-08-12,02:17,0,1,1
108,2023-08-12T02:19:00+10:00,2023-08-12,02:19,1,1,2
1,2023-08-12T02:10:00+10:00,2023-08-12,02:10,0,4,4
1,2023-08-12T02:24:00+10:00,2023-08-12,02:24,2,0,2
2,2023-08-12T02:10:00+10:00,2023-08-12,02:10,0,1,1
2,2023-08-12T02:13:00+10:00,2023-08-12,02:13,3,0,3
2,2023-08-12T02:18:00+10:00,2023-08-12,02:18,1,1,2
7,2023-08-12T02:16:00+10:00,2023-08-12,02:16,1,0,1
9,2023-08-12T02:13:00+10:00,2023-08-12,02:13,1,0,1
10,2023-08-12T02:12:00+10:00,2023-08-12,02:12,0,1,1
17,2023-08-12T02:15:00+10:00,2023-08-12,02:15,1,0,1
24,2023-08-12T02:11:00+10:00,2023-08-12,02:11,2,1,3
24,2023-08-12T02:12:00+10:00,2023-08-12,02:12,2,0,2
24,2023-08-12T02:18:00+10:00,2023-08-12,02:18,4,0,4
24,2023-08-12T02:22:00+10:00,2023-08-12,02:22,2,1,3
24,2023-08-12T02:24:00+10:00,2023-08-12,02:24,0,2,2
27,2023-08-12T02:14:00+10:00,2023-08-12,02:14,1,0,1
27,2023-08-12T02:18:00+10:00,2023-08-12,02:18,5,0,5
27,2023-08-12T02:21:00+10:00,2023-08-12,02:21,3,0,3
35,2023-08-12T02:10:00+10:00,2023-08-12,02:10,3,1,4
35,2023-08-12T02:12:00+10:00,2023-08-12,02:12,4,1,5
35,2023-08-12T02:15:00+10:00,2023-08-12,02:15,4,0,4
35,2023-08-12T02:19:00+10:00,2023-08-12,02:19,1,2,3
35,2023-08-12T02:21:00+10:00,2023-08-12,02:21,3,2,5
35,2023-08-12T02:24:00+10:00,2023-08-12,02:24,2,1,3
53,2023-08-12T02:10:00+10:00,2023-08-12,02:10,1,1,2
56,2023-08-12T02:12:00+10:00,2023-08-12,02:12,1,3,4
56,2023-08-12T02:13:00+10:00,2023-08-12,02:13,1,2,3
56,2023-08-12T02:14:00+10:00,2023-08-12,02:14,0,1,1
56,2023-08-12T02:18:00+10:00,2023-08-12,02:18,4,0,4
56,2023-08-12T02:20:00+10:00,2023-08-12,02:20,1,1,2
56,2023-08-12T02:22:00+10:00,2023-08-12,02:22,1,0,1
58,2023-08-12T02:12:00+10:00,2023-08-12,02:12,0,1,1
58,2023-08-12T02:15:00+10:00,2023-08-12,02:15,0,1,1
58,2023-08-12T02:19:00+10:00,2023-08-12,02:19,0,1,1
58,2023-08-12T02:21:00+10:00,2023-08-12,02:21,1,0,1
58,2023-08-12T02:24:00+10:00,2023-08-12,02:24,1,0,1
62,2023-08-12T02:16:00+10:00,2023-08-12,02:16,3,0,3
62,2023-08-12T02:19:00+10:00,2023-08-12,02:19,2,0,2
62,2023-08-12T02:20:00+10:00,2023-08-12,02:20,1,1,2
63,2023-08-12T02:13:00+10:00,2023-08-12,02:13,0,4,4
63,2023-08-12T02:14:00+10:00,2023-08-12,02:14,0,1,1
63,2023-08-12T02:15:00+10:00,2023-08-12,02:15,0,1,1
63,2023-08-12T02:16:00+10:00,2023-08-12,02:16,0,7,7
63,2023-08-12T02:23:00+10:00,2023-08-12,02:23,0,1,1
63,2023-08-12T02:24:00+10:00,2023-08-12,02:24,0,3,3
67,2023-08-12T02:18:00+10:00,2023-08-12,02:18,0,4,4
67,2023-08-12T02:21:00+10:00,2023-08-12,02:21,1,0,1
67,2023-08-12T02:23:00+10:00,2023-08-12,02:23,0,2,2
79,2023-08-12T02:13:00+10:00,2023-08-12,02:13,2,3,5
117,2023-08-12T02:15:00+10:00,2023-08-12,02:15,0,1,1
122,2023-08-12T02:10:00+10:00,2023-08-12,02:10,1,0,1
122,2023-08-12T02:21:00+10:00,2023-08-12,02:21,1,4,5
122,2023-08-12T02:23:00+10:00,2023-08-12,02:23,1,0,1
3,2023-08-12T02:25:00+10:00,2023-08-12,02:25,2,4,6
3,2023-08-12T02:27:00+10:00,2023-08-12,02:27,11,5,16
3,2023-08-12T02:32:00+10:00,2023-08-12,02:32,7,5,12
3,2023-08-12T02:34:00+10:00,2023-08-12,02:34,2,2,4
3,2023-08-12T02:39:00+10:00,2023-08-12,02:39,4,1,5
4,2023-08-12T02:25:00+10:00,2023-08-12,02:25,0,1,1
4,2023-08-12T02:33:00+10:00,2023-08-12,02:33,2,0,2
4,2023-08-12T02:34:00+10:00,2023-08-12,02:34,0,5,5
4,2023-08-12T02:38:00+10:00,2023-08-12,02:38,2,0,2
6,2023-08-12T02:26:00+10:00,2023-08-12,02:26,1,2,3
6,2023-08-12T02:33:00+10:00,2023-08-12,02:33,1,0,1
6,2023-08-12T02:35:00+10:00,2023-08-12,02:35,3,1,4
6,2023-08-12T02:36:00+10:00,2023-08-12,02:36,3,0,3
6,2023-08-12T02:38:00+10:00,2023-08-12,02:38,0,10,10
14,2023-08-12T02:27:00+10:00,2023-08-12,02:27,0,1,1
14,2023-08-12T02:28:00+10:00,2023-08-12,02:28,1,0,1
14,2023-08-12T02:30:00+10:00,2023-08-12,02:30,2,0,2
14,2023-08-12T02:34:00+10:00,2023-08-12,02:34,0,2,2
14,2023-08-12T02:38:00+10:00,2023-08-12,02:38,2,0,2
21,2023-08-12T02:25:00+10:00,2023-08-12,02:25,0,5,5
21,2023-08-12T02:26:00+10:00,2023-08-12,02:26,8,0,8
21,2023-08-12T02:27:00+10:00,2023-08-12,02:27,0,5,5
21,2023-08-12T02:33:00+10:00,2023-08-12,02:33,6,0,6
21,2023-08-12T02:34:00+10:00,2023-08-12,02:34,2,0,2
21,2023-08-12T02:36:00+10:00,2023-08-12,02:36,5,2,7
21,2023-08-12T02:38:00+10:00,2023-08-12,02:38,0,4,4
28,2023-08-12T02:28:00+10:00,2023-08-12,02:28,2,0,2
28,2023-08-12T02:33:00+10:00,2023-08-12,02:33,1,0,1
29,2023-08-12T02:25:00+10:00,2023-08-12,02:25,0,4,4
29,2023-08-12T02:28:00+10:00,2023-08-12,02:28,1,4,5
29,2023-08-12T02:33:00+10:00,2023-08-12,02:33,0,1,1
29,2023-08-12T02:36:00+10:00,2023-08-12,02:36,2,0,2
41,2023-08-12T02:27:00+10:00,2023-08-12,02:27,4,5,9
41,2023-08-12T02:31:00+10:00,2023-08-12,02:31,2,9,11
41,2023-08-12T02:32:00+10:00,2023-08-12,02:32,7,4,11
41,2023-08-12T02:34:00+10:00,2023-08-12,02:34,1,3,4
41,2023-08-12T02:37:00+10:00,2023-08-12,02:37,2,4,6
41,2023-08-12T02:39:00+10:00,2023-08-12,02:39,2,1,3
54,2023-08-12T02:29:00+10:00,2023-08-12,02:29,2,0,2
55,2023-08-12T02:25:00+10:00,2023-08-12,02:25,9,0,9
55,2023-08-12T02:26:00+10:00,2023-08-12,02:26,2,0,2
55,2023-08-12T02:32:00+10:00,2023-08-12,02:32,5,1,6
55,2023-08-12T02:35:00+10:00,2023-08-12,02:35,6,0,6
55,2023-08-12T02:38:00+10:00,2023-08-12,02:38,2,1,3
61,2023-08-12T02:27:00+10:00,2023-08-12,02:27,0,1,1
61,2023-08-12T02:28:00+10:00,2023-08-12,02:28,0,1,1
61,2023-08-12T02:33:00+10:00,2023-08-12,02:33,2,0,2
65,2023-08-12T02:38:00+10:00,2023-08-12,02:38,1,0,1
66,2023-08-12T02:35:00+10:00,2023-08-12,02:35,0,1,1
66,2023-08-12T02:36:00+10:00,2023-08-12,02:36,1,0,1
69,2023-08-12T02:28:00+10:00,2023-08-12,02:28,0,1,1
75,2023-08-12T02:25:00+10:00,2023-08-12,02:25,0,2,2
75,2023-08-12T02:39:00+10:00,2023-08-12,02:39,0,4,4
84,2023-08-12T02:25:00+10:00,2023-08-12,02:25,5,15,20
87,2023-08-12T02:35:00+10:00,2023-08-12,02:35,2,0,2
107,2023-08-12T02:35:00+10:00,2023-08-12,02:35,1,2,3
108,2023-08-12T02:33:00+10:00,2023-08-12,02:33,3,3,6
108,2023-08-12T02:36:00+10:00,2023-08-12,02:36,1,0,1
1,2023-08-12T02:31:00+10:00,2023-08-12,02:31,4,2,6
2,2023-08-12T02:32:00+10:00,2023-08-12,02:32,3,0,3
2,2023-08-12T02:35:00+10:00,2023-08-12,02:35,2,0,2
2,2023-08-12T02:36:00+10:00,2023-08-12,02:36,2,2,4
2,2023-08-12T02:39:00+10:00,2023-08-12,02:39,1,1,2
9,2023-08-12T02:27:00+10:00,2023-08-12,02:27,0,1,1
9,2023-08-12T02:30:00+10:00,2023-08-12,02:30,0,2,2
9,2023-08-12T02:37:00+10:00,2023-08-12,02:37,0,2,2
17,2023-08-12T02:36:00+10:00,2023-08-12,02:36,1,0,1
24,2023-08-12T02:26:00+10:00,2023-08-12,02:26,0,3,3
24,2023-08-12T02:30:00+10:00,2023-08-12,02:30,3,0,3
24,2023-08-12T02:34:00+10:00,2023-08-12,02:34,0,2,2
24,2023-08-12T02:38:00+10:00,2023-08-12,02:38,2,0,2
24,2023-08-12T02:39:00+10:00,2023-08-12,02:39,0,3,3
27,2023-08-12T02:27:00+10:00,2023-08-12,02:27,0,3,3
35,2023-08-12T02:25:00+10:00,2023-08-12,02:25,2,3,5
35,2023-08-12T02:26:00+10:00,2023-08-12,02:26,1,1,2
35,2023-08-12T02:28:00+10:00,2023-08-12,02:28,0,2,2
35,2023-08-12T02:31:00+10:00,2023-08-12,02:31,2,2,4
35,2023-08-12T02:33:00+10:00,2023-08-12,02:33,8,0,8
35,2023-08-12T02:34:00+10:00,2023-08-12,02:34,4,1,5
35,2023-08-12T02:37:00+10:00,2023-08-12,02:37,0,2,2
35,2023-08-12T02:38:00+10:00,2023-08-12,02:38,2,1,3
53,2023-08-12T02:27:00+10:00,2023-08-12,02:27,1,0,1
53,2023-08-12T02:30:00+10:00,2023-08-12,02:30,0,2,2
53,2023-08-12T02:37:00+10:00,2023-08-12,02:37,0,2,2
56,2023-08-12T02:30:00+10:00,2023-08-12,02:30,0,2,2
56,2023-08-12T02:32:00+10:00,2023-08-12,02:32,1,0,1
56,2023-08-12T02:39:00+10:00,2023-08-12,02:39,2,0,2
58,2023-08-12T02:26:00+10:00,2023-08-12,02:26,1,0,1
58,2023-08-12T02:33:00+10:00,2023-08-12,02:33,0,3,3
58,2023-08-12T02:38:00+10:00,2023-08-12,02:38,2,2,4
62,2023-08-12T02:26:00+10:00,2023-08-12,02:26,1,0,1
62,2023-08-12T02:28:00+10:00,2023-08-12,02:28,2,0,2
62,2023-08-12T02:30:00+10:00,2023-08-12,02:30,2,0,2
62,2023-08-12T02:35:00+10:00,2023-08-12,02:35,2,0,2
63,2023-08-12T02:25:00+10:00,2023-08-12,02:25,0,7,7
63,2023-08-12T02:29:00+10:00,2023-08-12,02:29,1,1,2
63,2023-08-12T02:32:00+10:00,2023-08-12,02:32,1,0,1
63,2023-08-12T02:33:00+10:00,2023-08-12,02:33,0,6,6
67,2023-08-12T02:36:00+10:00,2023-08-12,02:36,8,0,8
72,2023-08-12T02:25:00+10:00,2023-08-12,02:25,0,1,1
72,2023-08-12T02:26:00+10:00,2023-08-12,02:26,0,1,1
79,2023-08-12T02:29:00+10:00,2023-08-12,02:29,0,1,1
79,2023-08-12T02:31:00+10:00,2023-08-12,02:31,0,5,5
79,2023-08-12T02:32:00+10:00,2023-08-12,02:32,0,2,2
79,2023-08-12T02:37:00+10:00,2023-08-12,02:37,3,4,7
109,2023-08-12T02:25:00+10:00,2023-08-12,02:25,0,1,1
122,2023-08-12T02:35:00+10:00,2023-08-12,02:35,0,6,6
3,2023-08-12T02:40:00+10:00,2023-08-12,02:40,1,2,3
3,2023-08-12T02:44:00+10:00,2023-08-12,02:44,10,2,12
3,2023-08-12T02:47:00+10:00,2023-08-12,02:47,5,0,5
3,2023-08-12T02:50:00+10:00,2023-08-12,02:50,7,2,9
3,2023-08-12T02:53:00+10:00,2023-08-12,02:53,0,2,2
4,2023-08-12T02:45:00+10:00,2023-08-12,02:45,1,0,1
4,2023-08-12T02:51:00+10:00,2023-08-12,02:51,4,0,4
6,2023-08-12T02:40:00+10:00,2023-08-12,02:40,0,3,3
6,2023-08-12T02:41:00+10:00,2023-08-12,02:41,1,2,3
6,2023-08-12T02:50:00+10:00,2023-08-12,02:50,1,1,2
6,2023-08-12T02:53:00+10:00,2023-08-12,02:53,1,0,1
14,2023-08-12T02:41:00+10:00,2023-08-12,02:41,2,0,2
14,2023-08-12T02:43:00+10:00,2023-08-12,02:43,0,1,1
14,2023-08-12T02:45:00+10:00,2023-08-12,02:45,2,0,2
14,2023-08-12T02:49:00+10:00,2023-08-12,02:49,1,0,1
14,2023-08-12T02:52:00+10:00,2023-08-12,02:52,5,0,5
21,2023-08-12T02:42:00+10:00,2023-08-12,02:42,4,1,5
21,2023-08-12T02:44:00+10:00,2023-08-12,02:44,0,2,2
21,2023-08-12T02:46:00+10:00,2023-08-12,02:46,0,1,1
21,2023-08-12T02:47:00+10:00,2023-08-12,02:47,2,5,7
21,2023-08-12T02:52:00+10:00,2023-08-12,02:52,0,3,3
21,2023-08-12T02:54:00+10:00,2023-08-12,02:54,0,2,2
28,2023-08-12T02:40:00+10:00,2023-08-12,02:40,1,0,1
28,2023-08-12T02:50:00+10:00,2023-08-12,02:50,0,1,1
28,2023-08-12T02:51:00+10:00,2023-08-12,02:51,0,1,1
29,2023-08-12T02:49:00+10:00,2023-08-12,02:49,0,1,1
29,2023-08-12T02:50:00+10:00,2023-08-12,02:50,0,1,1
41,2023-08-12T02:42:00+10:00,2023-08-12,02:42,3,1,4
41,2023-08-12T02:45:00+10:00,2023-08-12,02:45,0,7,7
41,2023-08-12T02:49:00+10:00,2023-08-12,02:49,4,5,9
41,2023-08-12T02:54:00+10:00,2023-08-12,02:54,0,9,9
55,2023-08-12T02:43:00+10:00,2023-08-12,02:43,0,3,3
55,2023-08-12T02:45:00+10:00,2023-08-12,02:45,1,1,2
55,2023-08-12T02:48:00+10:00,2023-08-12,02:48,2,2,4
55,2023-08-12T02:53:00+10:00,2023-08-12,02:53,1,2,3
55,2023-08-12T02:54:00+10:00,2023-08-12,02:54,1,0,1
59,2023-08-12T02:50:00+10:00,2023-08-12,02:50,3,0,3
61,2023-08-12T02:41:00+10:00,2023-08-12,02:41,3,0,3
61,2023-08-12T02:54:00+10:00,2023-08-12,02:54,0,1,1
65,2023-08-12T02:42:00+10:00,2023-08-12,02:42,2,0,2
65,2023-08-12T02:46:00+10:00,2023-08-12,02:46,0,3,3
66,2023-08-12T02:40:00+10:00,2023-08-12,02:40,1,1,2
66,2023-08-12T02:44:00+10:00,2023-08-12,02:44,1,0,1
66,2023-08-12T02:48:00+10:00,2023-08-12,02:48,1,0,1
66,2023-08-12T02:49:00+10:00,2023-08-12,02:49,1,0,1
75,2023-08-12T02:50:00+10:00,2023-08-12,02:50,1,0,1
77,2023-08-12T02:43:00+10:00,2023-08-12,02:43,0,1,1
84,2023-08-12T02:45:00+10:00,2023-08-12,02:45,3,4,7
87,2023-08-12T02:48:00+10:00,2023-08-12,02:48,2,0,2
87,2023-08-12T02:51:00+10:00,2023-08-12,02:51,0,2,2
108,2023-08-12T02:43:00+10:00,2023-08-12,02:43,2,0,2
1,2023-08-12T02:47:00+10:00,2023-08-12,02:47,1,2,3
2,2023-08-12T02:41:00+10:00,2023-08-12,02:41,0,1,1
2,2023-08-12T02:43:00+10:00,2023-08-12,02:43,2,1,3
2,2023-08-12T02:50:00+10:00,2023-08-12,02:50,2,0,2
7,2023-08-12T02:41:00+10:00,2023-08-12,02:41,2,0,2
9,2023-08-12T02:54:00+10:00,2023-08-12,02:54,0,1,1
12,2023-08-12T02:45:00+10:00,2023-08-12,02:45,2,0,2
17,2023-08-12T02:42:00+10:00,2023-08-12,02:42,0,1,1
17,2023-08-12T02:45:00+10:00,2023-08-12,02:45,1,0,1
24,2023-08-12T02:41:00+10:00,2023-08-12,02:41,3,0,3
24,2023-08-12T02:42:00+10:00,2023-08-12,02:42,3,1,4
24,2023-08-12T02:45:00+10:00,2023-08-12,02:45,3,0,3
24,2023-08-12T02:54:00+10:00,2023-08-12,02:54,0,2,2
35,2023-08-12T02:40:00+10:00,2023-08-12,02:40,3,1,4
35,2023-08-12T02:42:00+10:00,2023-08-12,02:42,0,8,8
35,2023-08-12T02:46:00+10:00,2023-08-12,02:46,2,5,7
35,2023-08-12T02:48:00+10:00,2023-08-12,02:48,2,1,3
35,2023-08-12T02:50:00+10:00,2023-08-12,02:50,1,3,4
35,2023-08-12T02:54:00+10:00,2023-08-12,02:54,1,0,1
53,2023-08-12T02:48:00+10:00,2023-08-12,02:48,0,1,1
53,2023-08-12T02:52:00+10:00,2023-08-12,02:52,0,1,1
56,2023-08-12T02:40:00+10:00,2023-08-12,02:40,1,1,2
56,2023-08-12T02:42:00+10:00,2023-08-12,02:42,1,0,1
56,2023-08-12T02:48:00+10:00,2023-08-12,02:48,6,1,7
56,2023-08-12T02:51:00+10:00,2023-08-12,02:51,4,0,4
62,2023-08-12T02:40:00+10:00,2023-08-12,02:40,3,4,7
62,2023-08-12T02:42:00+10:00,2023-08-12,02:42,5,0,5
62,2023-08-12T02:47:00+10:00,2023-08-12,02:47,0,1,1
62,2023-08-12T02:52:00+10:00,2023-08-12,02:52,0,1,1
63,2023-08-12T02:45:00+10:00,2023-08-12,02:45,0,1,1
63,2023-08-12T02:48:00+10:00,2023-08-12,02:48,0,1,1
63,2023-08-12T02:49:00+10:00,2023-08-12,02:49,1,0,1
63,2023-08-12T02:51:00+10:00,2023-08-12,02:51,0,2,2
63,2023-08-12T02:52:00+10:00,2023-08-12,02:52,0,4,4
63,2023-08-12T02:54:00+10:00,2023-08-12,02:54,0,9,9
67,2023-08-12T02:41:00+10:00,2023-08-12,02:41,0,1,1
67,2023-08-12T02:42:00+10:00,2023-08-12,02:42,0,1,1
67,2023-08-12T02:44:00+10:00,2023-08-12,02:44,2,0,2
67,2023-08-12T02:45:00+10:00,2023-08-12,02:45,1,0,1
67,2023-08-12T02:47:00+10:00,2023-08-12,02:47,0,2,2
72,2023-08-12T02:42:00+10:00,2023-08-12,02:42,0,1,1
79,2023-08-12T02:41:00+10:00,2023-08-12,02:41,0,1,1
79,2023-08-12T02:45:00+10:00,2023-08-12,02:45,2,1,3
79,2023-08-12T02:46:00+10:00,2023-08-12,02:46,1,0,1
79,2023-08-12T02:47:00+10:00,2023-08-12,02:47,1,2,3
79,2023-08-12T02:48:00+10:00,2023-08-12,02:48,2,0,2
109,2023-08-12T02:50:00+10:00,2023-08-12,02:50,3,0,3
122,2023-08-12T02:44:00+10:00,2023-08-12,02:44,0,2,2
3,2023-08-12T02:59:00+10:00,2023-08-12,02:59,6,3,9
3,2023-08-12T03:01:00+10:00,2023-08-12,03:01,2,2,4
3,2023-08-12T03:03:00+10:00,2023-08-12,03:03,9,0,9
3,2023-08-12T03:07:00+10:00,2023-08-12,03:07,7,0,7
3,2023-08-12T03:09:00+10:00,2023-08-12,03:09,8,0,8
4,2023-08-12T02:55:00+10:00,2023-08-12,02:55,0,2,2
4,2023-08-12T02:57:00+10:00,2023-08-12,02:57,3,2,5
4,2023-08-12T03:03:00+10:00,2023-08-12,03:03,0,2,2
6,2023-08-12T03:03:00+10:00,2023-08-12,03:03,1,2,3
6,2023-08-12T03:04:00+10:00,2023-08-12,03:04,3,1,4
6,2023-08-12T03:05:00+10:00,2023-08-12,03:05,2,0,2
6,2023-08-12T03:06:00+10:00,2023-08-12,03:06,4,0,4
14,2023-08-12T03:03:00+10:00,2023-08-12,03:03,4,0,4
14,2023-08-12T03:07:00+10:00,2023-08-12,03:07,1,0,1
14,2023-08-12T03:08:00+10:00,2023-08-12,03:08,5,0,5
21,2023-08-12T03:01:00+10:00,2023-08-12,03:01,0,1,1
21,2023-08-12T03:03:00+10:00,2023-08-12,03:03,3,0,3
21,2023-08-12T03:05:00+10:00,2023-08-12,03:05,4,0,4
21,2023-08-12T03:06:00+10:00,2023-08-12,03:06,3,4,7
21,2023-08-12T03:07:00+10:00,2023-08-12,03:07,4,0,4
28,2023-08-12T03:00:00+10:00,2023-08-12,03:00,0,1,1
28,2023-08-12T03:01:00+10:00,2023-08-12,03:01,2,0,2
29,2023-08-12T02:58:00+10:00,2023-08-12,02:58,0,1,1
29,2023-08-12T03:01:00+10:00,2023-08-12,03:01,0,1,1
41,2023-08-12T02:56:00+10:00,2023-08-12,02:56,0,2,2
41,2023-08-12T02:58:00+10:00,2023-08-12,02:58,2,5,7
41,2023-08-12T03:00:00+10:00,2023-08-12,03:00,0,2,2
41,2023-08-12T03:01:00+10:00,2023-08-12,03:01,0,2,2
41,2023-08-12T03:04:00+10:00,2023-08-12,03:04,0,6,6
54,2023-08-12T03:04:00+10:00,2023-08-12,03:04,0,1,1
54,2023-08-12T03:06:00+10:00,2023-08-12,03:06,1,0,1
55,2023-08-12T02:55:00+10:00,2023-08-12,02:55,4,0,4
55,2023-08-12T03:00:00+10:00,2023-08-12,03:00,1,0,1
55,2023-08-12T03:01:00+10:00,2023-08-12,03:01,5,2,7
55,2023-08-12T03:08:00+10:00,2023-08-12,03:08,2,1,3
59,2023-08-12T03:00:00+10:00,2023-08-12,03:00,2,0,2
59,2023-08-12T03:05:00+10:00,2023-08-12,03:05,8,5,13
61,2023-08-12T03:03:00+10:00,2023-08-12,03:03,1,0,1
61,2023-08-12T03:09:00+10:00,2023-08-12,03:09,2,0,2
65,2023-08-12T02:55:00+10:00,2023-08-12,02:55,0,1,1
65,2023-08-12T03:06:00+10:00,2023-08-12,03:06,0,2,2
65,2023-08-12T03:08:00+10:00,2023-08-12,03:08,5,4,9
66,2023-08-12T02:59:00+10:00,2023-08-12,02:59,0,1,1
66,2023-08-12T03:06:00+10:00,2023-08-12,03:06,1,0,1
66,2023-08-12T03:08:00+10:00,2023-08-12,03:08,1,0,1
66,2023-08-12T03:09:00+10:00,2023-08-12,03:09,2,0,2
69,2023-08-12T02:58:00+10:00,2023-08-12,02:58,1,1,2
84,2023-08-12T03:00:00+10:00,2023-08-12,03:00,8,5,13
87,2023-08-12T03:08:00+10:00,2023-08-12,03:08,0,1,1
108,2023-08-12T02:56:00+10:00,2023-08-12,02:56,4,0,4
108,2023-08-12T02:57:00+10:00,2023-08-12,02:57,2,0,2
108,2023-08-12T03:05:00+10:00,2023-08-12,03:05,1,0,1
1,2023-08-12T03:00:00+10:00,2023-08-12,03:00,0,2,2
1,2023-08-12T03:02:00+10:00,2023-08-12,03:02,0,1,1
1,2023-08-12T03:06:00+10:00,2023-08-12,03:06,1,0,1
17,2023-08-12T02:56:00+10:00,2023-08-12,02:56,0,1,1
17,2023-08-12T02:57:00+10:00,2023-08-12,02:57,1,0,1
17,2023-08-12T03:06:00+10:00,2023-08-12,03:06,1,0,1
18,2023-08-12T02:57:00+10:00,2023-08-12,02:57,0,1,1
24,2023-08-12T02:58:00+10:00,2023-08-12,02:58,0,2,2
24,2023-08-12T03:03:00+10:00,2023-08-12,03:03,0,1,1
24,2023-08-12T03:07:00+10:00,2023-08-12,03:07,1,4,5
24,2023-08-12T03:08:00+10:00,2023-08-12,03:08,0,3,3
27,2023-08-12T03:00:00+10:00,2023-08-12,03:00,1,0,1
27,2023-08-12T03:01:00+10:00,2023-08-12,03:01,2,0,2
27,2023-08-12T03:03:00+10:00,2023-08-12,03:03,0,2,2
35,2023-08-12T02:58:00+10:00,2023-08-12,02:58,0,3,3
35,2023-08-12T03:01:00+10:00,2023-08-12,03:01,2,0,2
35,2023-08-12T03:06:00+10:00,2023-08-12,03:06,0,3,3
35,2023-08-12T03:07:00+10:00,2023-08-12,03:07,0,1,1
53,2023-08-12T03:05:00+10:00,2023-08-12,03:05,0,1,1
53,2023-08-12T03:07:00+10:00,2023-08-12,03:07,0,3,3
56,2023-08-12T02:56:00+10:00,2023-08-12,02:56,0,4,4
56,2023-08-12T02:59:00+10:00,2023-08-12,02:59,2,1,3
56,2023-08-12T03:05:00+10:00,2023-08-12,03:05,1,0,1
57,2023-08-12T03:08:00+10:00,2023-08-12,03:08,2,0,2
58,2023-08-12T03:08:00+10:00,2023-08-12,03:08,2,0,2
62,2023-08-12T02:56:00+10:00,2023-08-12,02:56,0,2,2
62,2023-08-12T02:57:00+10:00,2023-08-12,02:57,4,0,4
63,2023-08-12T02:59:00+10:00,2023-08-12,02:59,0,4,4
63,2023-08-12T03:02:00+10:00,2023-08-12,03:02,0,1,1
63,2023-08-12T03:07:00+10:00,2023-08-12,03:07,1,4,5
63,2023-08-12T03:08:00+10:00,2023-08-12,03:08,0,1,1
67,2023-08-12T03:09:00+10:00,2023-08-12,03:09,1,0,1
72,2023-08-12T03:04:00+10:00,2023-08-12,03:04,1,0,1
72,2023-08-12T03:07:00+10:00,2023-08-12,03:07,0,1,1
79,2023-08-12T02:56:00+10:00,2023-08-12,02:56,5,0,5
79,2023-08-12T02:59:00+10:00,2023-08-12,02:59,5,0,5
79,2023-08-12T03:00:00+10:00,2023-08-12,03:00,1,0,1
79,2023-08-12T03:01:00+10:00,2023-08-12,03:01,0,3,3
109,2023-08-12T02:55:00+10:00,2023-08-12,02:55,0,1,1
3,2023-08-12T03:12:00+10:00,2023-08-12,03:12,3,0,3
3,2023-08-12T03:14:00+10:00,2023-08-12,03:14,14,3,17
3,2023-08-12T03:18:00+10:00,2023-08-12,03:18,5,3,8
3,2023-08-12T03:20:00+10:00,2023-08-12,03:20,2,4,6
4,2023-08-12T03:12:00+10:00,2023-08-12,03:12,1,0,1
4,2023-08-12T03:16:00+10:00,2023-08-12,03:16,0,1,1
6,2023-08-12T03:10:00+10:00,2023-08-12,03:10,2,0,2
6,2023-08-12T03:13:00+10:00,2023-08-12,03:13,2,2,4
6,2023-08-12T03:14:00+10:00,2023-08-12,03:14,2,1,3
6,2023-08-12T03:17:00+10:00,2023-08-12,03:17,4,0,4
6,2023-08-12T03:18:00+10:00,2023-08-12,03:18,0,3,3
6,2023-08-12T03:21:00+10:00,2023-08-12,03:21,2,0,2
8,2023-08-12T03:16:00+10:00,2023-08-12,03:16,2,0,2
14,2023-08-12T03:13:00+10:00,2023-08-12,03:13,4,0,4
14,2023-08-12T03:14:00+10:00,2023-08-12,03:14,2,0,2
14,2023-08-12T03:20:00+10:00,2023-08-12,03:20,3,0,3
14,2023-08-12T03:22:00+10:00,2023-08-12,03:22,1,0,1
21,2023-08-12T03:17:00+10:00,2023-08-12,03:17,3,2,5
21,2023-08-12T03:18:00+10:00,2023-08-12,03:18,3,1,4
28,2023-08-12T03:20:00+10:00,2023-08-12,03:20,1,0,1
28,2023-08-12T03:22:00+10:00,2023-08-12,03:22,0,1,1
29,2023-08-12T03:20:00+10:00,2023-08-12,03:20,0,1,1
29,2023-08-12T03:24:00+10:00,2023-08-12,03:24,2,1,3
41,2023-08-12T03:10:00+10:00,2023-08-12,03:10,1,5,6
41,2023-08-12T03:12:00+10:00,2023-08-12,03:12,1,2,3
41,2023-08-12T03:15:00+10:00,2023-08-12,03:15,0,2,2
41,2023-08-12T03:17:00+10:00,2023-08-12,03:17,2,4,6
41,2023-08-12T03:18:00+10:00,2023-08-12,03:18,3,0,3
41,2023-08-12T03:19:00+10:00,2023-08-12,03:19,0,1,1
41,2023-08-12T03:21:00+10:00,2023-08-12,03:21,0,4,4
41,2023-08-12T03:22:00+10:00,2023-08-12,03:22,0,8,8
41,2023-08-12T03:23:00+10:00,2023-08-12,03:23,2,2,4
54,2023-08-12T03:17:00+10:00,2023-08-12,03:17,5,0,5
55,2023-08-12T03:12:00+10:00,2023-08-12,03:12,2,1,3
59,2023-08-12T03:20:00+10:00,2023-08-12,03:20,4,0,4
61,2023-08-12T03:19:00+10:00,2023-08-12,03:19,3,0,3
65,2023-08-12T03:10:00+10:00,2023-08-12,03:10,0,1,1
65,2023-08-12T03:17:00+10:00,2023-08-12,03:17,2,4,6
65,2023-08-12T03:24:00+10:00,2023-08-12,03:24,1,0,1
66,2023-08-12T03:11:00+10:00,2023-08-12,03:11,0,1,1
66,2023-08-12T03:21:00+10:00,2023-08-12,03:21,1,0,1
87,2023-08-12T03:11:00+10:00,2023-08-12,03:11,1,0,1
87,2023-08-12T03:23:00+10:00,2023-08-12,03:23,0,1,1
107,2023-08-12T03:15:00+10:00,2023-08-12,03:15,1,1,2
108,2023-08-12T03:17:00+10:00,2023-08-12,03:17,0,1,1
108,2023-08-12T03:19:00+10:00,2023-08-12,03:19,2,0,2
108,2023-08-12T03:20:00+10:00,2023-08-12,03:20,3,2,5
108,2023-08-12T03:22:00+10:00,2023-08-12,03:22,6,0,6
1,2023-08-12T03:11:00+10:00,2023-08-12,03:11,2,0,2
1,2023-08-12T03:12:00+10:00,2023-08-12,03:12,2,0,2
1,2023-08-12T03:15:00+10:00,2023-08-12,03:15,0,1,1
1,2023-08-12T03:17:00+10:00,2023-08-12,03:17,0,4,4
1,2023-08-12T03:23:00+10:00,2023-08-12,03:23,0,2,2
9,2023-08-12T03:14:00+10:00,2023-08-12,03:14,0,7,7
10,2023-08-12T03:18:00+10:00,2023-08-12,03:18,0,2,2
12,2023-08-12T03:11:00+10:00,2023-08-12,03:11,2,0,2
17,2023-08-12T03:23:00+10:00,2023-08-12,03:23,0,1,1
24,2023-08-12T03:20:00+10:00,2023-08-12,03:20,1,1,2
35,2023-08-12T03:15:00+10:00,2023-08-12,03:15,3,1,4
35,2023-08-12T03:22:00+10:00,2023-08-12,03:22,3,1,4
53,2023-08-12T03:10:00+10:00,2023-08-12,03:10,0,3,3
56,2023-08-12T03:15:00+10:00,2023-08-12,03:15,3,0,3
56,2023-08-12T03:18:00+10:00,2023-08-12,03:18,1,0,1
56,2023-08-12T03:24:00+10:00,2023-08-12,03:24,6,0,6
58,2023-08-12T03:19:00+10:00,2023-08-12,03:19,7,0,7
58,2023-08-12T03:23:00+10:00,2023-08-12,03:23,0,2,2
62,2023-08-12T03:13:00+10:00,2023-08-12,03:13,2,0,2
62,2023-08-12T03:20:00+10:00,2023-08-12,03:20,0,9,9
62,2023-08-12T03:22:00+10:00,2023-08-12,03:22,1,0,1
62,2023-08-12T03:24:00+10:00,2023-08-12,03:24,3,0,3
63,2023-08-12T03:23:00+10:00,2023-08-12,03:23,0,2,2
67,2023-08-12T03:12:00+10:00,2023-08-12,03:12,0,4,4
67,2023-08-12T03:24:00+10:00,2023-08-12,03:24,0,1,1
72,2023-08-12T03:10:00+10:00,2023-08-12,03:10,0,5,5
72,2023-08-12T03:12:00+10:00,2023-08-12,03:12,0,1,1
76,2023-08-12T03:22:00+10:00,2023-08-12,03:22,2,0,2
79,2023-08-12T03:10:00+10:00,2023-08-12,03:10,1,0,1
79,2023-08-12T03:18:00+10:00,2023-08-12,03:18,0,2,2
79,2023-08-12T03:19:00+10:00,2023-08-12,03:19,2,1,3
3,2023-08-12T03:26:00+10:00,2023-08-12,03:26,2,0,2
3,2023-08-12T03:31:00+10:00,2023-08-12,03:31,1,3,4
3,2023-08-12T03:33:00+10:00,2023-08-12,03:33,4,2,6
3,2023-08-12T03:35:00+10:00,2023-08-12,03:35,4,1,5
3,2023-08-12T03:38:00+10:00,2023-08-12,03:38,4,6,10
3,2023-08-12T03:39:00+10:00,2023-08-12,03:39,3,3,6
4,2023-08-12T03:30:00+10:00,2023-08-12,03:30,1,6,7
4,2023-08-12T03:32:00+10:00,2023-08-12,03:32,0,2,2
4,2023-08-12T03:36:00+10:00,2023-08-12,03:36,5,0,5
6,2023-08-12T03:26:00+10:00,2023-08-12,03:26,9,0,9
6,2023-08-12T03:29:00+10:00,2023-08-12,03:29,1,0,1
6,2023-08-12T03:30:00+10:00,2023-08-12,03:30,1,0,1
6,2023-08-12T03:36:00+10:00,2023-08-12,03:36,0,4,4
14,2023-08-12T03:32:00+10:00,2023-08-12,03:32,2,0,2
21,2023-08-12T03:25:00+10:00,2023-08-12,03:25,3,0,3
21,2023-08-12T03:27:00+10:00,2023-08-12,03:27,0,3,3
21,2023-08-12T03:30:00+10:00,2023-08-12,03:30,1,1,2
28,2023-08-12T03:32:00+10:00,2023-08-12,03:32,1,1,2
28,2023-08-12T03:34:00+10:00,2023-08-12,03:34,1,0,1
28,2023-08-12T03:36:00+10:00,2023-08-12,03:36,0,1,1
29,2023-08-12T03:37:00+10:00,2023-08-12,03:37,0,1,1
41,2023-08-12T03:25:00+10:00,2023-08-12,03:25,0,1,1
41,2023-08-12T03:32:00+10:00,2023-08-12,03:32,0,4,4
41,2023-08-12T03:33:00+10:00,2023-08-12,03:33,3,7,10
41,2023-08-12T03:35:00+10:00,2023-08-12,03:35,1,2,3
41,2023-08-12T03:39:00+10:00,2023-08-12,03:39,0,2,2
54,2023-08-12T03:28:00+10:00,2023-08-12,03:28,2,0,2
55,2023-08-12T03:26:00+10:00,2023-08-12,03:26,1,0,1
55,2023-08-12T03:34:00+10:00,2023-08-12,03:34,8,0,8
55,2023-08-12T03:35:00+10:00,2023-08-12,03:35,0,1,1
55,2023-08-12T03:36:00+10:00,2023-08-12,03:36,9,1,10
55,2023-08-12T03:38:00+10:00,2023-08-12,03:38,0,1,1
55,2023-08-12T03:39:00+10:00,2023-08-12,03:39,4,0,4
59,2023-08-12T03:25:00+10:00,2023-08-12,03:25,8,1,9
59,2023-08-12T03:30:00+10:00,2023-08-12,03:30,5,4,9
61,2023-08-12T03:28:00+10:00,2023-08-12,03:28,0,3,3
61,2023-08-12T03:32:00+10:00,2023-08-12,03:32,1,0,1
61,2023-08-12T03:34:00+10:00,2023-08-12,03:34,9,0,9
61,2023-08-12T03:35:00+10:00,2023-08-12,03:35,3,1,4
61,2023-08-12T03:38:00+10:00,2023-08-12,03:38,1,0,1
65,2023-08-12T03:32:00+10:00,2023-08-12,03:32,0,3,3
65,2023-08-12T03:38:00+10:00,2023-08-12,03:38,0,1,1
66,2023-08-12T03:26:00+10:00,2023-08-12,03:26,2,4,6
66,2023-08-12T03:28:00+10:00,2023-08-12,03:28,8,0,8
66,2023-08-12T03:29:00+10:00,2023-08-12,03:29,7,2,9
66,2023-08-12T03:31:00+10:00,2023-08-12,03:31,1,3,4
66,2023-08-12T03:32:00+10:00,2023-08-12,03:32,3,0,3
66,2023-08-12T03:39:00+10:00,2023-08-12,03:39,2,0,2
77,2023-08-12T03:27:00+10:00,2023-08-12,03:27,2,0,2
84,2023-08-12T03:35:00+10:00,2023-08-12,03:35,8,4,12
107,2023-08-12T03:35:00+10:00,2023-08-12,03:35,1,0,1
108,2023-08-12T03:33:00+10:00,2023-08-12,03:33,1,0,1
1,2023-08-12T03:30:00+10:00,2023-08-12,03:30,1,0,1
2,2023-08-12T03:39:00+10:00,2023-08-12,03:39,0,1,1
12,2023-08-12T03:32:00+10:00,2023-08-12,03:32,0,1,1
17,2023-08-12T03:25:00+10:00,2023-08-12,03:25,0,1,1
17,2023-08-12T03:27:00+10:00,2023-08-12,03:27,1,0,1
17,2023-08-12T03:29:00+10:00,2023-08-12,03:29,1,1,2
17,2023-08-12T03:34:00+10:00,2023-08-12,03:34,2,0,2
24,2023-08-12T03:28:00+10:00,2023-08-12,03:28,3,1,4
24,2023-08-12T03:29:00+10:00,2023-08-12,03:29,0,3,3
24,2023-08-12T03:39:00+10:00,2023-08-12,03:39,0,7,7
27,2023-08-12T03:32:00+10:00,2023-08-12,03:32,1,0,1
35,2023-08-12T03:27:00+10:00,2023-08-12,03:27,4,0,4
35,2023-08-12T03:34:00+10:00,2023-08-12,03:34,0,2,2
56,2023-08-12T03:27:00+10:00,2023-08-12,03:27,0,1,1
56,2023-08-12T03:31:00+10:00,2023-08-12,03:31,1,0,1
57,2023-08-12T03:39:00+10:00,2023-08-12,03:39,0,4,4
58,2023-08-12T03:26:00+10:00,2023-08-12,03:26,1,0,1
58,2023-08-12T03:27:00+10:00,2023-08-12,03:27,0,1,1
62,2023-08-12T03:27:00+10:00,2023-08-12,03:27,4,0,4
62,2023-08-12T03:34:00+10:00,2023-08-12,03:34,5,1,6
62,2023-08-12T03:35:00+10:00,2023-08-12,03:35,2,6,8
62,2023-08-12T03:36:00+10:00,2023-08-12,03:36,0,1,1
63,2023-08-12T03:26:00+10:00,2023-08-12,03:26,0,1,1
63,2023-08-12T03:33:00+10:00,2023-08-12,03:33,0,3,3
63,2023-08-12T03:36:00+10:00,2023-08-12,03:36,1,0,1
63,2023-08-12T03:37:00+10:00,2023-08-12,03:37,1,0,1
67,2023-08-12T03:39:00+10:00,2023-08-12,03:39,3,0,3
72,2023-08-12T03:27:00+10:00,2023-08-12,03:27,2,0,2
72,2023-08-12T03:28:00+10:00,2023-08-12,03:28,3,0,3
79,2023-08-12T03:25:00+10:00,2023-08-12,03:25,1,3,4
79,2023-08-12T03:27:00+10:00,2023-08-12,03:27,2,3,5
79,2023-08-12T03:29:00+10:00,2023-08-12,03:29,7,0,7
79,2023-08-12T03:32:00+10:00,2023-08-12,03:32,1,0,1
79,2023-08-12T03:33:00+10:00,2023-08-12,03:33,0,1,1
79,2023-08-12T03:35:00+10:00,2023-08-12,03:35,1,0,1
79,2023-08-12T03:36:00+10:00,2023-08-12,03:36,1,1,2
109,2023-08-12T03:25:00+10:00,2023-08-12,03:25,1,0,1
3,2023-08-12T03:45:00+10:00,2023-08-12,03:45,2,1,3
3,2023-08-12T03:49:00+10:00,2023-08-12,03:49,2,0,2
3,2023-08-12T03:54:00+10:00,2023-08-12,03:54,1,1,2
4,2023-08-12T03:40:00+10:00,2023-08-12,03:40,1,2,3
4,2023-08-12T03:41:00+10:00,2023-08-12,03:41,2,4,6
4,2023-08-12T03:43:00+10:00,2023-08-12,03:43,0,4,4
4,2023-08-12T03:45:00+10:00,2023-08-12,03:45,1,0,1
4,2023-08-12T03:47:00+10:00,2023-08-12,03:47,1,4,5
4,2023-08-12T03:50:00+10:00,2023-08-12,03:50,0,2,2
4,2023-08-12T03:53:00+10:00,2023-08-12,03:53,2,1,3
6,2023-08-12T03:43:00+10:00,2023-08-12,03:43,1,0,1
6,2023-08-12T03:48:00+10:00,2023-08-12,03:48,2,0,2
6,2023-08-12T03:51:00+10:00,2023-08-12,03:51,1,0,1
6,2023-08-12T03:54:00+10:00,2023-08-12,03:54,0,1,1
14,2023-08-12T03:43:00+10:00,2023-08-12,03:43,1,0,1
14,2023-08-12T03:45:00+10:00,2023-08-12,03:45,1,0,1
21,2023-08-12T03:43:00+10:00,2023-08-12,03:43,0,1,1
21,2023-08-12T03:46:00+10:00,2023-08-12,03:46,1,0,1
21,2023-08-12T03:51:00+10:00,2023-08-12,03:51,1,1,2
28,2023-08-12T03:43:00+10:00,2023-08-12,03:43,1,1,2
28,2023-08-12T03:49:00+10:00,2023-08-12,03:49,0,5,5
28,2023-08-12T03:51:00+10:00,2023-08-12,03:51,2,0,2
29,2023-08-12T03:44:00+10:00,2023-08-12,03:44,0,1,1
41,2023-08-12T03:41:00+10:00,2023-08-12,03:41,3,2,5
41,2023-08-12T03:45:00+10:00,2023-08-12,03:45,2,6,8
41,2023-08-12T03:47:00+10:00,2023-08-12,03:47,7,13,20
54,2023-08-12T03:47:00+10:00,2023-08-12,03:47,1,0,1
55,2023-08-12T03:45:00+10:00,2023-08-12,03:45,4,0,4
55,2023-08-12T03:47:00+10:00,2023-08-12,03:47,1,3,4
55,2023-08-12T03:50:00+10:00,2023-08-12,03:50,1,2,3
59,2023-08-12T03:40:00+10:00,2023-08-12,03:40,5,2,7
59,2023-08-12T03:45:00+10:00,2023-08-12,03:45,6,0,6
59,2023-08-12T03:50:00+10:00,2023-08-12,03:50,1,0,1
61,2023-08-12T03:53:00+10:00,2023-08-12,03:53,0,2,2
61,2023-08-12T03:54:00+10:00,2023-08-12,03:54,1,0,1
66,2023-08-12T03:40:00+10:00,2023-08-12,03:40,2,1,3
66,2023-08-12T03:46:00+10:00,2023-08-12,03:46,1,0,1
66,2023-08-12T03:49:00+10:00,2023-08-12,03:49,2,0,2
66,2023-08-12T03:54:00+10:00,2023-08-12,03:54,4,0,4
77,2023-08-12T03:44:00+10:00,2023-08-12,03:44,0,1,1
84,2023-08-12T03:50:00+10:00,2023-08-12,03:50,11,11,22
87,2023-08-12T03:40:00+10:00,2023-08-12,03:40,1,0,1
87,2023-08-12T03:43:00+10:00,2023-08-12,03:43,0,1,1
1,2023-08-12T03:42:00+10:00,2023-08-12,03:42,2,0,2
10,2023-08-12T03:44:00+10:00,2023-08-12,03:44,0,2,2
24,2023-08-12T03:43:00+10:00,2023-08-12,03:43,0,2,2
24,2023-08-12T03:48:00+10:00,2023-08-12,03:48,1,0,1
27,2023-08-12T03:51:00+10:00,2023-08-12,03:51,1,0,1
35,2023-08-12T03:52:00+10:00,2023-08-12,03:52,0,1,1
53,2023-08-12T03:46:00+10:00,2023-08-12,03:46,0,1,1
53,2023-08-12T03:54:00+10:00,2023-08-12,03:54,1,0,1
56,2023-08-12T03:44:00+10:00,2023-08-12,03:44,3,0,3
56,2023-08-12T03:48:00+10:00,2023-08-12,03:48,0,1,1
56,2023-08-12T03:53:00+10:00,2023-08-12,03:53,1,0,1
57,2023-08-12T03:53:00+10:00,2023-08-12,03:53,0,1,1
58,2023-08-12T03:54:00+10:00,2023-08-12,03:54,2,3,5
62,2023-08-12T03:45:00+10:00,2023-08-12,03:45,5,1,6
62,2023-08-12T03:46:00+10:00,2023-08-12,03:46,0,1,1
79,2023-08-12T03:46:00+10:00,2023-08-12,03:46,1,1,2
79,2023-08-12T03:47:00+10:00,2023-08-12,03:47,2,0,2
79,2023-08-12T03:49:00+10:00,2023-08-12,03:49,1,0,1
79,2023-08-12T03:50:00+10:00,2023-08-12,03:50,0,2,2
3,2023-08-12T03:57:00+10:00,2023-08-12,03:57,1,0,1
3,2023-08-12T03:58:00+10:00,2023-08-12,03:58,6,1,7
3,2023-08-12T04:02:00+10:00,2023-08-12,04:02,7,0,7
4,2023-08-12T03:55:00+10:00,2023-08-12,03:55,0,2,2
4,2023-08-12T04:02:00+10:00,2023-08-12,04:02,0,1,1
6,2023-08-12T03:57:00+10:00,2023-08-12,03:57,4,1,5
6,2023-08-12T04:04:00+10:00,2023-08-12,04:04,1,0,1
6,2023-08-12T04:06:00+10:00,2023-08-12,04:06,0,1,1
6,2023-08-12T04:09:00+10:00,2023-08-12,04:09,1,0,1
14,2023-08-12T03:55:00+10:00,2023-08-12,03:55,1,0,1
14,2023-08-12T03:56:00+10:00,2023-08-12,03:56,4,0,4
21,2023-08-12T03:57:00+10:00,2023-08-12,03:57,0,3,3
21,2023-08-12T04:00:00+10:00,2023-08-12,04:00,0,6,6
21,2023-08-12T04:03:00+10:00,2023-08-12,04:03,0,1,1
28,2023-08-12T03:59:00+10:00,2023-08-12,03:59,2,0,2
28,2023-08-12T04:00:00+10:00,2023-08-12,04:00,1,0,1
28,2023-08-12T04:02:00+10:00,2023-08-12,04:02,0,2,2
41,2023-08-12T04:00:00+10:00,2023-08-12,04:00,0,2,2
41,2023-08-12T04:04:00+10:00,2023-08-12,04:04,2,0,2
41,2023-08-12T04:05:00+10:00,2023-08-12,04:05,2,0,2
41,2023-08-12T04:07:00+10:00,2023-08-12,04:07,1,1,2
41,2023-08-12T04:09:00+10:00,2023-08-12,04:09,0,1,1
54,2023-08-12T04:06:00+10:00,2023-08-12,04:06,1,1,2
54,2023-08-12T04:09:00+10:00,2023-08-12,04:09,1,0,1
55,2023-08-12T03:55:00+10:00,2023-08-12,03:55,2,1,3
55,2023-08-12T03:59:00+10:00,2023-08-12,03:59,3,0,3
55,2023-08-12T04:02:00+10:00,2023-08-12,04:02,2,0,2
55,2023-08-12T04:06:00+10:00,2023-08-12,04:06,2,0,2
55,2023-08-12T04:09:00+10:00,2023-08-12,04:09,4,4,8
59,2023-08-12T03:55:00+10:00,2023-08-12,03:55,0,1,1
61,2023-08-12T03:59:00+10:00,2023-08-12,03:59,6,0,6
61,2023-08-12T04:04:00+10:00,2023-08-12,04:04,5,0,5
61,2023-08-12T04:05:00+10:00,2023-08-12,04:05,5,0,5
65,2023-08-12T04:02:00+10:00,2023-08-12,04:02,1,2,3
65,2023-08-12T04:04:00+10:00,2023-08-12,04:04,0,2,2
65,2023-08-12T04:07:00+10:00,2023-08-12,04:07,0,2,2
65,2023-08-12T04:09:00+10:00,2023-08-12,04:09,0,1,1
66,2023-08-12T04:01:00+10:00,2023-08-12,04:01,2,1,3
66,2023-08-12T04:02:00+10:00,2023-08-12,04:02,5,1,6
66,2023-08-12T04:03:00+10:00,2023-08-12,04:03,2,0,2
66,2023-08-12T04:08:00+10:00,2023-08-12,04:08,1,1,2
84,2023-08-12T04:00:00+10:00,2023-08-12,04:00,3,7,10
84,2023-08-12T04:05:00+10:00,2023-08-12,04:05,9,9,18
107,2023-08-12T03:55:00+10:00,2023-08-12,03:55,1,0,1
1,2023-08-12T03:59:00+10:00,2023-08-12,03:59,1,0,1
1,2023-08-12T04:06:00+10:00,2023-08-12,04:06,0,2,2
2,2023-08-12T04:00:00+10:00,2023-08-12,04:00,0,1,1
9,2023-08-12T04:02:00+10:00,2023-08-12,04:02,1,0,1
24,2023-08-12T03:58:00+10:00,2023-08-12,03:58,0,1,1
24,2023-08-12T04:06:00+10:00,2023-08-12,04:06,1,1,2
24,2023-08-12T04:07:00+10:00,2023-08-12,04:07,0,2,2
27,2023-08-12T03:56:00+10:00,2023-08-12,03:56,0,1,1
35,2023-08-12T03:55:00+10:00,2023-08-12,03:55,1,0,1
35,2023-08-12T04:02:00+10:00,2023-08-12,04:02,0,2,2
35,2023-08-12T04:03:00+10:00,2023-08-12,04:03,0,1,1
35,2023-08-12T04:04:00+10:00,2023-08-12,04:04,0,2,2
53,2023-08-12T03:56:00+10:00,2023-08-12,03:56,1,0,1
53,2023-08-12T04:09:00+10:00,2023-08-12,04:09,5,0,5
56,2023-08-12T03:58:00+10:00,2023-08-12,03:58,0,1,1
56,2023-08-12T04:02:00+10:00,2023-08-12,04:02,3,0,3
56,2023-08-12T04:03:00+10:00,2023-08-12,04:03,0,3,3
58,2023-08-12T03:56:00+10:00,2023-08-12,03:56,2,0,2
62,2023-08-12T03:58:00+10:00,2023-08-12,03:58,5,0,5
63,2023-08-12T04:00:00+10:00,2023-08-12,04:00,1,1,2
63,2023-08-12T04:06:00+10:00,2023-08-12,04:06,0,1,1
63,2023-08-12T04:08:00+10:00,2023-08-12,04:08,0,5,5
67,2023-08-12T04:09:00+10:00,2023-08-12,04:09,1,0,1
68,2023-08-12T04:02:00+10:00,2023-08-12,04:02,1,0,1
72,2023-08-12T04:02:00+10:00,2023-08-12,04:02,1,0,1
76,2023-08-12T04:06:00+10:00,2023-08-12,04:06,1,0,1
79,2023-08-12T03:56:00+10:00,2023-08-12,03:56,5,0,5
79,2023-08-12T03:59:00+10:00,2023-08-12,03:59,4,0,4
79,2023-08-12T04:03:00+10:00,2023-08-12,04:03,1,0,1
79,2023-08-12T04:04:00+10:00,2023-08-12,04:04,3,0,3
79,2023-08-12T04:05:00+10:00,2023-08-12,04:05,0,1,1
109,2023-08-12T04:00:00+10:00,2023-08-12,04:00,0,1,1
3,2023-08-12T04:19:00+10:00,2023-08-12,04:19,0,2,2
3,2023-08-12T04:24:00+10:00,2023-08-12,04:24,1,0,1
4,2023-08-12T04:14:00+10:00,2023-08-12,04:14,0,2,2
4,2023-08-12T04:18:00+10:00,2023-08-12,04:18,0,3,3
4,2023-08-12T04:20:00+10:00,2023-08-12,04:20,0,1,1
6,2023-08-12T04:21:00+10:00,2023-08-12,04:21,1,0,1
14,2023-08-12T04:12:00+10:00,2023-08-12,04:12,1,0,1
14,2023-08-12T04:22:00+10:00,2023-08-12,04:22,1,1,2
21,2023-08-12T04:14:00+10:00,2023-08-12,04:14,2,0,2
21,2023-08-12T04:17:00+10:00,2023-08-12,04:17,2,0,2
21,2023-08-12T04:19:00+10:00,2023-08-12,04:19,4,0,4
21,2023-08-12T04:20:00+10:00,2023-08-12,04:20,0,2,2
41,2023-08-12T04:20:00+10:00,2023-08-12,04:20,0,2,2
41,2023-08-12T04:22:00+10:00,2023-08-12,04:22,0,1,1
41,2023-08-12T04:24:00+10:00,2023-08-12,04:24,2,0,2
55,2023-08-12T04:14:00+10:00,2023-08-12,04:14,3,1,4
55,2023-08-12T04:15:00+10:00,2023-08-12,04:15,1,2,3
55,2023-08-12T04:17:00+10:00,2023-08-12,04:17,3,1,4
55,2023-08-12T04:18:00+10:00,2023-08-12,04:18,2,2,4
55,2023-08-12T04:20:00+10:00,2023-08-12,04:20,2,1,3
61,2023-08-12T04:11:00+10:00,2023-08-12,04:11,2,0,2
75,2023-08-12T04:22:00+10:00,2023-08-12,04:22,0,1,1
84,2023-08-12T04:10:00+10:00,2023-08-12,04:10,5,1,6
84,2023-08-12T04:15:00+10:00,2023-08-12,04:15,7,6,13
1,2023-08-12T04:10:00+10:00,2023-08-12,04:10,1,0,1
1,2023-08-12T04:24:00+10:00,2023-08-12,04:24,2,1,3
17,2023-08-12T04:13:00+10:00,2023-08-12,04:13,1,0,1
24,2023-08-12T04:10:00+10:00,2023-08-12,04:10,0,3,3
24,2023-08-12T04:13:00+10:00,2023-08-12,04:13,0,2,2
27,2023-08-12T04:20:00+10:00,2023-08-12,04:20,1,0,1
35,2023-08-12T04:11:00+10:00,2023-08-12,04:11,3,1,4
35,2023-08-12T04:20:00+10:00,2023-08-12,04:20,1,0,1
35,2023-08-12T04:22:00+10:00,2023-08-12,04:22,0,2,2
35,2023-08-12T04:24:00+10:00,2023-08-12,04:24,0,1,1
53,2023-08-12T04:17:00+10:00,2023-08-12,04:17,3,0,3
56,2023-08-12T04:11:00+10:00,2023-08-12,04:11,0,1,1
56,2023-08-12T04:14:00+10:00,2023-08-12,04:14,3,0,3
56,2023-08-12T04:18:00+10:00,2023-08-12,04:18,4,0,4
57,2023-08-12T04:11:00+10:00,2023-08-12,04:11,1,0,1
58,2023-08-12T04:17:00+10:00,2023-08-12,04:17,2,0,2
58,2023-08-12T04:21:00+10:00,2023-08-12,04:21,0,2,2
62,2023-08-12T04:11:00+10:00,2023-08-12,04:11,2,0,2
62,2023-08-12T04:16:00+10:00,2023-08-12,04:16,4,6,10
63,2023-08-12T04:12:00+10:00,2023-08-12,04:12,1,1,2
67,2023-08-12T04:14:00+10:00,2023-08-12,04:14,0,2,2
67,2023-08-12T04:21:00+10:00,2023-08-12,04:21,2,0,2
72,2023-08-12T04:24:00+10:00,2023-08-12,04:24,4,0,4
79,2023-08-12T04:10:00+10:00,2023-08-12,04:10,0,2,2
79,2023-08-12T04:17:00+10:00,2023-08-12,04:17,2,0,2
79,2023-08-12T04:19:00+10:00,2023-08-12,04:19,1,3,4
79,2023-08-12T04:20:00+10:00,2023-08-12,04:20,0,1,1
3,2023-08-12T04:26:00+10:00,2023-08-12,04:26,0,1,1
3,2023-08-12T04:33:00+10:00,2023-08-12,04:33,0,1,1
3,2023-08-12T04:34:00+10:00,2023-08-12,04:34,2,0,2
4,2023-08-12T04:26:00+10:00,2023-08-12,04:26,2,0,2
4,2023-08-12T04:27:00+10:00,2023-08-12,04:27,1,1,2
4,2023-08-12T04:29:00+10:00,2023-08-12,04:29,0,1,1
4,2023-08-12T04:31:00+10:00,2023-08-12,04:31,2,0,2
6,2023-08-12T04:26:00+10:00,2023-08-12,04:26,0,1,1
14,2023-08-12T04:28:00+10:00,2023-08-12,04:28,2,0,2
21,2023-08-12T04:29:00+10:00,2023-08-12,04:29,0,2,2
21,2023-08-12T04:30:00+10:00,2023-08-12,04:30,0,1,1
21,2023-08-12T04:31:00+10:00,2023-08-12,04:31,1,4,5
21,2023-08-12T04:35:00+10:00,2023-08-12,04:35,0,3,3
21,2023-08-12T04:36:00+10:00,2023-08-12,04:36,0,1,1
21,2023-08-12T04:39:00+10:00,2023-08-12,04:39,1,1,2
28,2023-08-12T04:28:00+10:00,2023-08-12,04:28,0,2,2
29,2023-08-12T04:38:00+10:00,2023-08-12,04:38,0,1,1
41,2023-08-12T04:28:00+10:00,2023-08-12,04:28,2,0,2
41,2023-08-12T04:29:00+10:00,2023-08-12,04:29,0,3,3
41,2023-08-12T04:32:00+10:00,2023-08-12,04:32,0,5,5
41,2023-08-12T04:34:00+10:00,2023-08-12,04:34,1,1,2
41,2023-08-12T04:36:00+10:00,2023-08-12,04:36,1,2,3
41,2023-08-12T04:38:00+10:00,2023-08-12,04:38,3,0,3
55,2023-08-12T04:26:00+10:00,2023-08-12,04:26,2,0,2
55,2023-08-12T04:28:00+10:00,2023-08-12,04:28,3,0,3
55,2023-08-12T04:30:00+10:00,2023-08-12,04:30,7,2,9
55,2023-08-12T04:33:00+10:00,2023-08-12,04:33,4,0,4
55,2023-08-12T04:36:00+10:00,2023-08-12,04:36,3,0,3
55,2023-08-12T04:38:00+10:00,2023-08-12,04:38,1,0,1
55,2023-08-12T04:39:00+10:00,2023-08-12,04:39,1,1,2
61,2023-08-12T04:29:00+10:00,2023-08-12,04:29,0,1,1
65,2023-08-12T04:29:00+10:00,2023-08-12,04:29,0,2,2
65,2023-08-12T04:36:00+10:00,2023-08-12,04:36,0,1,1
66,2023-08-12T04:36:00+10:00,2023-08-12,04:36,1,0,1
66,2023-08-12T04:38:00+10:00,2023-08-12,04:38,1,0,1
84,2023-08-12T04:35:00+10:00,2023-08-12,04:35,6,4,10
108,2023-08-12T04:35:00+10:00,2023-08-12,04:35,1,0,1
108,2023-08-12T04:39:00+10:00,2023-08-12,04:39,0,1,1
1,2023-08-12T04:27:00+10:00,2023-08-12,04:27,3,0,3
1,2023-08-12T04:30:00+10:00,2023-08-12,04:30,1,0,1
1,2023-08-12T04:31:00+10:00,2023-08-12,04:31,1,0,1
17,2023-08-12T04:30:00+10:00,2023-08-12,04:30,1,0,1
24,2023-08-12T04:27:00+10:00,2023-08-12,04:27,0,8,8
24,2023-08-12T04:28:00+10:00,2023-08-12,04:28,0,3,3
24,2023-08-12T04:31:00+10:00,2023-08-12,04:31,0,2,2
24,2023-08-12T04:32:00+10:00,2023-08-12,04:32,2,2,4
35,2023-08-12T04:29:00+10:00,2023-08-12,04:29,0,2,2
35,2023-08-12T04:32:00+10:00,2023-08-12,04:32,0,1,1
35,2023-08-12T04:38:00+10:00,2023-08-12,04:38,2,0,2
58,2023-08-12T04:28:00+10:00,2023-08-12,04:28,1,0,1
62,2023-08-12T04:25:00+10:00,2023-08-12,04:25,4,0,4
62,2023-08-12T04:28:00+10:00,2023-08-12,04:28,2,0,2
62,2023-08-12T04:35:00+10:00,2023-08-12,04:35,0,2,2
62,2023-08-12T04:36:00+10:00,2023-08-12,04:36,2,0,2
62,2023-08-12T04:38:00+10:00,2023-08-12,04:38,0,1,1
67,2023-08-12T04:26:00+10:00,2023-08-12,04:26,1,0,1
68,2023-08-12T04:33:00+10:00,2023-08-12,04:33,1,0,1
79,2023-08-12T04:34:00+10:00,2023-08-12,04:34,0,1,1
79,2023-08-12T04:35:00+10:00,2023-08-12,04:35,2,0,2
79,2023-08-12T04:39:00+10:00,2023-08-12,04:39,0,1,1
3,2023-08-12T04:46:00+10:00,2023-08-12,04:46,0,1,1
3,2023-08-12T04:49:00+10:00,2023-08-12,04:49,2,0,2
3,2023-08-12T04:51:00+10:00,2023-08-12,04:51,0,3,3
4,2023-08-12T04:45:00+10:00,2023-08-12,04:45,0,1,1
4,2023-08-12T04:47:00+10:00,2023-08-12,04:47,0,2,2
4,2023-08-12T04:49:00+10:00,2023-08-12,04:49,1,1,2
6,2023-08-12T04:44:00+10:00,2023-08-12,04:44,2,0,2
6,2023-08-12T04:45:00+10:00,2023-08-12,04:45,2,0,2
6,2023-08-12T04:54:00+10:00,2023-08-12,04:54,1,0,1
8,2023-08-12T04:48:00+10:00,2023-08-12,04:48,0,1,1
14,2023-08-12T04:41:00+10:00,2023-08-12,04:41,0,1,1
14,2023-08-12T04:51:00+10:00,2023-08-12,04:51,1,0,1
21,2023-08-12T04:47:00+10:00,2023-08-12,04:47,2,0,2
21,2023-08-12T04:52:00+10:00,2023-08-12,04:52,2,0,2
28,2023-08-12T04:40:00+10:00,2023-08-12,04:40,0,1,1
28,2023-08-12T04:42:00+10:00,2023-08-12,04:42,2,1,3
29,2023-08-12T04:53:00+10:00,2023-08-12,04:53,1,0,1
41,2023-08-12T04:41:00+10:00,2023-08-12,04:41,0,1,1
41,2023-08-12T04:42:00+10:00,2023-08-12,04:42,2,2,4
41,2023-08-12T04:45:00+10:00,2023-08-12,04:45,1,0,1
41,2023-08-12T04:47:00+10:00,2023-08-12,04:47,1,0,1
41,2023-08-12T04:51:00+10:00,2023-08-12,04:51,1,0,1
55,2023-08-12T04:41:00+10:00,2023-08-12,04:41,1,0,1
59,2023-08-12T04:40:00+10:00,2023-08-12,04:40,2,1,3
61,2023-08-12T04:54:00+10:00,2023-08-12,04:54,1,0,1
65,2023-08-12T04:43:00+10:00,2023-08-12,04:43,2,0,2
65,2023-08-12T04:53:00+10:00,2023-08-12,04:53,0,1,1
66,2023-08-12T04:44:00+10:00,2023-08-12,04:44,0,2,2
66,2023-08-12T04:49:00+10:00,2023-08-12,04:49,3,2,5
1,2023-08-12T04:43:00+10:00,2023-08-12,04:43,1,0,1
17,2023-08-12T04:50:00+10:00,2023-08-12,04:50,2,4,6
17,2023-08-12T04:51:00+10:00,2023-08-12,04:51,5,6,11
24,2023-08-12T04:42:00+10:00,2023-08-12,04:42,1,0,1
24,2023-08-12T04:45:00+10:00,2023-08-12,04:45,0,1,1
24,2023-08-12T04:50:00+10:00,2023-08-12,04:50,1,0,1
24,2023-08-12T04:51:00+10:00,2023-08-12,04:51,1,2,3
27,2023-08-12T04:46:00+10:00,2023-08-12,04:46,1,0,1
27,2023-08-12T04:53:00+10:00,2023-08-12,04:53,0,1,1
35,2023-08-12T04:53:00+10:00,2023-08-12,04:53,1,0,1
53,2023-08-12T04:50:00+10:00,2023-08-12,04:50,1,0,1
56,2023-08-12T04:51:00+10:00,2023-08-12,04:51,2,0,2
56,2023-08-12T04:53:00+10:00,2023-08-12,04:53,2,0,2
58,2023-08-12T04:53:00+10:00,2023-08-12,04:53,0,3,3
62,2023-08-12T04:41:00+10:00,2023-08-12,04:41,1,0,1
62,2023-08-12T04:44:00+10:00,2023-08-12,04:44,2,1,3
62,2023-08-12T04:52:00+10:00,2023-08-12,04:52,1,1,2
62,2023-08-12T04:53:00+10:00,2023-08-12,04:53,1,1,2
62,2023-08-12T04:54:00+10:00,2023-08-12,04:54,4,1,5
63,2023-08-12T04:53:00+10:00,2023-08-12,04:53,0,2,2
63,2023-08-12T04:54:00+10:00,2023-08-12,04:54,0,1,1
67,2023-08-12T04:42:00+10:00,2023-08-12,04:42,2,0,2
72,2023-08-12T04:41:00+10:00,2023-08-12,04:41,0,1,1
79,2023-08-12T04:54:00+10:00,2023-08-12,04:54,0,1,1
3,2023-08-12T04:59:00+10:00,2023-08-12,04:59,0,3,3
3,2023-08-12T05:07:00+10:00,2023-08-12,05:07,1,0,1
4,2023-08-12T04:55:00+10:00,2023-08-12,04:55,0,1,1
4,2023-08-12T05:01:00+10:00,2023-08-12,05:01,1,0,1
4,2023-08-12T05:03:00+10:00,2023-08-12,05:03,1,0,1
6,2023-08-12T05:04:00+10:00,2023-08-12,05:04,0,1,1
6,2023-08-12T05:06:00+10:00,2023-08-12,05:06,2,2,4
6,2023-08-12T05:07:00+10:00,2023-08-12,05:07,1,1,2
6,2023-08-12T05:08:00+10:00,2023-08-12,05:08,1,0,1
14,2023-08-12T05:09:00+10:00,2023-08-12,05:09,1,0,1
21,2023-08-12T05:08:00+10:00,2023-08-12,05:08,2,2,4
28,2023-08-12T05:04:00+10:00,2023-08-12,05:04,0,1,1
28,2023-08-12T05:09:00+10:00,2023-08-12,05:09,0,1,1
41,2023-08-12T04:58:00+10:00,2023-08-12,04:58,1,1,2
41,2023-08-12T05:07:00+10:00,2023-08-12,05:07,2,1,3
41,2023-08-12T05:08:00+10:00,2023-08-12,05:08,7,2,9
55,2023-08-12T04:55:00+10:00,2023-08-12,04:55,5,0,5
55,2023-08-12T05:05:00+10:00,2023-08-12,05:05,1,1,2
55,2023-08-12T05:08:00+10:00,2023-08-12,05:08,1,6,7
61,2023-08-12T04:55:00+10:00,2023-08-12,04:55,0,4,4
61,2023-08-12T05:09:00+10:00,2023-08-12,05:09,1,0,1
65,2023-08-12T05:07:00+10:00,2023-08-12,05:07,0,1,1
66,2023-08-12T04:57:00+10:00,2023-08-12,04:57,1,0,1
66,2023-08-12T04:59:00+10:00,2023-08-12,04:59,0,1,1
66,2023-08-12T05:08:00+10:00,2023-08-12,05:08,1,0,1
69,2023-08-12T05:03:00+10:00,2023-08-12,05:03,1,0,1
70,2023-08-12T05:05:00+10:00,2023-08-12,05:05,0,1,1
84,2023-08-12T05:00:00+10:00,2023-08-12,05:00,4,4,8
108,2023-08-12T05:02:00+10:00,2023-08-12,05:02,1,0,1
1,2023-08-12T05:03:00+10:00,2023-08-12,05:03,1,0,1
9,2023-08-12T05:03:00+10:00,2023-08-12,05:03,1,0,1
17,2023-08-12T05:04:00+10:00,2023-08-12,05:04,0,2,2
24,2023-08-12T04:59:00+10:00,2023-08-12,04:59,2,0,2
35,2023-08-12T05:06:00+10:00,2023-08-12,05:06,0,2,2
35,2023-08-12T05:09:00+10:00,2023-08-12,05:09,1,0,1
56,2023-08-12T05:04:00+10:00,2023-08-12,05:04,2,0,2
56,2023-08-12T05:07:00+10:00,2023-08-12,05:07,1,0,1
58,2023-08-12T04:55:00+10:00,2023-08-12,04:55,0,1,1
62,2023-08-12T04:56:00+10:00,2023-08-12,04:56,1,2,3
62,2023-08-12T05:04:00+10:00,2023-08-12,05:04,1,0,1
62,2023-08-12T05:07:00+10:00,2023-08-12,05:07,1,1,2
62,2023-08-12T05:09:00+10:00,2023-08-12,05:09,1,1,2
63,2023-08-12T04:55:00+10:00,2023-08-12,04:55,1,1,2
67,2023-08-12T05:03:00+10:00,2023-08-12,05:03,1,0,1
67,2023-08-12T05:08:00+10:00,2023-08-12,05:08,7,0,7
72,2023-08-12T04:57:00+10:00,2023-08-12,04:57,2,3,5
72,2023-08-12T04:59:00+10:00,2023-08-12,04:59,2,0,2
79,2023-08-12T05:00:00+10:00,2023-08-12,05:00,1,2,3
79,2023-08-12T05:02:00+10:00,2023-08-12,05:02,1,0,1
79,2023-08-12T05:04:00+10:00,2023-08-12,05:04,1,0,1
79,2023-08-12T05:08:00+10:00,2023-08-12,05:08,2,0,2
109,2023-08-12T05:00:00+10:00,2023-08-12,05:00,1,1,2
109,2023-08-12T05:05:00+10:00,2023-08-12,05:05,1,0,1
122,2023-08-12T05:04:00+10:00,2023-08-12,05:04,1,0,1
3,2023-08-12T05:16:00+10:00,2023-08-12,05:16,8,0,8
6,2023-08-12T05:13:00+10:00,2023-08-12,05:13,1,0,1
6,2023-08-12T05:16:00+10:00,2023-08-12,05:16,1,0,1
8,2023-08-12T05:13:00+10:00,2023-08-12,05:13,2,0,2
14,2023-08-12T05:14:00+10:00,2023-08-12,05:14,0,1,1
14,2023-08-12T05:18:00+10:00,2023-08-12,05:18,1,0,1
14,2023-08-12T05:22:00+10:00,2023-08-12,05:22,1,0,1
28,2023-08-12T05:16:00+10:00,2023-08-12,05:16,0,2,2
29,2023-08-12T05:18:00+10:00,2023-08-12,05:18,2,0,2
41,2023-08-12T05:10:00+10:00,2023-08-12,05:10,0,2,2
41,2023-08-12T05:11:00+10:00,2023-08-12,05:11,2,1,3
41,2023-08-12T05:14:00+10:00,2023-08-12,05:14,2,0,2
54,2023-08-12T05:21:00+10:00,2023-08-12,05:21,1,0,1
55,2023-08-12T05:10:00+10:00,2023-08-12,05:10,0,3,3
55,2023-08-12T05:13:00+10:00,2023-08-12,05:13,1,0,1
55,2023-08-12T05:14:00+10:00,2023-08-12,05:14,0,1,1
55,2023-08-12T05:17:00+10:00,2023-08-12,05:17,2,3,5
55,2023-08-12T05:18:00+10:00,2023-08-12,05:18,0,2,2
55,2023-08-12T05:20:00+10:00,2023-08-12,05:20,0,2,2
55,2023-08-12T05:23:00+10:00,2023-08-12,05:23,1,0,1
55,2023-08-12T05:24:00+10:00,2023-08-12,05:24,1,2,3
61,2023-08-12T05:15:00+10:00,2023-08-12,05:15,1,0,1
61,2023-08-12T05:19:00+10:00,2023-08-12,05:19,1,0,1
65,2023-08-12T05:10:00+10:00,2023-08-12,05:10,0,2,2
65,2023-08-12T05:16:00+10:00,2023-08-12,05:16,1,4,5
66,2023-08-12T05:18:00+10:00,2023-08-12,05:18,1,0,1
66,2023-08-12T05:19:00+10:00,2023-08-12,05:19,1,0,1
107,2023-08-12T05:15:00+10:00,2023-08-12,05:15,1,0,1
107,2023-08-12T05:20:00+10:00,2023-08-12,05:20,2,4,6
108,2023-08-12T05:14:00+10:00,2023-08-12,05:14,1,0,1
108,2023-08-12T05:21:00+10:00,2023-08-12,05:21,1,0,1
108,2023-08-12T05:24:00+10:00,2023-08-12,05:24,0,1,1
1,2023-08-12T05:19:00+10:00,2023-08-12,05:19,0,1,1
2,2023-08-12T05:20:00+10:00,2023-08-12,05:20,0,1,1
9,2023-08-12T05:12:00+10:00,2023-08-12,05:12,1,0,1
24,2023-08-12T05:11:00+10:00,2023-08-12,05:11,3,0,3
24,2023-08-12T05:14:00+10:00,2023-08-12,05:14,1,0,1
24,2023-08-12T05:17:00+10:00,2023-08-12,05:17,0,1,1
24,2023-08-12T05:18:00+10:00,2023-08-12,05:18,1,0,1
24,2023-08-12T05:19:00+10:00,2023-08-12,05:19,0,1,1
27,2023-08-12T05:10:00+10:00,2023-08-12,05:10,2,0,2
27,2023-08-12T05:15:00+10:00,2023-08-12,05:15,0,1,1
35,2023-08-12T05:10:00+10:00,2023-08-12,05:10,2,0,2
35,2023-08-12T05:22:00+10:00,2023-08-12,05:22,0,1,1
35,2023-08-12T05:24:00+10:00,2023-08-12,05:24,1,1,2
53,2023-08-12T05:10:00+10:00,2023-08-12,05:10,2,0,2
57,2023-08-12T05:17:00+10:00,2023-08-12,05:17,3,0,3
58,2023-08-12T05:14:00+10:00,2023-08-12,05:14,2,0,2
62,2023-08-12T05:13:00+10:00,2023-08-12,05:13,0,1,1
62,2023-08-12T05:18:00+10:00,2023-08-12,05:18,2,0,2
63,2023-08-12T05:10:00+10:00,2023-08-12,05:10,0,1,1
67,2023-08-12T05:10:00+10:00,2023-08-12,05:10,0,1,1
72,2023-08-12T05:10:00+10:00,2023-08-12,05:10,0,1,1
72,2023-08-12T05:12:00+10:00,2023-08-12,05:12,0,1,1
79,2023-08-12T05:15:00+10:00,2023-08-12,05:15,0,1,1
109,2023-08-12T05:20:00+10:00,2023-08-12,05:20,0,2,2
3,2023-08-12T05:33:00+10:00,2023-08-12,05:33,1,0,1
4,2023-08-12T05:25:00+10:00,2023-08-12,05:25,0,2,2
4,2023-08-12T05:28:00+10:00,2023-08-12,05:28,0,2,2
4,2023-08-12T05:30:00+10:00,2023-08-12,05:30,1,1,2
6,2023-08-12T05:32:00+10:00,2023-08-12,05:32,1,0,1
6,2023-08-12T05:37:00+10:00,2023-08-12,05:37,1,1,2
6,2023-08-12T05:39:00+10:00,2023-08-12,05:39,1,0,1
14,2023-08-12T05:26:00+10:00,2023-08-12,05:26,1,0,1
14,2023-08-12T05:28:00+10:00,2023-08-12,05:28,0,1,1
14,2023-08-12T05:30:00+10:00,2023-08-12,05:30,1,1,2
21,2023-08-12T05:25:00+10:00,2023-08-12,05:25,3,0,3
21,2023-08-12T05:31:00+10:00,2023-08-12,05:31,0,3,3
21,2023-08-12T05:34:00+10:00,2023-08-12,05:34,2,0,2
28,2023-08-12T05:31:00+10:00,2023-08-12,05:31,1,0,1
28,2023-08-12T05:37:00+10:00,2023-08-12,05:37,1,0,1
29,2023-08-12T05:31:00+10:00,2023-08-12,05:31,0,1,1
29,2023-08-12T05:33:00+10:00,2023-08-12,05:33,1,0,1
29,2023-08-12T05:35:00+10:00,2023-08-12,05:35,1,0,1
29,2023-08-12T05:36:00+10:00,2023-08-12,05:36,1,0,1
41,2023-08-12T05:25:00+10:00,2023-08-12,05:25,3,0,3
41,2023-08-12T05:26:00+10:00,2023-08-12,05:26,0,1,1
41,2023-08-12T05:33:00+10:00,2023-08-12,05:33,0,1,1
41,2023-08-12T05:36:00+10:00,2023-08-12,05:36,2,0,2
41,2023-08-12T05:39:00+10:00,2023-08-12,05:39,0,4,4
54,2023-08-12T05:29:00+10:00,2023-08-12,05:29,0,1,1
54,2023-08-12T05:35:00+10:00,2023-08-12,05:35,2,0,2
55,2023-08-12T05:25:00+10:00,2023-08-12,05:25,1,0,1
55,2023-08-12T05:37:00+10:00,2023-08-12,05:37,0,1,1
55,2023-08-12T05:38:00+10:00,2023-08-12,05:38,0,1,1
59,2023-08-12T05:30:00+10:00,2023-08-12,05:30,3,0,3
61,2023-08-12T05:25:00+10:00,2023-08-12,05:25,1,0,1
61,2023-08-12T05:26:00+10:00,2023-08-12,05:26,0,1,1
66,2023-08-12T05:28:00+10:00,2023-08-12,05:28,0,1,1
66,2023-08-12T05:38:00+10:00,2023-08-12,05:38,0,1,1
70,2023-08-12T05:37:00+10:00,2023-08-12,05:37,1,0,1
75,2023-08-12T05:25:00+10:00,2023-08-12,05:25,0,2,2
84,2023-08-12T05:25:00+10:00,2023-08-12,05:25,4,3,7
107,2023-08-12T05:35:00+10:00,2023-08-12,05:35,0,1,1
108,2023-08-12T05:28:00+10:00,2023-08-12,05:28,0,2,2
108,2023-08-12T05:33:00+10:00,2023-08-12,05:33,0,1,1
1,2023-08-12T05:27:00+10:00,2023-08-12,05:27,1,0,1
1,2023-08-12T05:28:00+10:00,2023-08-12,05:28,1,0,1
9,2023-08-12T05:37:00+10:00,2023-08-12,05:37,1,0,1
12,2023-08-12T05:33:00+10:00,2023-08-12,05:33,1,0,1
18,2023-08-12T05:35:00+10:00,2023-08-12,05:35,0,1,1
24,2023-08-12T05:25:00+10:00,2023-08-12,05:25,0,1,1
24,2023-08-12T05:27:00+10:00,2023-08-12,05:27,1,7,8
24,2023-08-12T05:30:00+10:00,2023-08-12,05:30,1,0,1
24,2023-08-12T05:36:00+10:00,2023-08-12,05:36,0,1,1
24,2023-08-12T05:37:00+10:00,2023-08-12,05:37,1,5,6
35,2023-08-12T05:31:00+10:00,2023-08-12,05:31,1,0,1
35,2023-08-12T05:37:00+10:00,2023-08-12,05:37,1,1,2
35,2023-08-12T05:39:00+10:00,2023-08-12,05:39,1,1,2
58,2023-08-12T05:38:00+10:00,2023-08-12,05:38,1,0,1
62,2023-08-12T05:26:00+10:00,2023-08-12,05:26,2,0,2
62,2023-08-12T05:29:00+10:00,2023-08-12,05:29,0,1,1
62,2023-08-12T05:35:00+10:00,2023-08-12,05:35,0,1,1
63,2023-08-12T05:33:00+10:00,2023-08-12,05:33,1,0,1
67,2023-08-12T05:26:00+10:00,2023-08-12,05:26,0,3,3
79,2023-08-12T05:25:00+10:00,2023-08-12,05:25,0,4,4
79,2023-08-12T05:29:00+10:00,2023-08-12,05:29,0,1,1
79,2023-08-12T05:30:00+10:00,2023-08-12,05:30,0,1,1
79,2023-08-12T05:32:00+10:00,2023-08-12,05:32,0,1,1
79,2023-08-12T05:36:00+10:00,2023-08-12,05:36,0,2,2
109,2023-08-12T05:30:00+10:00,2023-08-12,05:30,0,1,1
117,2023-08-12T05:35:00+10:00,2023-08-12,05:35,1,1,2
122,2023-08-12T05:30:00+10:00,2023-08-12,05:30,1,0,1
122,2023-08-12T05:34:00+10:00,2023-08-12,05:34,1,0,1
3,2023-08-12T05:40:00+10:00,2023-08-12,05:40,0,5,5
3,2023-08-12T05:46:00+10:00,2023-08-12,05:46,1,2,3
3,2023-08-12T05:49:00+10:00,2023-08-12,05:49,2,2,4
4,2023-08-12T05:43:00+10:00,2023-08-12,05:43,1,0,1
4,2023-08-12T05:45:00+10:00,2023-08-12,05:45,0,1,1
4,2023-08-12T05:51:00+10:00,2023-08-12,05:51,1,0,1
4,2023-08-12T05:54:00+10:00,2023-08-12,05:54,1,1,2
6,2023-08-12T05:44:00+10:00,2023-08-12,05:44,0,7,7
6,2023-08-12T05:45:00+10:00,2023-08-12,05:45,0,1,1
6,2023-08-12T05:54:00+10:00,2023-08-12,05:54,1,1,2
14,2023-08-12T05:46:00+10:00,2023-08-12,05:46,0,4,4
14,2023-08-12T05:48:00+10:00,2023-08-12,05:48,0,2,2
21,2023-08-12T05:46:00+10:00,2023-08-12,05:46,4,0,4
28,2023-08-12T05:50:00+10:00,2023-08-12,05:50,0,1,1
29,2023-08-12T05:44:00+10:00,2023-08-12,05:44,2,0,2
29,2023-08-12T05:51:00+10:00,2023-08-12,05:51,1,0,1
39,2023-08-12T05:40:00+10:00,2023-08-12,05:40,0,1,1
39,2023-08-12T05:54:00+10:00,2023-08-12,05:54,0,3,3
41,2023-08-12T05:41:00+10:00,2023-08-12,05:41,1,1,2
41,2023-08-12T05:43:00+10:00,2023-08-12,05:43,0,1,1
54,2023-08-12T05:46:00+10:00,2023-08-12,05:46,1,0,1
55,2023-08-12T05:41:00+10:00,2023-08-12,05:41,1,1,2
55,2023-08-12T05:50:00+10:00,2023-08-12,05:50,0,2,2
59,2023-08-12T05:40:00+10:00,2023-08-12,05:40,1,2,3
59,2023-08-12T05:45:00+10:00,2023-08-12,05:45,3,0,3
59,2023-08-12T05:50:00+10:00,2023-08-12,05:50,2,2,4
65,2023-08-12T05:45:00+10:00,2023-08-12,05:45,0,1,1
66,2023-08-12T05:42:00+10:00,2023-08-12,05:42,0,1,1
75,2023-08-12T05:43:00+10:00,2023-08-12,05:43,0,1,1
84,2023-08-12T05:50:00+10:00,2023-08-12,05:50,4,2,6
87,2023-08-12T05:47:00+10:00,2023-08-12,05:47,0,1,1
107,2023-08-12T05:45:00+10:00,2023-08-12,05:45,3,2,5
108,2023-08-12T05:43:00+10:00,2023-08-12,05:43,0,2,2
108,2023-08-12T05:44:00+10:00,2023-08-12,05:44,1,0,1
108,2023-08-12T05:48:00+10:00,2023-08-12,05:48,1,0,1
1,2023-08-12T05:40:00+10:00,2023-08-12,05:40,1,0,1
1,2023-08-12T05:45:00+10:00,2023-08-12,05:45,0,1,1
1,2023-08-12T05:51:00+10:00,2023-08-12,05:51,1,1,2
2,2023-08-12T05:43:00+10:00,2023-08-12,05:43,1,1,2
2,2023-08-12T05:46:00+10:00,2023-08-12,05:46,0,1,1
2,2023-08-12T05:48:00+10:00,2023-08-12,05:48,0,2,2
2,2023-08-12T05:53:00+10:00,2023-08-12,05:53,1,0,1
7,2023-08-12T05:42:00+10:00,2023-08-12,05:42,1,0,1
9,2023-08-12T05:44:00+10:00,2023-08-12,05:44,1,0,1
10,2023-08-12T05:48:00+10:00,2023-08-12,05:48,0,1,1
17,2023-08-12T05:47:00+10:00,2023-08-12,05:47,2,0,2
24,2023-08-12T05:44:00+10:00,2023-08-12,05:44,2,2,4
24,2023-08-12T05:45:00+10:00,2023-08-12,05:45,0,2,2
24,2023-08-12T05:46:00+10:00,2023-08-12,05:46,2,1,3
24,2023-08-12T05:47:00+10:00,2023-08-12,05:47,2,1,3
24,2023-08-12T05:51:00+10:00,2023-08-12,05:51,1,1,2
24,2023-08-12T05:52:00+10:00,2023-08-12,05:52,1,0,1
24,2023-08-12T05:54:00+10:00,2023-08-12,05:54,1,2,3
35,2023-08-12T05:40:00+10:00,2023-08-12,05:40,0,3,3
35,2023-08-12T05:45:00+10:00,2023-08-12,05:45,0,1,1
35,2023-08-12T05:53:00+10:00,2023-08-12,05:53,0,1,1
35,2023-08-12T05:54:00+10:00,2023-08-12,05:54,0,3,3
53,2023-08-12T05:42:00+10:00,2023-08-12,05:42,1,0,1
53,2023-08-12T05:44:00+10:00,2023-08-12,05:44,0,2,2
53,2023-08-12T05:53:00+10:00,2023-08-12,05:53,0,1,1
56,2023-08-12T05:45:00+10:00,2023-08-12,05:45,1,0,1
56,2023-08-12T05:54:00+10:00,2023-08-12,05:54,1,0,1
57,2023-08-12T05:46:00+10:00,2023-08-12,05:46,2,0,2
58,2023-08-12T05:46:00+10:00,2023-08-12,05:46,0,1,1
62,2023-08-12T05:46:00+10:00,2023-08-12,05:46,1,0,1
63,2023-08-12T05:43:00+10:00,2023-08-12,05:43,0,1,1
63,2023-08-12T05:46:00+10:00,2023-08-12,05:46,0,2,2
67,2023-08-12T05:53:00+10:00,2023-08-12,05:53,0,1,1
72,2023-08-12T05:48:00+10:00,2023-08-12,05:48,1,0,1
72,2023-08-12T05:51:00+10:00,2023-08-12,05:51,0,1,1
76,2023-08-12T05:46:00+10:00,2023-08-12,05:46,1,0,1
79,2023-08-12T05:45:00+10:00,2023-08-12,05:45,0,2,2
79,2023-08-12T05:48:00+10:00,2023-08-12,05:48,2,1,3
79,2023-08-12T05:49:00+10:00,2023-08-12,05:49,2,0,2
109,2023-08-12T05:40:00+10:00,2023-08-12,05:40,2,0,2
117,2023-08-12T05:45:00+10:00,2023-08-12,05:45,3,1,4
122,2023-08-12T05:40:00+10:00,2023-08-12,05:40,0,1,1
3,2023-08-12T05:56:00+10:00,2023-08-12,05:56,0,1,1
3,2023-08-12T05:57:00+10:00,2023-08-12,05:57,7,1,8
3,2023-08-12T05:59:00+10:00,2023-08-12,05:59,0,1,1
3,2023-08-12T06:01:00+10:00,2023-08-12,06:01,1,0,1
3,2023-08-12T06:02:00+10:00,2023-08-12,06:02,1,2,3
4,2023-08-12T06:05:00+10:00,2023-08-12,06:05,1,0,1
6,2023-08-12T05:58:00+10:00,2023-08-12,05:58,0,1,1
6,2023-08-12T06:04:00+10:00,2023-08-12,06:04,1,0,1
6,2023-08-12T06:06:00+10:00,2023-08-12,06:06,0,1,1
8,2023-08-12T05:59:00+10:00,2023-08-12,05:59,0,2,2
14,2023-08-12T05:56:00+10:00,2023-08-12,05:56,1,0,1
14,2023-08-12T06:01:00+10:00,2023-08-12,06:01,1,0,1
14,2023-08-12T06:02:00+10:00,2023-08-12,06:02,0,1,1
14,2023-08-12T06:03:00+10:00,2023-08-12,06:03,0,1,1
14,2023-08-12T06:06:00+10:00,2023-08-12,06:06,1,0,1
14,2023-08-12T06:08:00+10:00,2023-08-12,06:08,1,0,1
14,2023-08-12T06:09:00+10:00,2023-08-12,06:09,0,1,1
21,2023-08-12T05:55:00+10:00,2023-08-12,05:55,0,2,2
28,2023-08-12T06:03:00+10:00,2023-08-12,06:03,0,1,1
28,2023-08-12T06:04:00+10:00,2023-08-12,06:04,0,2,2
28,2023-08-12T06:06:00+10:00,2023-08-12,06:06,0,1,1
29,2023-08-12T05:57:00+10:00,2023-08-12,05:57,2,0,2
29,2023-08-12T05:58:00+10:00,2023-08-12,05:58,1,0,1
29,2023-08-12T06:01:00+10:00,2023-08-12,06:01,0,1,1
29,2023-08-12T06:03:00+10:00,2023-08-12,06:03,1,2,3
29,2023-08-12T06:06:00+10:00,2023-08-12,06:06,1,1,2
29,2023-08-12T06:08:00+10:00,2023-08-12,06:08,1,0,1
41,2023-08-12T06:00:00+10:00,2023-08-12,06:00,3,2,5
41,2023-08-12T06:01:00+10:00,2023-08-12,06:01,1,2,3
41,2023-08-12T06:02:00+10:00,2023-08-12,06:02,0,4,4
41,2023-08-12T06:03:00+10:00,2023-08-12,06:03,1,2,3
41,2023-08-12T06:05:00+10:00,2023-08-12,06:05,2,1,3
41,2023-08-12T06:07:00+10:00,2023-08-12,06:07,0,1,1
54,2023-08-12T05:56:00+10:00,2023-08-12,05:56,0,1,1
55,2023-08-12T05:59:00+10:00,2023-08-12,05:59,1,1,2
55,2023-08-12T06:00:00+10:00,2023-08-12,06:00,1,0,1
55,2023-08-12T06:02:00+10:00,2023-08-12,06:02,2,0,2
55,2023-08-12T06:03:00+10:00,2023-08-12,06:03,0,4,4
55,2023-08-12T06:04:00+10:00,2023-08-12,06:04,3,0,3
55,2023-08-12T06:08:00+10:00,2023-08-12,06:08,0,1,1
59,2023-08-12T06:05:00+10:00,2023-08-12,06:05,1,0,1
61,2023-08-12T05:55:00+10:00,2023-08-12,05:55,0,1,1
61,2023-08-12T06:05:00+10:00,2023-08-12,06:05,0,1,1
61,2023-08-12T06:09:00+10:00,2023-08-12,06:09,0,1,1
65,2023-08-12T06:05:00+10:00,2023-08-12,06:05,0,2,2
65,2023-08-12T06:09:00+10:00,2023-08-12,06:09,0,1,1
69,2023-08-12T05:56:00+10:00,2023-08-12,05:56,1,0,1
84,2023-08-12T06:05:00+10:00,2023-08-12,06:05,4,7,11
107,2023-08-12T06:00:00+10:00,2023-08-12,06:00,0,3,3
108,2023-08-12T05:55:00+10:00,2023-08-12,05:55,0,1,1
108,2023-08-12T06:04:00+10:00,2023-08-12,06:04,0,1,1
108,2023-08-12T06:09:00+10:00,2023-08-12,06:09,1,1,2
1,2023-08-12T05:56:00+10:00,2023-08-12,05:56,1,2,3
1,2023-08-12T06:00:00+10:00,2023-08-12,06:00,0,1,1
1,2023-08-12T06:01:00+10:00,2023-08-12,06:01,0,3,3
2,2023-08-12T06:00:00+10:00,2023-08-12,06:00,1,0,1
17,2023-08-12T05:57:00+10:00,2023-08-12,05:57,2,0,2
17,2023-08-12T05:58:00+10:00,2023-08-12,05:58,1,1,2
17,2023-08-12T06:01:00+10:00,2023-08-12,06:01,2,0,2
24,2023-08-12T05:59:00+10:00,2023-08-12,05:59,3,2,5
24,2023-08-12T06:00:00+10:00,2023-08-12,06:00,0,3,3
24,2023-08-12T06:05:00+10:00,2023-08-12,06:05,2,0,2
24,2023-08-12T06:09:00+10:00,2023-08-12,06:09,1,7,8
27,2023-08-12T06:05:00+10:00,2023-08-12,06:05,2,0,2
27,2023-08-12T06:06:00+10:00,2023-08-12,06:06,0,1,1
35,2023-08-12T05:56:00+10:00,2023-08-12,05:56,1,2,3
35,2023-08-12T05:57:00+10:00,2023-08-12,05:57,1,0,1
35,2023-08-12T05:58:00+10:00,2023-08-12,05:58,3,0,3
35,2023-08-12T06:02:00+10:00,2023-08-12,06:02,0,3,3
53,2023-08-12T05:58:00+10:00,2023-08-12,05:58,0,1,1
53,2023-08-12T06:03:00+10:00,2023-08-12,06:03,0,1,1
56,2023-08-12T06:04:00+10:00,2023-08-12,06:04,1,0,1
56,2023-08-12T06:05:00+10:00,2023-08-12,06:05,0,1,1
57,2023-08-12T05:59:00+10:00,2023-08-12,05:59,0,1,1
58,2023-08-12T06:07:00+10:00,2023-08-12,06:07,0,2,2
58,2023-08-12T06:08:00+10:00,2023-08-12,06:08,1,2,3
62,2023-08-12T05:57:00+10:00,2023-08-12,05:57,2,0,2
62,2023-08-12T06:01:00+10:00,2023-08-12,06:01,0,1,1
63,2023-08-12T06:06:00+10:00,2023-08-12,06:06,1,0,1
67,2023-08-12T06:01:00+10:00,2023-08-12,06:01,0,1,1
72,2023-08-12T05:59:00+10:00,2023-08-12,05:59,1,2,3
79,2023-08-12T05:55:00+10:00,2023-08-12,05:55,3,2,5
79,2023-08-12T05:57:00+10:00,2023-08-12,05:57,0,1,1
79,2023-08-12T06:01:00+10:00,2023-08-12,06:01,0,2,2
79,2023-08-12T06:03:00+10:00,2023-08-12,06:03,1,0,1
79,2023-08-12T06:04:00+10:00,2023-08-12,06:04,0,1,1
79,2023-08-12T06:08:00+10:00,2023-08-12,06:08,2,0,2
3,2023-08-11T23:55:00+10:00,2023-08-11,23:55,21,8,29
3,2023-08-11T23:58:00+10:00,2023-08-11,23:58,8,8,16
3,2023-08-11T23:59:00+10:00,2023-08-11,23:59,5,10,15
3,2023-08-12T00:00:00+10:00,2023-08-12,00:00,15,8,23
3,2023-08-12T00:02:00+10:00,2023-08-12,00:02,3,11,14
3,2023-08-12T00:07:00+10:00,2023-08-12,00:07,10,6,16
3,2023-08-12T00:08:00+10:00,2023-08-12,00:08,6,12,18
4,2023-08-11T23:57:00+10:00,2023-08-11,23:57,8,13,21
4,2023-08-12T00:00:00+10:00,2023-08-12,00:00,8,5,13
4,2023-08-12T00:01:00+10:00,2023-08-12,00:01,7,5,12
4,2023-08-12T00:03:00+10:00,2023-08-12,00:03,14,13,27
4,2023-08-12T00:04:00+10:00,2023-08-12,00:04,6,13,19
4,2023-08-12T00:08:00+10:00,2023-08-12,00:08,3,19,22
6,2023-08-11T23:56:00+10:00,2023-08-11,23:56,9,3,12
6,2023-08-11T23:58:00+10:00,2023-08-11,23:58,1,11,12
6,2023-08-11T23:59:00+10:00,2023-08-11,23:59,2,14,16
6,2023-08-12T00:00:00+10:00,2023-08-12,00:00,4,8,12
6,2023-08-12T00:07:00+10:00,2023-08-12,00:07,4,8,12
6,2023-08-12T00:08:00+10:00,2023-08-12,00:08,8,2,10
8,2023-08-12T00:02:00+10:00,2023-08-12,00:02,3,0,3
14,2023-08-12T00:00:00+10:00,2023-08-12,00:00,2,1,3
14,2023-08-12T00:01:00+10:00,2023-08-12,00:01,0,1,1
14,2023-08-12T00:03:00+10:00,2023-08-12,00:03,0,3,3
14,2023-08-12T00:05:00+10:00,2023-08-12,00:05,3,9,12
14,2023-08-12T00:06:00+10:00,2023-08-12,00:06,3,2,5
14,2023-08-12T00:07:00+10:00,2023-08-12,00:07,4,0,4
21,2023-08-11T23:56:00+10:00,2023-08-11,23:56,3,6,9
21,2023-08-11T23:59:00+10:00,2023-08-11,23:59,2,5,7
21,2023-08-12T00:00:00+10:00,2023-08-12,00:00,6,1,7
21,2023-08-12T00:01:00+10:00,2023-08-12,00:01,1,6,7
21,2023-08-12T00:03:00+10:00,2023-08-12,00:03,0,3,3
21,2023-08-12T00:06:00+10:00,2023-08-12,00:06,6,2,8
21,2023-08-12T00:07:00+10:00,2023-08-12,00:07,2,0,2
28,2023-08-11T23:58:00+10:00,2023-08-11,23:58,1,1,2
28,2023-08-12T00:00:00+10:00,2023-08-12,00:00,7,2,9
28,2023-08-12T00:03:00+10:00,2023-08-12,00:03,5,2,7
28,2023-08-12T00:07:00+10:00,2023-08-12,00:07,2,1,3
29,2023-08-11T23:57:00+10:00,2023-08-11,23:57,0,1,1
29,2023-08-11T23:59:00+10:00,2023-08-11,23:59,0,1,1
29,2023-08-12T00:00:00+10:00,2023-08-12,00:00,1,0,1
29,2023-08-12T00:09:00+10:00,2023-08-12,00:09,2,0,2
39,2023-08-11T23:58:00+10:00,2023-08-11,23:58,3,1,4
39,2023-08-11T23:59:00+10:00,2023-08-11,23:59,1,2,3
39,2023-08-12T00:00:00+10:00,2023-08-12,00:00,1,0,1
39,2023-08-12T00:03:00+10:00,2023-08-12,00:03,3,1,4
41,2023-08-11T23:58:00+10:00,2023-08-11,23:58,11,20,31
41,2023-08-12T00:01:00+10:00,2023-08-12,00:01,10,15,25
41,2023-08-12T00:06:00+10:00,2023-08-12,00:06,8,13,21
54,2023-08-12T00:03:00+10:00,2023-08-12,00:03,1,0,1
55,2023-08-11T23:55:00+10:00,2023-08-11,23:55,2,5,7
55,2023-08-11T23:57:00+10:00,2023-08-11,23:57,13,7,20
55,2023-08-11T23:58:00+10:00,2023-08-11,23:58,6,5,11
55,2023-08-12T00:00:00+10:00,2023-08-12,00:00,16,2,18
55,2023-08-12T00:02:00+10:00,2023-08-12,00:02,4,7,11
55,2023-08-12T00:06:00+10:00,2023-08-12,00:06,13,7,20
55,2023-08-12T00:09:00+10:00,2023-08-12,00:09,8,6,14
61,2023-08-11T23:56:00+10:00,2023-08-11,23:56,0,1,1
61,2023-08-11T23:57:00+10:00,2023-08-11,23:57,1,0,1
61,2023-08-12T00:01:00+10:00,2023-08-12,00:01,1,0,1
61,2023-08-12T00:08:00+10:00,2023-08-12,00:08,2,4,6
61,2023-08-12T00:09:00+10:00,2023-08-12,00:09,0,8,8
65,2023-08-11T23:59:00+10:00,2023-08-11,23:59,2,2,4
65,2023-08-12T00:00:00+10:00,2023-08-12,00:00,1,11,12
65,2023-08-12T00:01:00+10:00,2023-08-12,00:01,3,2,5
65,2023-08-12T00:07:00+10:00,2023-08-12,00:07,0,3,3
65,2023-08-12T00:08:00+10:00,2023-08-12,00:08,0,5,5
65,2023-08-12T00:09:00+10:00,2023-08-12,00:09,1,11,12
66,2023-08-11T23:56:00+10:00,2023-08-11,23:56,10,3,13
66,2023-08-11T23:57:00+10:00,2023-08-11,23:57,8,4,12
66,2023-08-12T00:02:00+10:00,2023-08-12,00:02,14,1,15
66,2023-08-12T00:05:00+10:00,2023-08-12,00:05,3,4,7
66,2023-08-12T00:06:00+10:00,2023-08-12,00:06,6,1,7
66,2023-08-12T00:08:00+10:00,2023-08-12,00:08,3,3,6
66,2023-08-12T00:09:00+10:00,2023-08-12,00:09,6,0,6
69,2023-08-11T23:57:00+10:00,2023-08-11,23:57,1,0,1
69,2023-08-12T00:09:00+10:00,2023-08-12,00:09,1,0,1
70,2023-08-12T00:08:00+10:00,2023-08-12,00:08,0,1,1
77,2023-08-11T23:56:00+10:00,2023-08-11,23:56,1,0,1
78,2023-08-12T00:02:00+10:00,2023-08-12,00:02,0,4,4
78,2023-08-12T00:06:00+10:00,2023-08-12,00:06,0,1,1
84,2023-08-12T00:05:00+10:00,2023-08-12,00:05,19,37,56
107,2023-08-11T23:55:00+10:00,2023-08-11,23:55,2,5,7
108,2023-08-11T23:57:00+10:00,2023-08-11,23:57,1,0,1
108,2023-08-12T00:01:00+10:00,2023-08-12,00:01,0,2,2
108,2023-08-12T00:02:00+10:00,2023-08-12,00:02,1,0,1
118,2023-08-11T23:55:00+10:00,2023-08-11,23:55,3,0,3
1,2023-08-11T23:57:00+10:00,2023-08-11,23:57,1,0,1
1,2023-08-12T00:02:00+10:00,2023-08-12,00:02,1,1,2
1,2023-08-12T00:07:00+10:00,2023-08-12,00:07,2,4,6
2,2023-08-11T23:56:00+10:00,2023-08-11,23:56,3,0,3
2,2023-08-11T23:58:00+10:00,2023-08-11,23:58,0,7,7
2,2023-08-12T00:00:00+10:00,2023-08-12,00:00,0,6,6
2,2023-08-12T00:06:00+10:00,2023-08-12,00:06,1,4,5
2,2023-08-12T00:08:00+10:00,2023-08-12,00:08,0,6,6
7,2023-08-11T23:56:00+10:00,2023-08-11,23:56,2,7,9
7,2023-08-11T23:57:00+10:00,2023-08-11,23:57,0,8,8
7,2023-08-11T23:58:00+10:00,2023-08-11,23:58,0,4,4
7,2023-08-12T00:00:00+10:00,2023-08-12,00:00,0,3,3
7,2023-08-12T00:02:00+10:00,2023-08-12,00:02,0,1,1
7,2023-08-12T00:07:00+10:00,2023-08-12,00:07,0,3,3
9,2023-08-12T00:02:00+10:00,2023-08-12,00:02,2,0,2
9,2023-08-12T00:07:00+10:00,2023-08-12,00:07,1,0,1
10,2023-08-12T00:07:00+10:00,2023-08-12,00:07,1,0,1
12,2023-08-12T00:00:00+10:00,2023-08-12,00:00,0,3,3
12,2023-08-12T00:05:00+10:00,2023-08-12,00:05,5,3,8
17,2023-08-12T00:01:00+10:00,2023-08-12,00:01,0,1,1
17,2023-08-12T00:02:00+10:00,2023-08-12,00:02,4,0,4
18,2023-08-11T23:58:00+10:00,2023-08-11,23:58,1,0,1
18,2023-08-12T00:02:00+10:00,2023-08-12,00:02,0,1,1
24,2023-08-11T23:57:00+10:00,2023-08-11,23:57,7,5,12
24,2023-08-11T23:59:00+10:00,2023-08-11,23:59,5,9,14
24,2023-08-12T00:01:00+10:00,2023-08-12,00:01,0,10,10
24,2023-08-12T00:03:00+10:00,2023-08-12,00:03,3,0,3
24,2023-08-12T00:04:00+10:00,2023-08-12,00:04,0,2,2
24,2023-08-12T00:06:00+10:00,2023-08-12,00:06,4,6,10
27,2023-08-11T23:55:00+10:00,2023-08-11,23:55,0,4,4
27,2023-08-12T00:09:00+10:00,2023-08-12,00:09,1,1,2
35,2023-08-11T23:59:00+10:00,2023-08-11,23:59,9,2,11
35,2023-08-12T00:09:00+10:00,2023-08-12,00:09,5,10,15
53,2023-08-11T23:56:00+10:00,2023-08-11,23:56,2,3,5
53,2023-08-12T00:06:00+10:00,2023-08-12,00:06,0,2,2
56,2023-08-11T23:59:00+10:00,2023-08-11,23:59,1,0,1
56,2023-08-12T00:03:00+10:00,2023-08-12,00:03,0,1,1
56,2023-08-12T00:08:00+10:00,2023-08-12,00:08,0,1,1
57,2023-08-11T23:57:00+10:00,2023-08-11,23:57,1,1,2
57,2023-08-11T23:58:00+10:00,2023-08-11,23:58,1,1,2
57,2023-08-12T00:00:00+10:00,2023-08-12,00:00,1,0,1
58,2023-08-11T23:55:00+10:00,2023-08-11,23:55,0,4,4
58,2023-08-11T23:56:00+10:00,2023-08-11,23:56,2,17,19
58,2023-08-12T00:00:00+10:00,2023-08-12,00:00,3,3,6
58,2023-08-12T00:01:00+10:00,2023-08-12,00:01,2,2,4
58,2023-08-12T00:02:00+10:00,2023-08-12,00:02,2,3,5
58,2023-08-12T00:06:00+10:00,2023-08-12,00:06,3,4,7
58,2023-08-12T00:08:00+10:00,2023-08-12,00:08,0,9,9
58,2023-08-12T00:09:00+10:00,2023-08-12,00:09,4,4,8
62,2023-08-12T00:07:00+10:00,2023-08-12,00:07,7,0,7
62,2023-08-12T00:09:00+10:00,2023-08-12,00:09,1,0,1
63,2023-08-11T23:57:00+10:00,2023-08-11,23:57,0,6,6
63,2023-08-12T00:00:00+10:00,2023-08-12,00:00,24,5,29
63,2023-08-12T00:06:00+10:00,2023-08-12,00:06,2,9,11
63,2023-08-12T00:09:00+10:00,2023-08-12,00:09,2,2,4
67,2023-08-11T23:59:00+10:00,2023-08-11,23:59,3,0,3
67,2023-08-12T00:03:00+10:00,2023-08-12,00:03,0,10,10
67,2023-08-12T00:07:00+10:00,2023-08-12,00:07,2,3,5
67,2023-08-12T00:08:00+10:00,2023-08-12,00:08,1,1,2
68,2023-08-11T23:57:00+10:00,2023-08-11,23:57,2,0,2
68,2023-08-12T00:03:00+10:00,2023-08-12,00:03,1,0,1
72,2023-08-12T00:01:00+10:00,2023-08-12,00:01,0,1,1
72,2023-08-12T00:03:00+10:00,2023-08-12,00:03,0,2,2
72,2023-08-12T00:06:00+10:00,2023-08-12,00:06,4,2,6
72,2023-08-12T00:08:00+10:00,2023-08-12,00:08,4,3,7
79,2023-08-11T23:57:00+10:00,2023-08-11,23:57,1,3,4
79,2023-08-11T23:58:00+10:00,2023-08-11,23:58,1,4,5
79,2023-08-12T00:03:00+10:00,2023-08-12,00:03,2,4,6
79,2023-08-12T00:05:00+10:00,2023-08-12,00:05,4,5,9
79,2023-08-12T00:06:00+10:00,2023-08-12,00:06,3,6,9
79,2023-08-12T00:08:00+10:00,2023-08-12,00:08,1,5,6
117,2023-08-12T00:05:00+10:00,2023-08-12,00:05,9,5,14
122,2023-08-11T23:57:00+10:00,2023-08-11,23:57,0,1,1
122,2023-08-12T00:00:00+10:00,2023-08-12,00:00,0,3,3
122,2023-08-12T00:06:00+10:00,2023-08-12,00:06,0,1,1
3,2023-08-12T06:40:00+10:00,2023-08-12,06:40,0,1,1
3,2023-08-12T06:41:00+10:00,2023-08-12,06:41,0,1,1
3,2023-08-12T06:43:00+10:00,2023-08-12,06:43,0,1,1
3,2023-08-12T06:44:00+10:00,2023-08-12,06:44,2,1,3
3,2023-08-12T06:51:00+10:00,2023-08-12,06:51,2,0,2
4,2023-08-12T06:40:00+10:00,2023-08-12,06:40,1,0,1
4,2023-08-12T06:42:00+10:00,2023-08-12,06:42,3,0,3
4,2023-08-12T06:43:00+10:00,2023-08-12,06:43,2,0,2
4,2023-08-12T06:44:00+10:00,2023-08-12,06:44,0,2,2
4,2023-08-12T06:45:00+10:00,2023-08-12,06:45,2,0,2
4,2023-08-12T06:52:00+10:00,2023-08-12,06:52,0,1,1
6,2023-08-12T06:42:00+10:00,2023-08-12,06:42,1,12,13
6,2023-08-12T06:46:00+10:00,2023-08-12,06:46,0,3,3
6,2023-08-12T06:48:00+10:00,2023-08-12,06:48,1,1,2
6,2023-08-12T06:50:00+10:00,2023-08-12,06:50,0,1,1
8,2023-08-12T06:44:00+10:00,2023-08-12,06:44,1,0,1
8,2023-08-12T06:54:00+10:00,2023-08-12,06:54,0,1,1
14,2023-08-12T06:44:00+10:00,2023-08-12,06:44,0,4,4
14,2023-08-12T06:45:00+10:00,2023-08-12,06:45,0,2,2
21,2023-08-12T06:47:00+10:00,2023-08-12,06:47,0,1,1
28,2023-08-12T06:43:00+10:00,2023-08-12,06:43,0,1,1
28,2023-08-12T06:48:00+10:00,2023-08-12,06:48,1,1,2
28,2023-08-12T06:49:00+10:00,2023-08-12,06:49,2,3,5
28,2023-08-12T06:51:00+10:00,2023-08-12,06:51,1,0,1
29,2023-08-12T06:42:00+10:00,2023-08-12,06:42,1,1,2
29,2023-08-12T06:43:00+10:00,2023-08-12,06:43,0,2,2
41,2023-08-12T06:42:00+10:00,2023-08-12,06:42,1,3,4
41,2023-08-12T06:47:00+10:00,2023-08-12,06:47,1,2,3
41,2023-08-12T06:48:00+10:00,2023-08-12,06:48,3,3,6
41,2023-08-12T06:49:00+10:00,2023-08-12,06:49,1,0,1
41,2023-08-12T06:50:00+10:00,2023-08-12,06:50,3,4,7
41,2023-08-12T06:52:00+10:00,2023-08-12,06:52,2,1,3
55,2023-08-12T06:40:00+10:00,2023-08-12,06:40,1,3,4
55,2023-08-12T06:42:00+10:00,2023-08-12,06:42,2,3,5
55,2023-08-12T06:44:00+10:00,2023-08-12,06:44,2,6,8
55,2023-08-12T06:50:00+10:00,2023-08-12,06:50,1,0,1
55,2023-08-12T06:51:00+10:00,2023-08-12,06:51,1,1,2
55,2023-08-12T06:52:00+10:00,2023-08-12,06:52,2,0,2
59,2023-08-12T06:40:00+10:00,2023-08-12,06:40,4,2,6
65,2023-08-12T06:41:00+10:00,2023-08-12,06:41,0,1,1
65,2023-08-12T06:48:00+10:00,2023-08-12,06:48,0,1,1
69,2023-08-12T06:51:00+10:00,2023-08-12,06:51,0,1,1
75,2023-08-12T06:44:00+10:00,2023-08-12,06:44,0,1,1
75,2023-08-12T06:48:00+10:00,2023-08-12,06:48,1,1,2
77,2023-08-12T06:42:00+10:00,2023-08-12,06:42,1,0,1
77,2023-08-12T06:45:00+10:00,2023-08-12,06:45,1,0,1
77,2023-08-12T06:53:00+10:00,2023-08-12,06:53,0,1,1
84,2023-08-12T06:40:00+10:00,2023-08-12,06:40,7,2,9
107,2023-08-12T06:50:00+10:00,2023-08-12,06:50,0,5,5
108,2023-08-12T06:42:00+10:00,2023-08-12,06:42,0,1,1
108,2023-08-12T06:43:00+10:00,2023-08-12,06:43,0,1,1
108,2023-08-12T06:47:00+10:00,2023-08-12,06:47,0,1,1
108,2023-08-12T06:53:00+10:00,2023-08-12,06:53,0,1,1
108,2023-08-12T06:54:00+10:00,2023-08-12,06:54,0,1,1
118,2023-08-12T06:50:00+10:00,2023-08-12,06:50,0,1,1
1,2023-08-12T06:43:00+10:00,2023-08-12,06:43,1,1,2
2,2023-08-12T06:48:00+10:00,2023-08-12,06:48,0,1,1
7,2023-08-12T06:40:00+10:00,2023-08-12,06:40,1,0,1
7,2023-08-12T06:43:00+10:00,2023-08-12,06:43,1,1,2
7,2023-08-12T06:54:00+10:00,2023-08-12,06:54,1,1,2
9,2023-08-12T06:49:00+10:00,2023-08-12,06:49,0,1,1
9,2023-08-12T06:54:00+10:00,2023-08-12,06:54,0,2,2
12,2023-08-12T06:52:00+10:00,2023-08-12,06:52,1,0,1
12,2023-08-12T06:54:00+10:00,2023-08-12,06:54,1,0,1
17,2023-08-12T06:50:00+10:00,2023-08-12,06:50,0,1,1
17,2023-08-12T06:51:00+10:00,2023-08-12,06:51,1,0,1
24,2023-08-12T06:47:00+10:00,2023-08-12,06:47,3,1,4
24,2023-08-12T06:48:00+10:00,2023-08-12,06:48,0,1,1
24,2023-08-12T06:53:00+10:00,2023-08-12,06:53,5,0,5
24,2023-08-12T06:54:00+10:00,2023-08-12,06:54,3,1,4
27,2023-08-12T06:43:00+10:00,2023-08-12,06:43,0,1,1
27,2023-08-12T06:48:00+10:00,2023-08-12,06:48,1,1,2
27,2023-08-12T06:52:00+10:00,2023-08-12,06:52,0,3,3
35,2023-08-12T06:41:00+10:00,2023-08-12,06:41,1,0,1
35,2023-08-12T06:42:00+10:00,2023-08-12,06:42,3,3,6
35,2023-08-12T06:43:00+10:00,2023-08-12,06:43,1,2,3
35,2023-08-12T06:45:00+10:00,2023-08-12,06:45,0,3,3
35,2023-08-12T06:46:00+10:00,2023-08-12,06:46,0,2,2
35,2023-08-12T06:49:00+10:00,2023-08-12,06:49,1,1,2
35,2023-08-12T06:51:00+10:00,2023-08-12,06:51,0,2,2
35,2023-08-12T06:52:00+10:00,2023-08-12,06:52,3,0,3
53,2023-08-12T06:53:00+10:00,2023-08-12,06:53,0,1,1
58,2023-08-12T06:41:00+10:00,2023-08-12,06:41,2,1,3
58,2023-08-12T06:51:00+10:00,2023-08-12,06:51,0,1,1
58,2023-08-12T06:53:00+10:00,2023-08-12,06:53,0,1,1
62,2023-08-12T06:45:00+10:00,2023-08-12,06:45,0,5,5
62,2023-08-12T06:47:00+10:00,2023-08-12,06:47,4,2,6
62,2023-08-12T06:49:00+10:00,2023-08-12,06:49,1,2,3
62,2023-08-12T06:53:00+10:00,2023-08-12,06:53,3,0,3
63,2023-08-12T06:50:00+10:00,2023-08-12,06:50,1,1,2
67,2023-08-12T06:42:00+10:00,2023-08-12,06:42,3,0,3
67,2023-08-12T06:43:00+10:00,2023-08-12,06:43,1,1,2
67,2023-08-12T06:47:00+10:00,2023-08-12,06:47,0,1,1
67,2023-08-12T06:48:00+10:00,2023-08-12,06:48,3,0,3
67,2023-08-12T06:52:00+10:00,2023-08-12,06:52,0,4,4
72,2023-08-12T06:42:00+10:00,2023-08-12,06:42,1,0,1
72,2023-08-12T06:43:00+10:00,2023-08-12,06:43,0,1,1
72,2023-08-12T06:44:00+10:00,2023-08-12,06:44,0,1,1
72,2023-08-12T06:45:00+10:00,2023-08-12,06:45,0,1,1
72,2023-08-12T06:47:00+10:00,2023-08-12,06:47,2,0,2
72,2023-08-12T06:49:00+10:00,2023-08-12,06:49,1,1,2
76,2023-08-12T06:42:00+10:00,2023-08-12,06:42,1,0,1
79,2023-08-12T06:40:00+10:00,2023-08-12,06:40,2,1,3
79,2023-08-12T06:42:00+10:00,2023-08-12,06:42,1,0,1
79,2023-08-12T06:44:00+10:00,2023-08-12,06:44,0,1,1
79,2023-08-12T06:45:00+10:00,2023-08-12,06:45,0,2,2
79,2023-08-12T06:46:00+10:00,2023-08-12,06:46,0,1,1
79,2023-08-12T06:52:00+10:00,2023-08-12,06:52,1,4,5
79,2023-08-12T06:53:00+10:00,2023-08-12,06:53,1,2,3
79,2023-08-12T06:54:00+10:00,2023-08-12,06:54,1,1,2
109,2023-08-12T06:45:00+10:00,2023-08-12,06:45,3,2,5
117,2023-08-12T06:50:00+10:00,2023-08-12,06:50,2,1,3
3,2023-08-12T06:31:00+10:00,2023-08-12,06:31,1,2,3
3,2023-08-12T06:33:00+10:00,2023-08-12,06:33,1,0,1
3,2023-08-12T06:35:00+10:00,2023-08-12,06:35,1,1,2
4,2023-08-12T06:26:00+10:00,2023-08-12,06:26,0,2,2
4,2023-08-12T06:36:00+10:00,2023-08-12,06:36,1,1,2
6,2023-08-12T06:26:00+10:00,2023-08-12,06:26,1,2,3
6,2023-08-12T06:31:00+10:00,2023-08-12,06:31,2,0,2
6,2023-08-12T06:32:00+10:00,2023-08-12,06:32,1,1,2
6,2023-08-12T06:33:00+10:00,2023-08-12,06:33,1,0,1
6,2023-08-12T06:35:00+10:00,2023-08-12,06:35,0,1,1
6,2023-08-12T06:37:00+10:00,2023-08-12,06:37,1,0,1
14,2023-08-12T06:27:00+10:00,2023-08-12,06:27,0,1,1
14,2023-08-12T06:39:00+10:00,2023-08-12,06:39,2,0,2
21,2023-08-12T06:32:00+10:00,2023-08-12,06:32,0,1,1
28,2023-08-12T06:29:00+10:00,2023-08-12,06:29,1,1,2
28,2023-08-12T06:30:00+10:00,2023-08-12,06:30,1,2,3
28,2023-08-12T06:32:00+10:00,2023-08-12,06:32,1,1,2
28,2023-08-12T06:35:00+10:00,2023-08-12,06:35,2,0,2
28,2023-08-12T06:38:00+10:00,2023-08-12,06:38,0,2,2
29,2023-08-12T06:30:00+10:00,2023-08-12,06:30,1,1,2
29,2023-08-12T06:36:00+10:00,2023-08-12,06:36,1,1,2
29,2023-08-12T06:37:00+10:00,2023-08-12,06:37,2,0,2
39,2023-08-12T06:26:00+10:00,2023-08-12,06:26,1,0,1
41,2023-08-12T06:25:00+10:00,2023-08-12,06:25,2,1,3
41,2023-08-12T06:26:00+10:00,2023-08-12,06:26,3,0,3
41,2023-08-12T06:27:00+10:00,2023-08-12,06:27,0,3,3
41,2023-08-12T06:28:00+10:00,2023-08-12,06:28,3,0,3
41,2023-08-12T06:31:00+10:00,2023-08-12,06:31,3,3,6
41,2023-08-12T06:34:00+10:00,2023-08-12,06:34,1,0,1
41,2023-08-12T06:35:00+10:00,2023-08-12,06:35,2,3,5
41,2023-08-12T06:36:00+10:00,2023-08-12,06:36,3,3,6
41,2023-08-12T06:37:00+10:00,2023-08-12,06:37,2,4,6
54,2023-08-12T06:37:00+10:00,2023-08-12,06:37,0,1,1
55,2023-08-12T06:28:00+10:00,2023-08-12,06:28,0,3,3
55,2023-08-12T06:32:00+10:00,2023-08-12,06:32,0,1,1
55,2023-08-12T06:33:00+10:00,2023-08-12,06:33,2,0,2
55,2023-08-12T06:35:00+10:00,2023-08-12,06:35,0,2,2
55,2023-08-12T06:36:00+10:00,2023-08-12,06:36,0,2,2
59,2023-08-12T06:25:00+10:00,2023-08-12,06:25,2,3,5
61,2023-08-12T06:26:00+10:00,2023-08-12,06:26,2,0,2
61,2023-08-12T06:34:00+10:00,2023-08-12,06:34,0,2,2
61,2023-08-12T06:38:00+10:00,2023-08-12,06:38,0,1,1
65,2023-08-12T06:25:00+10:00,2023-08-12,06:25,1,0,1
65,2023-08-12T06:27:00+10:00,2023-08-12,06:27,0,1,1
66,2023-08-12T06:25:00+10:00,2023-08-12,06:25,0,1,1
66,2023-08-12T06:35:00+10:00,2023-08-12,06:35,0,1,1
69,2023-08-12T06:36:00+10:00,2023-08-12,06:36,1,1,2
84,2023-08-12T06:25:00+10:00,2023-08-12,06:25,3,8,11
87,2023-08-12T06:32:00+10:00,2023-08-12,06:32,0,1,1
108,2023-08-12T06:28:00+10:00,2023-08-12,06:28,1,0,1
108,2023-08-12T06:30:00+10:00,2023-08-12,06:30,0,2,2
108,2023-08-12T06:37:00+10:00,2023-08-12,06:37,0,1,1
1,2023-08-12T06:39:00+10:00,2023-08-12,06:39,0,1,1
2,2023-08-12T06:37:00+10:00,2023-08-12,06:37,0,1,1
11,2023-08-12T06:30:00+10:00,2023-08-12,06:30,2,0,2
12,2023-08-12T06:32:00+10:00,2023-08-12,06:32,0,4,4
12,2023-08-12T06:37:00+10:00,2023-08-12,06:37,2,0,2
17,2023-08-12T06:34:00+10:00,2023-08-12,06:34,0,1,1
17,2023-08-12T06:35:00+10:00,2023-08-12,06:35,0,2,2
18,2023-08-12T06:26:00+10:00,2023-08-12,06:26,0,1,1
24,2023-08-12T06:33:00+10:00,2023-08-12,06:33,1,2,3
24,2023-08-12T06:35:00+10:00,2023-08-12,06:35,3,3,6
27,2023-08-12T06:26:00+10:00,2023-08-12,06:26,1,1,2
27,2023-08-12T06:32:00+10:00,2023-08-12,06:32,1,0,1
35,2023-08-12T06:26:00+10:00,2023-08-12,06:26,0,1,1
35,2023-08-12T06:27:00+10:00,2023-08-12,06:27,1,1,2
35,2023-08-12T06:28:00+10:00,2023-08-12,06:28,2,3,5
35,2023-08-12T06:31:00+10:00,2023-08-12,06:31,1,1,2
53,2023-08-12T06:33:00+10:00,2023-08-12,06:33,1,0,1
56,2023-08-12T06:31:00+10:00,2023-08-12,06:31,1,1,2
56,2023-08-12T06:33:00+10:00,2023-08-12,06:33,1,0,1
58,2023-08-12T06:27:00+10:00,2023-08-12,06:27,0,2,2
58,2023-08-12T06:33:00+10:00,2023-08-12,06:33,0,1,1
58,2023-08-12T06:39:00+10:00,2023-08-12,06:39,2,0,2
62,2023-08-12T06:30:00+10:00,2023-08-12,06:30,2,0,2
62,2023-08-12T06:31:00+10:00,2023-08-12,06:31,1,0,1
62,2023-08-12T06:33:00+10:00,2023-08-12,06:33,1,1,2
62,2023-08-12T06:35:00+10:00,2023-08-12,06:35,4,0,4
63,2023-08-12T06:38:00+10:00,2023-08-12,06:38,0,2,2
67,2023-08-12T06:29:00+10:00,2023-08-12,06:29,1,1,2
67,2023-08-12T06:31:00+10:00,2023-08-12,06:31,0,1,1
67,2023-08-12T06:32:00+10:00,2023-08-12,06:32,2,2,4
67,2023-08-12T06:33:00+10:00,2023-08-12,06:33,1,1,2
67,2023-08-12T06:38:00+10:00,2023-08-12,06:38,1,0,1
79,2023-08-12T06:27:00+10:00,2023-08-12,06:27,4,4,8
79,2023-08-12T06:31:00+10:00,2023-08-12,06:31,0,1,1
79,2023-08-12T06:35:00+10:00,2023-08-12,06:35,1,3,4
79,2023-08-12T06:38:00+10:00,2023-08-12,06:38,0,1,1
109,2023-08-12T06:25:00+10:00,2023-08-12,06:25,2,0,2
109,2023-08-12T06:35:00+10:00,2023-08-12,06:35,2,2,4
122,2023-08-12T06:31:00+10:00,2023-08-12,06:31,0,1,1
122,2023-08-12T06:37:00+10:00,2023-08-12,06:37,1,0,1
3,2023-08-12T06:10:00+10:00,2023-08-12,06:10,0,1,1
3,2023-08-12T06:14:00+10:00,2023-08-12,06:14,0,1,1
6,2023-08-12T06:10:00+10:00,2023-08-12,06:10,0,1,1
6,2023-08-12T06:11:00+10:00,2023-08-12,06:11,1,1,2
6,2023-08-12T06:21:00+10:00,2023-08-12,06:21,1,0,1
6,2023-08-12T06:24:00+10:00,2023-08-12,06:24,1,1,2
14,2023-08-12T06:15:00+10:00,2023-08-12,06:15,1,1,2
14,2023-08-12T06:21:00+10:00,2023-08-12,06:21,2,0,2
21,2023-08-12T06:20:00+10:00,2023-08-12,06:20,0,1,1
28,2023-08-12T06:16:00+10:00,2023-08-12,06:16,1,0,1
28,2023-08-12T06:23:00+10:00,2023-08-12,06:23,0,1,1
41,2023-08-12T06:10:00+10:00,2023-08-12,06:10,4,3,7
41,2023-08-12T06:14:00+10:00,2023-08-12,06:14,2,1,3
41,2023-08-12T06:21:00+10:00,2023-08-12,06:21,3,0,3
41,2023-08-12T06:22:00+10:00,2023-08-12,06:22,0,4,4
41,2023-08-12T06:24:00+10:00,2023-08-12,06:24,2,1,3
55,2023-08-12T06:10:00+10:00,2023-08-12,06:10,0,1,1
55,2023-08-12T06:11:00+10:00,2023-08-12,06:11,0,1,1
59,2023-08-12T06:20:00+10:00,2023-08-12,06:20,1,0,1
61,2023-08-12T06:23:00+10:00,2023-08-12,06:23,1,1,2
61,2023-08-12T06:24:00+10:00,2023-08-12,06:24,0,2,2
65,2023-08-12T06:11:00+10:00,2023-08-12,06:11,0,1,1
65,2023-08-12T06:22:00+10:00,2023-08-12,06:22,0,2,2
66,2023-08-12T06:10:00+10:00,2023-08-12,06:10,1,0,1
66,2023-08-12T06:17:00+10:00,2023-08-12,06:17,0,1,1
66,2023-08-12T06:24:00+10:00,2023-08-12,06:24,1,1,2
70,2023-08-12T06:12:00+10:00,2023-08-12,06:12,1,0,1
77,2023-08-12T06:11:00+10:00,2023-08-12,06:11,0,1,1
77,2023-08-12T06:24:00+10:00,2023-08-12,06:24,1,0,1
78,2023-08-12T06:16:00+10:00,2023-08-12,06:16,1,0,1
78,2023-08-12T06:23:00+10:00,2023-08-12,06:23,1,0,1
87,2023-08-12T06:12:00+10:00,2023-08-12,06:12,1,0,1
108,2023-08-12T06:16:00+10:00,2023-08-12,06:16,0,1,1
108,2023-08-12T06:17:00+10:00,2023-08-12,06:17,0,1,1
1,2023-08-12T06:20:00+10:00,2023-08-12,06:20,0,3,3
2,2023-08-12T06:12:00+10:00,2023-08-12,06:12,2,0,2
17,2023-08-12T06:15:00+10:00,2023-08-12,06:15,0,1,1
17,2023-08-12T06:18:00+10:00,2023-08-12,06:18,1,0,1
17,2023-08-12T06:22:00+10:00,2023-08-12,06:22,0,1,1
24,2023-08-12T06:21:00+10:00,2023-08-12,06:21,2,3,5
27,2023-08-12T06:21:00+10:00,2023-08-12,06:21,2,0,2
35,2023-08-12T06:15:00+10:00,2023-08-12,06:15,2,1,3
35,2023-08-12T06:20:00+10:00,2023-08-12,06:20,1,0,1
35,2023-08-12T06:23:00+10:00,2023-08-12,06:23,2,3,5
53,2023-08-12T06:11:00+10:00,2023-08-12,06:11,1,0,1
56,2023-08-12T06:23:00+10:00,2023-08-12,06:23,1,0,1
58,2023-08-12T06:15:00+10:00,2023-08-12,06:15,1,0,1
58,2023-08-12T06:16:00+10:00,2023-08-12,06:16,1,0,1
58,2023-08-12T06:18:00+10:00,2023-08-12,06:18,3,0,3
58,2023-08-12T06:21:00+10:00,2023-08-12,06:21,0,2,2
58,2023-08-12T06:23:00+10:00,2023-08-12,06:23,3,0,3
62,2023-08-12T06:10:00+10:00,2023-08-12,06:10,0,2,2
62,2023-08-12T06:11:00+10:00,2023-08-12,06:11,6,0,6
62,2023-08-12T06:13:00+10:00,2023-08-12,06:13,1,0,1
62,2023-08-12T06:14:00+10:00,2023-08-12,06:14,3,0,3
62,2023-08-12T06:21:00+10:00,2023-08-12,06:21,0,1,1
62,2023-08-12T06:22:00+10:00,2023-08-12,06:22,0,1,1
63,2023-08-12T06:14:00+10:00,2023-08-12,06:14,0,2,2
67,2023-08-12T06:14:00+10:00,2023-08-12,06:14,0,3,3
67,2023-08-12T06:23:00+10:00,2023-08-12,06:23,0,1,1
72,2023-08-12T06:11:00+10:00,2023-08-12,06:11,0,1,1
72,2023-08-12T06:15:00+10:00,2023-08-12,06:15,0,1,1
72,2023-08-12T06:18:00+10:00,2023-08-12,06:18,1,0,1
72,2023-08-12T06:21:00+10:00,2023-08-12,06:21,0,2,2
72,2023-08-12T06:23:00+10:00,2023-08-12,06:23,0,1,1
79,2023-08-12T06:17:00+10:00,2023-08-12,06:17,0,1,1
79,2023-08-12T06:18:00+10:00,2023-08-12,06:18,1,0,1
79,2023-08-12T06:20:00+10:00,2023-08-12,06:20,2,0,2
79,2023-08-12T06:21:00+10:00,2023-08-12,06:21,3,0,3
79,2023-08-12T06:23:00+10:00,2023-08-12,06:23,1,0,1
79,2023-08-12T06:24:00+10:00,2023-08-12,06:24,0,1,1
85,2023-08-12T06:10:00+10:00,2023-08-12,06:10,1,0,1
85,2023-08-12T06:20:00+10:00,2023-08-12,06:20,1,0,1
86,2023-08-12T06:22:00+10:00,2023-08-12,06:22,1,0,1
109,2023-08-12T06:20:00+10:00,2023-08-12,06:20,1,2,3
117,2023-08-12T06:10:00+10:00,2023-08-12,06:10,0,1,1
3,2023-08-12T07:02:00+10:00,2023-08-12,07:02,0,2,2
4,2023-08-12T06:58:00+10:00,2023-08-12,06:58,0,1,1
4,2023-08-12T07:04:00+10:00,2023-08-12,07:04,1,1,2
4,2023-08-12T07:06:00+10:00,2023-08-12,07:06,4,2,6
4,2023-08-12T07:07:00+10:00,2023-08-12,07:07,1,0,1
6,2023-08-12T06:56:00+10:00,2023-08-12,06:56,1,1,2
6,2023-08-12T07:01:00+10:00,2023-08-12,07:01,3,3,6
6,2023-08-12T07:03:00+10:00,2023-08-12,07:03,1,0,1
8,2023-08-12T07:00:00+10:00,2023-08-12,07:00,0,2,2
8,2023-08-12T07:03:00+10:00,2023-08-12,07:03,0,2,2
8,2023-08-12T07:04:00+10:00,2023-08-12,07:04,0,1,1
14,2023-08-12T06:56:00+10:00,2023-08-12,06:56,1,0,1
14,2023-08-12T06:58:00+10:00,2023-08-12,06:58,2,0,2
14,2023-08-12T07:02:00+10:00,2023-08-12,07:02,2,0,2
28,2023-08-12T06:58:00+10:00,2023-08-12,06:58,2,1,3
28,2023-08-12T07:01:00+10:00,2023-08-12,07:01,0,1,1
28,2023-08-12T07:03:00+10:00,2023-08-12,07:03,1,0,1
28,2023-08-12T07:04:00+10:00,2023-08-12,07:04,0,2,2
29,2023-08-12T06:55:00+10:00,2023-08-12,06:55,1,1,2
29,2023-08-12T06:56:00+10:00,2023-08-12,06:56,1,1,2
29,2023-08-12T07:02:00+10:00,2023-08-12,07:02,0,8,8
41,2023-08-12T06:55:00+10:00,2023-08-12,06:55,9,5,14
41,2023-08-12T06:57:00+10:00,2023-08-12,06:57,6,2,8
41,2023-08-12T06:58:00+10:00,2023-08-12,06:58,1,6,7
41,2023-08-12T07:00:00+10:00,2023-08-12,07:00,3,3,6
41,2023-08-12T07:05:00+10:00,2023-08-12,07:05,0,3,3
41,2023-08-12T07:06:00+10:00,2023-08-12,07:06,0,1,1
41,2023-08-12T07:09:00+10:00,2023-08-12,07:09,2,0,2
54,2023-08-12T07:05:00+10:00,2023-08-12,07:05,0,1,1
55,2023-08-12T06:58:00+10:00,2023-08-12,06:58,0,1,1
55,2023-08-12T07:02:00+10:00,2023-08-12,07:02,1,0,1
55,2023-08-12T07:03:00+10:00,2023-08-12,07:03,0,4,4
55,2023-08-12T07:06:00+10:00,2023-08-12,07:06,1,2,3
55,2023-08-12T07:08:00+10:00,2023-08-12,07:08,0,1,1
59,2023-08-12T07:05:00+10:00,2023-08-12,07:05,2,3,5
61,2023-08-12T06:56:00+10:00,2023-08-12,06:56,0,1,1
61,2023-08-12T07:01:00+10:00,2023-08-12,07:01,0,2,2
65,2023-08-12T07:02:00+10:00,2023-08-12,07:02,0,1,1
66,2023-08-12T06:55:00+10:00,2023-08-12,06:55,0,1,1
66,2023-08-12T06:59:00+10:00,2023-08-12,06:59,0,1,1
70,2023-08-12T07:05:00+10:00,2023-08-12,07:05,1,0,1
70,2023-08-12T07:07:00+10:00,2023-08-12,07:07,1,0,1
70,2023-08-12T07:08:00+10:00,2023-08-12,07:08,1,0,1
75,2023-08-12T06:56:00+10:00,2023-08-12,06:56,2,0,2
75,2023-08-12T07:04:00+10:00,2023-08-12,07:04,0,1,1
75,2023-08-12T07:05:00+10:00,2023-08-12,07:05,1,0,1
78,2023-08-12T07:04:00+10:00,2023-08-12,07:04,0,1,1
84,2023-08-12T06:55:00+10:00,2023-08-12,06:55,10,4,14
84,2023-08-12T07:00:00+10:00,2023-08-12,07:00,4,8,12
87,2023-08-12T07:08:00+10:00,2023-08-12,07:08,0,1,1
108,2023-08-12T06:56:00+10:00,2023-08-12,06:56,0,1,1
108,2023-08-12T07:03:00+10:00,2023-08-12,07:03,0,1,1
108,2023-08-12T07:05:00+10:00,2023-08-12,07:05,1,0,1
1,2023-08-12T06:58:00+10:00,2023-08-12,06:58,0,1,1
1,2023-08-12T07:03:00+10:00,2023-08-12,07:03,0,1,1
1,2023-08-12T07:04:00+10:00,2023-08-12,07:04,0,1,1
2,2023-08-12T06:55:00+10:00,2023-08-12,06:55,1,0,1
2,2023-08-12T07:02:00+10:00,2023-08-12,07:02,1,0,1
2,2023-08-12T07:03:00+10:00,2023-08-12,07:03,0,1,1
7,2023-08-12T07:08:00+10:00,2023-08-12,07:08,1,1,2
9,2023-08-12T06:57:00+10:00,2023-08-12,06:57,2,0,2
9,2023-08-12T07:00:00+10:00,2023-08-12,07:00,2,0,2
9,2023-08-12T07:04:00+10:00,2023-08-12,07:04,0,1,1
11,2023-08-12T06:56:00+10:00,2023-08-12,06:56,1,0,1
11,2023-08-12T07:06:00+10:00,2023-08-12,07:06,0,1,1
12,2023-08-12T06:55:00+10:00,2023-08-12,06:55,0,1,1
12,2023-08-12T06:57:00+10:00,2023-08-12,06:57,0,2,2
12,2023-08-12T07:01:00+10:00,2023-08-12,07:01,1,1,2
12,2023-08-12T07:08:00+10:00,2023-08-12,07:08,0,1,1
17,2023-08-12T06:57:00+10:00,2023-08-12,06:57,0,1,1
17,2023-08-12T07:04:00+10:00,2023-08-12,07:04,2,1,3
17,2023-08-12T07:06:00+10:00,2023-08-12,07:06,1,0,1
17,2023-08-12T07:08:00+10:00,2023-08-12,07:08,0,2,2
24,2023-08-12T07:00:00+10:00,2023-08-12,07:00,1,3,4
24,2023-08-12T07:01:00+10:00,2023-08-12,07:01,0,5,5
24,2023-08-12T07:02:00+10:00,2023-08-12,07:02,2,0,2
24,2023-08-12T07:08:00+10:00,2023-08-12,07:08,2,8,10
27,2023-08-12T07:01:00+10:00,2023-08-12,07:01,1,2,3
35,2023-08-12T06:56:00+10:00,2023-08-12,06:56,4,2,6
35,2023-08-12T07:01:00+10:00,2023-08-12,07:01,1,4,5
35,2023-08-12T07:04:00+10:00,2023-08-12,07:04,1,0,1
35,2023-08-12T07:05:00+10:00,2023-08-12,07:05,2,0,2
35,2023-08-12T07:09:00+10:00,2023-08-12,07:09,1,0,1
53,2023-08-12T06:55:00+10:00,2023-08-12,06:55,1,0,1
53,2023-08-12T06:56:00+10:00,2023-08-12,06:56,1,0,1
53,2023-08-12T07:04:00+10:00,2023-08-12,07:04,0,2,2
56,2023-08-12T06:57:00+10:00,2023-08-12,06:57,0,1,1
56,2023-08-12T07:04:00+10:00,2023-08-12,07:04,1,0,1
57,2023-08-12T06:55:00+10:00,2023-08-12,06:55,2,1,3
58,2023-08-12T06:58:00+10:00,2023-08-12,06:58,2,2,4
58,2023-08-12T06:59:00+10:00,2023-08-12,06:59,2,4,6
58,2023-08-12T07:00:00+10:00,2023-08-12,07:00,0,1,1
58,2023-08-12T07:03:00+10:00,2023-08-12,07:03,3,1,4
58,2023-08-12T07:07:00+10:00,2023-08-12,07:07,4,2,6
62,2023-08-12T06:55:00+10:00,2023-08-12,06:55,0,2,2
62,2023-08-12T06:58:00+10:00,2023-08-12,06:58,1,1,2
62,2023-08-12T06:59:00+10:00,2023-08-12,06:59,0,1,1
62,2023-08-12T07:03:00+10:00,2023-08-12,07:03,3,0,3
62,2023-08-12T07:06:00+10:00,2023-08-12,07:06,1,0,1
63,2023-08-12T06:57:00+10:00,2023-08-12,06:57,1,0,1
63,2023-08-12T06:58:00+10:00,2023-08-12,06:58,1,0,1
63,2023-08-12T07:03:00+10:00,2023-08-12,07:03,1,0,1
67,2023-08-12T07:01:00+10:00,2023-08-12,07:01,0,3,3
68,2023-08-12T07:09:00+10:00,2023-08-12,07:09,0,1,1
72,2023-08-12T06:55:00+10:00,2023-08-12,06:55,5,2,7
72,2023-08-12T07:00:00+10:00,2023-08-12,07:00,0,1,1
79,2023-08-12T06:56:00+10:00,2023-08-12,06:56,2,0,2
79,2023-08-12T06:57:00+10:00,2023-08-12,06:57,1,1,2
85,2023-08-12T07:00:00+10:00,2023-08-12,07:00,0,1,1
109,2023-08-12T07:00:00+10:00,2023-08-12,07:00,1,4,5
122,2023-08-12T07:02:00+10:00,2023-08-12,07:02,1,1,2
3,2023-08-12T07:11:00+10:00,2023-08-12,07:11,1,1,2
3,2023-08-12T07:13:00+10:00,2023-08-12,07:13,0,1,1
3,2023-08-12T07:15:00+10:00,2023-08-12,07:15,0,1,1
4,2023-08-12T07:13:00+10:00,2023-08-12,07:13,2,0,2
4,2023-08-12T07:14:00+10:00,2023-08-12,07:14,4,0,4
4,2023-08-12T07:19:00+10:00,2023-08-12,07:19,1,0,1
4,2023-08-12T07:24:00+10:00,2023-08-12,07:24,2,1,3
6,2023-08-12T07:11:00+10:00,2023-08-12,07:11,0,3,3
6,2023-08-12T07:13:00+10:00,2023-08-12,07:13,2,0,2
6,2023-08-12T07:17:00+10:00,2023-08-12,07:17,1,1,2
6,2023-08-12T07:19:00+10:00,2023-08-12,07:19,3,0,3
6,2023-08-12T07:20:00+10:00,2023-08-12,07:20,1,1,2
6,2023-08-12T07:22:00+10:00,2023-08-12,07:22,0,2,2
8,2023-08-12T07:12:00+10:00,2023-08-12,07:12,1,0,1
8,2023-08-12T07:16:00+10:00,2023-08-12,07:16,1,0,1
8,2023-08-12T07:19:00+10:00,2023-08-12,07:19,0,3,3
8,2023-08-12T07:22:00+10:00,2023-08-12,07:22,3,0,3
14,2023-08-12T07:12:00+10:00,2023-08-12,07:12,0,1,1
14,2023-08-12T07:17:00+10:00,2023-08-12,07:17,3,0,3
21,2023-08-12T07:13:00+10:00,2023-08-12,07:13,1,0,1
21,2023-08-12T07:15:00+10:00,2023-08-12,07:15,9,3,12
21,2023-08-12T07:22:00+10:00,2023-08-12,07:22,1,0,1
28,2023-08-12T07:10:00+10:00,2023-08-12,07:10,0,2,2
28,2023-08-12T07:14:00+10:00,2023-08-12,07:14,1,0,1
28,2023-08-12T07:19:00+10:00,2023-08-12,07:19,0,2,2
28,2023-08-12T07:21:00+10:00,2023-08-12,07:21,0,1,1
28,2023-08-12T07:23:00+10:00,2023-08-12,07:23,1,0,1
29,2023-08-12T07:13:00+10:00,2023-08-12,07:13,2,0,2
29,2023-08-12T07:18:00+10:00,2023-08-12,07:18,1,4,5
29,2023-08-12T07:23:00+10:00,2023-08-12,07:23,3,0,3
29,2023-08-12T07:24:00+10:00,2023-08-12,07:24,0,1,1
41,2023-08-12T07:13:00+10:00,2023-08-12,07:13,5,0,5
41,2023-08-12T07:14:00+10:00,2023-08-12,07:14,1,0,1
41,2023-08-12T07:15:00+10:00,2023-08-12,07:15,4,0,4
41,2023-08-12T07:22:00+10:00,2023-08-12,07:22,4,1,5
41,2023-08-12T07:23:00+10:00,2023-08-12,07:23,4,0,4
54,2023-08-12T07:22:00+10:00,2023-08-12,07:22,0,2,2
54,2023-08-12T07:23:00+10:00,2023-08-12,07:23,0,1,1
55,2023-08-12T07:10:00+10:00,2023-08-12,07:10,2,1,3
55,2023-08-12T07:11:00+10:00,2023-08-12,07:11,0,4,4
55,2023-08-12T07:14:00+10:00,2023-08-12,07:14,2,6,8
55,2023-08-12T07:15:00+10:00,2023-08-12,07:15,3,3,6
55,2023-08-12T07:20:00+10:00,2023-08-12,07:20,2,0,2
55,2023-08-12T07:22:00+10:00,2023-08-12,07:22,4,1,5
65,2023-08-12T07:11:00+10:00,2023-08-12,07:11,1,0,1
65,2023-08-12T07:14:00+10:00,2023-08-12,07:14,2,0,2
65,2023-08-12T07:18:00+10:00,2023-08-12,07:18,1,0,1
65,2023-08-12T07:21:00+10:00,2023-08-12,07:21,0,3,3
66,2023-08-12T07:16:00+10:00,2023-08-12,07:16,0,1,1
66,2023-08-12T07:17:00+10:00,2023-08-12,07:17,0,1,1
69,2023-08-12T07:21:00+10:00,2023-08-12,07:21,2,1,3
69,2023-08-12T07:22:00+10:00,2023-08-12,07:22,2,3,5
69,2023-08-12T07:23:00+10:00,2023-08-12,07:23,0,1,1
75,2023-08-12T07:10:00+10:00,2023-08-12,07:10,1,0,1
75,2023-08-12T07:22:00+10:00,2023-08-12,07:22,0,2,2
75,2023-08-12T07:23:00+10:00,2023-08-12,07:23,0,1,1
77,2023-08-12T07:13:00+10:00,2023-08-12,07:13,0,1,1
77,2023-08-12T07:22:00+10:00,2023-08-12,07:22,0,4,4
78,2023-08-12T07:13:00+10:00,2023-08-12,07:13,1,0,1
78,2023-08-12T07:23:00+10:00,2023-08-12,07:23,1,0,1
87,2023-08-12T07:18:00+10:00,2023-08-12,07:18,1,0,1
87,2023-08-12T07:20:00+10:00,2023-08-12,07:20,0,1,1
108,2023-08-12T07:16:00+10:00,2023-08-12,07:16,1,0,1
108,2023-08-12T07:18:00+10:00,2023-08-12,07:18,2,1,3
108,2023-08-12T07:19:00+10:00,2023-08-12,07:19,0,3,3
108,2023-08-12T07:20:00+10:00,2023-08-12,07:20,1,0,1
108,2023-08-12T07:21:00+10:00,2023-08-12,07:21,0,3,3
108,2023-08-12T07:22:00+10:00,2023-08-12,07:22,0,1,1
1,2023-08-12T07:10:00+10:00,2023-08-12,07:10,0,1,1
1,2023-08-12T07:12:00+10:00,2023-08-12,07:12,1,0,1
1,2023-08-12T07:21:00+10:00,2023-08-12,07:21,2,0,2
2,2023-08-12T07:15:00+10:00,2023-08-12,07:15,0,1,1
2,2023-08-12T07:18:00+10:00,2023-08-12,07:18,0,1,1
9,2023-08-12T07:10:00+10:00,2023-08-12,07:10,1,0,1
9,2023-08-12T07:15:00+10:00,2023-08-12,07:15,1,1,2
9,2023-08-12T07:24:00+10:00,2023-08-12,07:24,4,0,4
12,2023-08-12T07:21:00+10:00,2023-08-12,07:21,3,1,4
17,2023-08-12T07:12:00+10:00,2023-08-12,07:12,1,1,2
17,2023-08-12T07:14:00+10:00,2023-08-12,07:14,1,0,1
17,2023-08-12T07:17:00+10:00,2023-08-12,07:17,2,1,3
18,2023-08-12T07:19:00+10:00,2023-08-12,07:19,4,0,4
24,2023-08-12T07:10:00+10:00,2023-08-12,07:10,6,0,6
24,2023-08-12T07:12:00+10:00,2023-08-12,07:12,2,0,2
24,2023-08-12T07:13:00+10:00,2023-08-12,07:13,1,1,2
24,2023-08-12T07:15:00+10:00,2023-08-12,07:15,4,0,4
24,2023-08-12T07:17:00+10:00,2023-08-12,07:17,0,2,2
24,2023-08-12T07:21:00+10:00,2023-08-12,07:21,0,4,4
24,2023-08-12T07:22:00+10:00,2023-08-12,07:22,0,13,13
24,2023-08-12T07:23:00+10:00,2023-08-12,07:23,3,1,4
27,2023-08-12T07:15:00+10:00,2023-08-12,07:15,1,0,1
35,2023-08-12T07:10:00+10:00,2023-08-12,07:10,2,0,2
35,2023-08-12T07:11:00+10:00,2023-08-12,07:11,3,1,4
35,2023-08-12T07:12:00+10:00,2023-08-12,07:12,1,5,6
35,2023-08-12T07:13:00+10:00,2023-08-12,07:13,4,2,6
35,2023-08-12T07:14:00+10:00,2023-08-12,07:14,7,2,9
35,2023-08-12T07:15:00+10:00,2023-08-12,07:15,5,1,6
35,2023-08-12T07:16:00+10:00,2023-08-12,07:16,3,3,6
35,2023-08-12T07:20:00+10:00,2023-08-12,07:20,5,1,6
53,2023-08-12T07:23:00+10:00,2023-08-12,07:23,0,1,1
57,2023-08-12T07:12:00+10:00,2023-08-12,07:12,1,0,1
57,2023-08-12T07:17:00+10:00,2023-08-12,07:17,0,1,1
58,2023-08-12T07:15:00+10:00,2023-08-12,07:15,2,2,4
58,2023-08-12T07:16:00+10:00,2023-08-12,07:16,0,2,2
58,2023-08-12T07:17:00+10:00,2023-08-12,07:17,0,2,2
62,2023-08-12T07:10:00+10:00,2023-08-12,07:10,0,1,1
62,2023-08-12T07:11:00+10:00,2023-08-12,07:11,1,0,1
62,2023-08-12T07:16:00+10:00,2023-08-12,07:16,1,0,1
63,2023-08-12T07:13:00+10:00,2023-08-12,07:13,0,1,1
63,2023-08-12T07:15:00+10:00,2023-08-12,07:15,0,1,1
63,2023-08-12T07:21:00+10:00,2023-08-12,07:21,0,2,2
67,2023-08-12T07:17:00+10:00,2023-08-12,07:17,2,1,3
67,2023-08-12T07:19:00+10:00,2023-08-12,07:19,1,0,1
68,2023-08-12T07:15:00+10:00,2023-08-12,07:15,0,1,1
72,2023-08-12T07:11:00+10:00,2023-08-12,07:11,0,1,1
72,2023-08-12T07:15:00+10:00,2023-08-12,07:15,0,1,1
72,2023-08-12T07:17:00+10:00,2023-08-12,07:17,2,0,2
72,2023-08-12T07:21:00+10:00,2023-08-12,07:21,1,0,1
72,2023-08-12T07:23:00+10:00,2023-08-12,07:23,0,1,1
76,2023-08-12T07:18:00+10:00,2023-08-12,07:18,1,0,1
76,2023-08-12T07:22:00+10:00,2023-08-12,07:22,1,0,1
79,2023-08-12T07:14:00+10:00,2023-08-12,07:14,0,1,1
79,2023-08-12T07:18:00+10:00,2023-08-12,07:18,1,2,3
79,2023-08-12T07:20:00+10:00,2023-08-12,07:20,1,1,2
86,2023-08-12T07:20:00+10:00,2023-08-12,07:20,1,0,1
109,2023-08-12T07:10:00+10:00,2023-08-12,07:10,2,0,2
109,2023-08-12T07:15:00+10:00,2023-08-12,07:15,1,2,3
109,2023-08-12T07:20:00+10:00,2023-08-12,07:20,3,2,5
117,2023-08-12T07:10:00+10:00,2023-08-12,07:10,4,1,5
117,2023-08-12T07:20:00+10:00,2023-08-12,07:20,1,2,3
122,2023-08-12T07:20:00+10:00,2023-08-12,07:20,1,0,1
122,2023-08-12T07:22:00+10:00,2023-08-12,07:22,1,0,1
3,2023-08-12T07:28:00+10:00,2023-08-12,07:28,4,3,7
3,2023-08-12T07:36:00+10:00,2023-08-12,07:36,1,1,2
4,2023-08-12T07:25:00+10:00,2023-08-12,07:25,1,1,2
4,2023-08-12T07:27:00+10:00,2023-08-12,07:27,2,0,2
4,2023-08-12T07:28:00+10:00,2023-08-12,07:28,0,1,1
4,2023-08-12T07:34:00+10:00,2023-08-12,07:34,1,2,3
4,2023-08-12T07:35:00+10:00,2023-08-12,07:35,2,0,2
4,2023-08-12T07:39:00+10:00,2023-08-12,07:39,3,2,5
6,2023-08-12T07:25:00+10:00,2023-08-12,07:25,2,1,3
6,2023-08-12T07:27:00+10:00,2023-08-12,07:27,1,3,4
6,2023-08-12T07:29:00+10:00,2023-08-12,07:29,1,0,1
6,2023-08-12T07:30:00+10:00,2023-08-12,07:30,3,0,3
6,2023-08-12T07:33:00+10:00,2023-08-12,07:33,3,2,5
8,2023-08-12T07:27:00+10:00,2023-08-12,07:27,2,1,3
8,2023-08-12T07:32:00+10:00,2023-08-12,07:32,2,0,2
8,2023-08-12T07:33:00+10:00,2023-08-12,07:33,1,0,1
14,2023-08-12T07:26:00+10:00,2023-08-12,07:26,1,0,1
14,2023-08-12T07:27:00+10:00,2023-08-12,07:27,2,0,2
14,2023-08-12T07:31:00+10:00,2023-08-12,07:31,0,1,1
14,2023-08-12T07:33:00+10:00,2023-08-12,07:33,2,5,7
14,2023-08-12T07:35:00+10:00,2023-08-12,07:35,0,1,1
14,2023-08-12T07:39:00+10:00,2023-08-12,07:39,0,1,1
21,2023-08-12T07:28:00+10:00,2023-08-12,07:28,0,2,2
21,2023-08-12T07:31:00+10:00,2023-08-12,07:31,0,2,2
21,2023-08-12T07:37:00+10:00,2023-08-12,07:37,0,1,1
28,2023-08-12T07:28:00+10:00,2023-08-12,07:28,0,2,2
28,2023-08-12T07:32:00+10:00,2023-08-12,07:32,3,1,4
28,2023-08-12T07:38:00+10:00,2023-08-12,07:38,0,1,1
29,2023-08-12T07:26:00+10:00,2023-08-12,07:26,1,0,1
29,2023-08-12T07:27:00+10:00,2023-08-12,07:27,2,0,2
29,2023-08-12T07:28:00+10:00,2023-08-12,07:28,2,0,2
29,2023-08-12T07:30:00+10:00,2023-08-12,07:30,1,0,1
29,2023-08-12T07:36:00+10:00,2023-08-12,07:36,1,0,1
41,2023-08-12T07:25:00+10:00,2023-08-12,07:25,2,3,5
41,2023-08-12T07:30:00+10:00,2023-08-12,07:30,4,0,4
41,2023-08-12T07:32:00+10:00,2023-08-12,07:32,4,1,5
41,2023-08-12T07:33:00+10:00,2023-08-12,07:33,5,2,7
41,2023-08-12T07:34:00+10:00,2023-08-12,07:34,1,1,2
41,2023-08-12T07:35:00+10:00,2023-08-12,07:35,4,0,4
41,2023-08-12T07:36:00+10:00,2023-08-12,07:36,12,3,15
41,2023-08-12T07:38:00+10:00,2023-08-12,07:38,4,1,5
55,2023-08-12T07:28:00+10:00,2023-08-12,07:28,0,5,5
55,2023-08-12T07:30:00+10:00,2023-08-12,07:30,2,0,2
55,2023-08-12T07:31:00+10:00,2023-08-12,07:31,0,4,4
55,2023-08-12T07:33:00+10:00,2023-08-12,07:33,1,3,4
55,2023-08-12T07:34:00+10:00,2023-08-12,07:34,0,3,3
55,2023-08-12T07:38:00+10:00,2023-08-12,07:38,2,1,3
59,2023-08-12T07:25:00+10:00,2023-08-12,07:25,3,1,4
59,2023-08-12T07:35:00+10:00,2023-08-12,07:35,5,4,9
61,2023-08-12T07:30:00+10:00,2023-08-12,07:30,0,2,2
61,2023-08-12T07:31:00+10:00,2023-08-12,07:31,1,1,2
61,2023-08-12T07:39:00+10:00,2023-08-12,07:39,0,2,2
65,2023-08-12T07:30:00+10:00,2023-08-12,07:30,1,0,1
65,2023-08-12T07:32:00+10:00,2023-08-12,07:32,0,2,2
65,2023-08-12T07:33:00+10:00,2023-08-12,07:33,2,0,2
65,2023-08-12T07:36:00+10:00,2023-08-12,07:36,1,0,1
65,2023-08-12T07:38:00+10:00,2023-08-12,07:38,1,0,1
66,2023-08-12T07:26:00+10:00,2023-08-12,07:26,1,2,3
66,2023-08-12T07:27:00+10:00,2023-08-12,07:27,0,1,1
66,2023-08-12T07:32:00+10:00,2023-08-12,07:32,1,0,1
66,2023-08-12T07:36:00+10:00,2023-08-12,07:36,1,0,1
66,2023-08-12T07:37:00+10:00,2023-08-12,07:37,1,0,1
66,2023-08-12T07:39:00+10:00,2023-08-12,07:39,2,0,2
70,2023-08-12T07:28:00+10:00,2023-08-12,07:28,1,0,1
70,2023-08-12T07:36:00+10:00,2023-08-12,07:36,1,0,1
75,2023-08-12T07:27:00+10:00,2023-08-12,07:27,2,0,2
77,2023-08-12T07:27:00+10:00,2023-08-12,07:27,0,1,1
77,2023-08-12T07:33:00+10:00,2023-08-12,07:33,1,3,4
77,2023-08-12T07:34:00+10:00,2023-08-12,07:34,1,0,1
78,2023-08-12T07:35:00+10:00,2023-08-12,07:35,0,1,1
87,2023-08-12T07:36:00+10:00,2023-08-12,07:36,1,0,1
108,2023-08-12T07:26:00+10:00,2023-08-12,07:26,2,1,3
118,2023-08-12T07:30:00+10:00,2023-08-12,07:30,1,2,3
1,2023-08-12T07:30:00+10:00,2023-08-12,07:30,2,0,2
1,2023-08-12T07:33:00+10:00,2023-08-12,07:33,2,0,2
7,2023-08-12T07:34:00+10:00,2023-08-12,07:34,0,1,1
9,2023-08-12T07:27:00+10:00,2023-08-12,07:27,1,1,2
9,2023-08-12T07:31:00+10:00,2023-08-12,07:31,0,1,1
10,2023-08-12T07:34:00+10:00,2023-08-12,07:34,2,0,2
11,2023-08-12T07:25:00+10:00,2023-08-12,07:25,4,0,4
11,2023-08-12T07:39:00+10:00,2023-08-12,07:39,0,1,1
12,2023-08-12T07:37:00+10:00,2023-08-12,07:37,1,0,1
12,2023-08-12T07:39:00+10:00,2023-08-12,07:39,3,0,3
17,2023-08-12T07:25:00+10:00,2023-08-12,07:25,1,1,2
17,2023-08-12T07:29:00+10:00,2023-08-12,07:29,0,1,1
17,2023-08-12T07:34:00+10:00,2023-08-12,07:34,3,0,3
17,2023-08-12T07:39:00+10:00,2023-08-12,07:39,0,1,1
18,2023-08-12T07:28:00+10:00,2023-08-12,07:28,2,2,4
18,2023-08-12T07:34:00+10:00,2023-08-12,07:34,1,0,1
24,2023-08-12T07:26:00+10:00,2023-08-12,07:26,4,0,4
24,2023-08-12T07:27:00+10:00,2023-08-12,07:27,1,3,4
24,2023-08-12T07:35:00+10:00,2023-08-12,07:35,9,1,10
24,2023-08-12T07:38:00+10:00,2023-08-12,07:38,0,2,2
24,2023-08-12T07:39:00+10:00,2023-08-12,07:39,9,6,15
27,2023-08-12T07:38:00+10:00,2023-08-12,07:38,0,2,2
35,2023-08-12T07:25:00+10:00,2023-08-12,07:25,0,2,2
35,2023-08-12T07:30:00+10:00,2023-08-12,07:30,2,2,4
35,2023-08-12T07:32:00+10:00,2023-08-12,07:32,1,1,2
35,2023-08-12T07:34:00+10:00,2023-08-12,07:34,2,3,5
35,2023-08-12T07:36:00+10:00,2023-08-12,07:36,0,2,2
53,2023-08-12T07:29:00+10:00,2023-08-12,07:29,2,0,2
53,2023-08-12T07:30:00+10:00,2023-08-12,07:30,0,1,1
53,2023-08-12T07:32:00+10:00,2023-08-12,07:32,1,0,1
56,2023-08-12T07:27:00+10:00,2023-08-12,07:27,1,0,1
56,2023-08-12T07:28:00+10:00,2023-08-12,07:28,1,1,2
57,2023-08-12T07:32:00+10:00,2023-08-12,07:32,0,1,1
57,2023-08-12T07:33:00+10:00,2023-08-12,07:33,1,2,3
57,2023-08-12T07:37:00+10:00,2023-08-12,07:37,0,3,3
58,2023-08-12T07:27:00+10:00,2023-08-12,07:27,2,2,4
58,2023-08-12T07:30:00+10:00,2023-08-12,07:30,5,2,7
58,2023-08-12T07:33:00+10:00,2023-08-12,07:33,0,1,1
58,2023-08-12T07:37:00+10:00,2023-08-12,07:37,3,1,4
62,2023-08-12T07:25:00+10:00,2023-08-12,07:25,6,0,6
62,2023-08-12T07:33:00+10:00,2023-08-12,07:33,3,0,3
62,2023-08-12T07:36:00+10:00,2023-08-12,07:36,3,0,3
63,2023-08-12T07:36:00+10:00,2023-08-12,07:36,2,1,3
63,2023-08-12T07:39:00+10:00,2023-08-12,07:39,0,1,1
67,2023-08-12T07:26:00+10:00,2023-08-12,07:26,2,3,5
67,2023-08-12T07:27:00+10:00,2023-08-12,07:27,1,0,1
67,2023-08-12T07:30:00+10:00,2023-08-12,07:30,0,4,4
67,2023-08-12T07:31:00+10:00,2023-08-12,07:31,3,1,4
68,2023-08-12T07:29:00+10:00,2023-08-12,07:29,2,0,2
68,2023-08-12T07:36:00+10:00,2023-08-12,07:36,2,0,2
68,2023-08-12T07:39:00+10:00,2023-08-12,07:39,0,1,1
72,2023-08-12T07:27:00+10:00,2023-08-12,07:27,0,2,2
72,2023-08-12T07:28:00+10:00,2023-08-12,07:28,0,2,2
72,2023-08-12T07:29:00+10:00,2023-08-12,07:29,1,1,2
72,2023-08-12T07:38:00+10:00,2023-08-12,07:38,1,0,1
76,2023-08-12T07:25:00+10:00,2023-08-12,07:25,1,0,1
79,2023-08-12T07:25:00+10:00,2023-08-12,07:25,0,1,1
79,2023-08-12T07:26:00+10:00,2023-08-12,07:26,0,1,1
79,2023-08-12T07:28:00+10:00,2023-08-12,07:28,1,1,2
79,2023-08-12T07:34:00+10:00,2023-08-12,07:34,1,2,3
79,2023-08-12T07:37:00+10:00,2023-08-12,07:37,4,2,6
85,2023-08-12T07:36:00+10:00,2023-08-12,07:36,2,0,2
86,2023-08-12T07:31:00+10:00,2023-08-12,07:31,1,0,1
86,2023-08-12T07:38:00+10:00,2023-08-12,07:38,1,0,1
109,2023-08-12T07:25:00+10:00,2023-08-12,07:25,3,1,4
109,2023-08-12T07:30:00+10:00,2023-08-12,07:30,0,3,3
109,2023-08-12T07:35:00+10:00,2023-08-12,07:35,2,7,9
122,2023-08-12T07:27:00+10:00,2023-08-12,07:27,1,0,1
122,2023-08-12T07:34:00+10:00,2023-08-12,07:34,0,2,2
122,2023-08-12T07:36:00+10:00,2023-08-12,07:36,8,0,8
3,2023-08-12T07:40:00+10:00,2023-08-12,07:40,1,6,7
3,2023-08-12T07:50:00+10:00,2023-08-12,07:50,2,2,4
3,2023-08-12T07:51:00+10:00,2023-08-12,07:51,0,2,2
4,2023-08-12T07:43:00+10:00,2023-08-12,07:43,1,3,4
4,2023-08-12T07:45:00+10:00,2023-08-12,07:45,1,1,2
4,2023-08-12T07:46:00+10:00,2023-08-12,07:46,1,0,1
4,2023-08-12T07:48:00+10:00,2023-08-12,07:48,5,0,5
4,2023-08-12T07:51:00+10:00,2023-08-12,07:51,4,2,6
6,2023-08-12T07:41:00+10:00,2023-08-12,07:41,2,2,4
6,2023-08-12T07:46:00+10:00,2023-08-12,07:46,2,1,3
6,2023-08-12T07:48:00+10:00,2023-08-12,07:48,2,2,4
6,2023-08-12T07:49:00+10:00,2023-08-12,07:49,3,6,9
6,2023-08-12T07:53:00+10:00,2023-08-12,07:53,1,0,1
6,2023-08-12T07:54:00+10:00,2023-08-12,07:54,2,1,3
8,2023-08-12T07:45:00+10:00,2023-08-12,07:45,0,6,6
8,2023-08-12T07:46:00+10:00,2023-08-12,07:46,1,1,2
8,2023-08-12T07:48:00+10:00,2023-08-12,07:48,0,3,3
8,2023-08-12T07:52:00+10:00,2023-08-12,07:52,2,0,2
14,2023-08-12T07:41:00+10:00,2023-08-12,07:41,0,1,1
14,2023-08-12T07:47:00+10:00,2023-08-12,07:47,0,1,1
14,2023-08-12T07:49:00+10:00,2023-08-12,07:49,1,1,2
14,2023-08-12T07:52:00+10:00,2023-08-12,07:52,0,1,1
21,2023-08-12T07:40:00+10:00,2023-08-12,07:40,2,0,2
21,2023-08-12T07:42:00+10:00,2023-08-12,07:42,0,5,5
21,2023-08-12T07:44:00+10:00,2023-08-12,07:44,2,0,2
21,2023-08-12T07:45:00+10:00,2023-08-12,07:45,2,1,3
21,2023-08-12T07:54:00+10:00,2023-08-12,07:54,1,1,2
28,2023-08-12T07:42:00+10:00,2023-08-12,07:42,1,0,1
28,2023-08-12T07:43:00+10:00,2023-08-12,07:43,0,1,1
28,2023-08-12T07:50:00+10:00,2023-08-12,07:50,2,0,2
28,2023-08-12T07:52:00+10:00,2023-08-12,07:52,3,3,6
28,2023-08-12T07:54:00+10:00,2023-08-12,07:54,2,1,3
29,2023-08-12T07:48:00+10:00,2023-08-12,07:48,2,0,2
29,2023-08-12T07:54:00+10:00,2023-08-12,07:54,0,3,3
39,2023-08-12T07:41:00+10:00,2023-08-12,07:41,0,2,2
39,2023-08-12T07:47:00+10:00,2023-08-12,07:47,0,1,1
41,2023-08-12T07:43:00+10:00,2023-08-12,07:43,2,2,4
41,2023-08-12T07:44:00+10:00,2023-08-12,07:44,0,5,5
41,2023-08-12T07:48:00+10:00,2023-08-12,07:48,5,4,9
41,2023-08-12T07:51:00+10:00,2023-08-12,07:51,5,0,5
41,2023-08-12T07:52:00+10:00,2023-08-12,07:52,10,0,10
55,2023-08-12T07:42:00+10:00,2023-08-12,07:42,0,1,1
55,2023-08-12T07:44:00+10:00,2023-08-12,07:44,0,3,3
55,2023-08-12T07:45:00+10:00,2023-08-12,07:45,0,4,4
55,2023-08-12T07:46:00+10:00,2023-08-12,07:46,2,3,5
55,2023-08-12T07:49:00+10:00,2023-08-12,07:49,0,3,3
55,2023-08-12T07:51:00+10:00,2023-08-12,07:51,1,1,2
55,2023-08-12T07:53:00+10:00,2023-08-12,07:53,3,4,7
55,2023-08-12T07:54:00+10:00,2023-08-12,07:54,1,0,1
61,2023-08-12T07:43:00+10:00,2023-08-12,07:43,0,1,1
61,2023-08-12T07:47:00+10:00,2023-08-12,07:47,0,1,1
61,2023-08-12T07:50:00+10:00,2023-08-12,07:50,0,1,1
61,2023-08-12T07:54:00+10:00,2023-08-12,07:54,0,2,2
65,2023-08-12T07:44:00+10:00,2023-08-12,07:44,1,0,1
65,2023-08-12T07:50:00+10:00,2023-08-12,07:50,0,1,1
65,2023-08-12T07:52:00+10:00,2023-08-12,07:52,3,0,3
66,2023-08-12T07:42:00+10:00,2023-08-12,07:42,5,0,5
66,2023-08-12T07:43:00+10:00,2023-08-12,07:43,0,2,2
66,2023-08-12T07:44:00+10:00,2023-08-12,07:44,0,4,4
66,2023-08-12T07:46:00+10:00,2023-08-12,07:46,0,1,1
66,2023-08-12T07:48:00+10:00,2023-08-12,07:48,0,7,7
69,2023-08-12T07:48:00+10:00,2023-08-12,07:48,0,1,1
70,2023-08-12T07:46:00+10:00,2023-08-12,07:46,1,0,1
70,2023-08-12T07:49:00+10:00,2023-08-12,07:49,2,0,2
70,2023-08-12T07:52:00+10:00,2023-08-12,07:52,0,1,1
75,2023-08-12T07:41:00+10:00,2023-08-12,07:41,1,0,1
77,2023-08-12T07:43:00+10:00,2023-08-12,07:43,1,0,1
77,2023-08-12T07:44:00+10:00,2023-08-12,07:44,1,0,1
77,2023-08-12T07:45:00+10:00,2023-08-12,07:45,0,1,1
77,2023-08-12T07:50:00+10:00,2023-08-12,07:50,4,2,6
84,2023-08-12T07:45:00+10:00,2023-08-12,07:45,15,8,23
87,2023-08-12T07:46:00+10:00,2023-08-12,07:46,1,1,2
87,2023-08-12T07:49:00+10:00,2023-08-12,07:49,1,0,1
108,2023-08-12T07:42:00+10:00,2023-08-12,07:42,0,2,2
108,2023-08-12T07:46:00+10:00,2023-08-12,07:46,2,0,2
1,2023-08-12T07:42:00+10:00,2023-08-12,07:42,1,1,2
1,2023-08-12T07:47:00+10:00,2023-08-12,07:47,1,2,3
1,2023-08-12T07:49:00+10:00,2023-08-12,07:49,3,1,4
2,2023-08-12T07:47:00+10:00,2023-08-12,07:47,1,0,1
2,2023-08-12T07:50:00+10:00,2023-08-12,07:50,1,1,2
2,2023-08-12T07:52:00+10:00,2023-08-12,07:52,0,1,1
2,2023-08-12T07:54:00+10:00,2023-08-12,07:54,0,2,2
7,2023-08-12T07:48:00+10:00,2023-08-12,07:48,1,0,1
7,2023-08-12T07:50:00+10:00,2023-08-12,07:50,0,2,2
7,2023-08-12T07:53:00+10:00,2023-08-12,07:53,1,0,1
7,2023-08-12T07:54:00+10:00,2023-08-12,07:54,0,1,1
9,2023-08-12T07:46:00+10:00,2023-08-12,07:46,1,0,1
9,2023-08-12T07:47:00+10:00,2023-08-12,07:47,0,1,1
9,2023-08-12T07:49:00+10:00,2023-08-12,07:49,0,1,1
9,2023-08-12T07:53:00+10:00,2023-08-12,07:53,1,0,1
10,2023-08-12T07:40:00+10:00,2023-08-12,07:40,1,0,1
10,2023-08-12T07:41:00+10:00,2023-08-12,07:41,1,0,1
10,2023-08-12T07:43:00+10:00,2023-08-12,07:43,0,1,1
10,2023-08-12T07:46:00+10:00,2023-08-12,07:46,1,0,1
10,2023-08-12T07:52:00+10:00,2023-08-12,07:52,2,0,2
11,2023-08-12T07:41:00+10:00,2023-08-12,07:41,1,0,1
11,2023-08-12T07:44:00+10:00,2023-08-12,07:44,1,0,1
11,2023-08-12T07:50:00+10:00,2023-08-12,07:50,1,1,2
11,2023-08-12T07:54:00+10:00,2023-08-12,07:54,0,1,1
12,2023-08-12T07:44:00+10:00,2023-08-12,07:44,1,0,1
12,2023-08-12T07:48:00+10:00,2023-08-12,07:48,0,2,2
12,2023-08-12T07:52:00+10:00,2023-08-12,07:52,0,2,2
12,2023-08-12T07:54:00+10:00,2023-08-12,07:54,0,3,3
17,2023-08-12T07:40:00+10:00,2023-08-12,07:40,4,0,4
17,2023-08-12T07:43:00+10:00,2023-08-12,07:43,1,2,3
17,2023-08-12T07:53:00+10:00,2023-08-12,07:53,1,0,1
17,2023-08-12T07:54:00+10:00,2023-08-12,07:54,1,0,1
18,2023-08-12T07:42:00+10:00,2023-08-12,07:42,0,1,1
18,2023-08-12T07:49:00+10:00,2023-08-12,07:49,0,1,1
24,2023-08-12T07:53:00+10:00,2023-08-12,07:53,0,3,3
27,2023-08-12T07:40:00+10:00,2023-08-12,07:40,0,2,2
27,2023-08-12T07:44:00+10:00,2023-08-12,07:44,2,1,3
27,2023-08-12T07:46:00+10:00,2023-08-12,07:46,0,1,1
27,2023-08-12T07:50:00+10:00,2023-08-12,07:50,0,1,1
27,2023-08-12T07:52:00+10:00,2023-08-12,07:52,1,0,1
35,2023-08-12T07:42:00+10:00,2023-08-12,07:42,2,2,4
35,2023-08-12T07:45:00+10:00,2023-08-12,07:45,6,0,6
35,2023-08-12T07:52:00+10:00,2023-08-12,07:52,3,6,9
53,2023-08-12T07:48:00+10:00,2023-08-12,07:48,0,1,1
56,2023-08-12T07:54:00+10:00,2023-08-12,07:54,1,0,1
57,2023-08-12T07:50:00+10:00,2023-08-12,07:50,0,1,1
58,2023-08-12T07:45:00+10:00,2023-08-12,07:45,1,2,3
58,2023-08-12T07:47:00+10:00,2023-08-12,07:47,1,0,1
58,2023-08-12T07:53:00+10:00,2023-08-12,07:53,5,0,5
58,2023-08-12T07:54:00+10:00,2023-08-12,07:54,5,2,7
62,2023-08-12T07:40:00+10:00,2023-08-12,07:40,11,1,12
62,2023-08-12T07:47:00+10:00,2023-08-12,07:47,1,0,1
62,2023-08-12T07:53:00+10:00,2023-08-12,07:53,1,1,2
63,2023-08-12T07:50:00+10:00,2023-08-12,07:50,0,1,1
63,2023-08-12T07:51:00+10:00,2023-08-12,07:51,1,1,2
63,2023-08-12T07:52:00+10:00,2023-08-12,07:52,2,0,2
67,2023-08-12T07:52:00+10:00,2023-08-12,07:52,0,1,1
67,2023-08-12T07:53:00+10:00,2023-08-12,07:53,0,3,3
68,2023-08-12T07:47:00+10:00,2023-08-12,07:47,1,0,1
68,2023-08-12T07:53:00+10:00,2023-08-12,07:53,1,0,1
72,2023-08-12T07:48:00+10:00,2023-08-12,07:48,0,1,1
72,2023-08-12T07:50:00+10:00,2023-08-12,07:50,1,4,5
76,2023-08-12T07:45:00+10:00,2023-08-12,07:45,1,1,2
79,2023-08-12T07:42:00+10:00,2023-08-12,07:42,0,2,2
79,2023-08-12T07:50:00+10:00,2023-08-12,07:50,2,0,2
79,2023-08-12T07:52:00+10:00,2023-08-12,07:52,0,5,5
85,2023-08-12T07:45:00+10:00,2023-08-12,07:45,1,0,1
109,2023-08-12T07:45:00+10:00,2023-08-12,07:45,1,2,3
117,2023-08-12T07:40:00+10:00,2023-08-12,07:40,4,5,9
117,2023-08-12T07:45:00+10:00,2023-08-12,07:45,1,7,8
122,2023-08-12T07:42:00+10:00,2023-08-12,07:42,1,0,1
122,2023-08-12T07:52:00+10:00,2023-08-12,07:52,1,0,1
3,2023-08-12T07:57:00+10:00,2023-08-12,07:57,1,1,2
3,2023-08-12T07:59:00+10:00,2023-08-12,07:59,2,1,3
3,2023-08-12T08:06:00+10:00,2023-08-12,08:06,0,5,5
3,2023-08-12T08:09:00+10:00,2023-08-12,08:09,0,1,1
4,2023-08-12T07:58:00+10:00,2023-08-12,07:58,2,1,3
4,2023-08-12T08:02:00+10:00,2023-08-12,08:02,3,2,5
4,2023-08-12T08:04:00+10:00,2023-08-12,08:04,1,2,3
4,2023-08-12T08:06:00+10:00,2023-08-12,08:06,1,0,1
6,2023-08-12T07:56:00+10:00,2023-08-12,07:56,1,6,7
6,2023-08-12T07:58:00+10:00,2023-08-12,07:58,2,2,4
6,2023-08-12T07:59:00+10:00,2023-08-12,07:59,1,4,5
6,2023-08-12T08:00:00+10:00,2023-08-12,08:00,1,0,1
6,2023-08-12T08:01:00+10:00,2023-08-12,08:01,3,3,6
6,2023-08-12T08:03:00+10:00,2023-08-12,08:03,1,1,2
6,2023-08-12T08:04:00+10:00,2023-08-12,08:04,2,0,2
6,2023-08-12T08:05:00+10:00,2023-08-12,08:05,1,1,2
6,2023-08-12T08:06:00+10:00,2023-08-12,08:06,2,1,3
6,2023-08-12T08:07:00+10:00,2023-08-12,08:07,2,1,3
6,2023-08-12T08:09:00+10:00,2023-08-12,08:09,3,4,7
8,2023-08-12T07:55:00+10:00,2023-08-12,07:55,0,2,2
8,2023-08-12T08:02:00+10:00,2023-08-12,08:02,2,0,2
14,2023-08-12T07:55:00+10:00,2023-08-12,07:55,3,0,3
14,2023-08-12T07:56:00+10:00,2023-08-12,07:56,2,1,3
14,2023-08-12T08:07:00+10:00,2023-08-12,08:07,2,0,2
21,2023-08-12T07:59:00+10:00,2023-08-12,07:59,1,0,1
21,2023-08-12T08:01:00+10:00,2023-08-12,08:01,1,1,2
21,2023-08-12T08:03:00+10:00,2023-08-12,08:03,2,0,2
28,2023-08-12T07:55:00+10:00,2023-08-12,07:55,2,1,3
28,2023-08-12T07:57:00+10:00,2023-08-12,07:57,1,0,1
28,2023-08-12T08:02:00+10:00,2023-08-12,08:02,0,1,1
28,2023-08-12T08:04:00+10:00,2023-08-12,08:04,3,1,4
29,2023-08-12T07:56:00+10:00,2023-08-12,07:56,0,6,6
29,2023-08-12T07:57:00+10:00,2023-08-12,07:57,0,3,3
29,2023-08-12T08:06:00+10:00,2023-08-12,08:06,1,0,1
39,2023-08-12T08:05:00+10:00,2023-08-12,08:05,1,1,2
41,2023-08-12T07:55:00+10:00,2023-08-12,07:55,2,0,2
41,2023-08-12T07:56:00+10:00,2023-08-12,07:56,2,4,6
41,2023-08-12T07:58:00+10:00,2023-08-12,07:58,2,6,8
41,2023-08-12T07:59:00+10:00,2023-08-12,07:59,16,1,17
41,2023-08-12T08:00:00+10:00,2023-08-12,08:00,1,2,3
41,2023-08-12T08:01:00+10:00,2023-08-12,08:01,3,3,6
41,2023-08-12T08:02:00+10:00,2023-08-12,08:02,1,0,1
41,2023-08-12T08:04:00+10:00,2023-08-12,08:04,8,0,8
41,2023-08-12T08:05:00+10:00,2023-08-12,08:05,9,3,12
41,2023-08-12T08:07:00+10:00,2023-08-12,08:07,5,1,6
54,2023-08-12T07:55:00+10:00,2023-08-12,07:55,1,0,1
54,2023-08-12T07:57:00+10:00,2023-08-12,07:57,1,0,1
54,2023-08-12T08:08:00+10:00,2023-08-12,08:08,1,0,1
55,2023-08-12T07:56:00+10:00,2023-08-12,07:56,0,1,1
55,2023-08-12T07:58:00+10:00,2023-08-12,07:58,2,0,2
55,2023-08-12T08:00:00+10:00,2023-08-12,08:00,1,2,3
55,2023-08-12T08:04:00+10:00,2023-08-12,08:04,0,2,2
55,2023-08-12T08:08:00+10:00,2023-08-12,08:08,2,7,9
61,2023-08-12T07:56:00+10:00,2023-08-12,07:56,1,1,2
61,2023-08-12T07:58:00+10:00,2023-08-12,07:58,2,0,2
61,2023-08-12T07:59:00+10:00,2023-08-12,07:59,2,1,3
65,2023-08-12T08:04:00+10:00,2023-08-12,08:04,2,1,3
65,2023-08-12T08:07:00+10:00,2023-08-12,08:07,0,2,2
65,2023-08-12T08:09:00+10:00,2023-08-12,08:09,0,2,2
66,2023-08-12T07:56:00+10:00,2023-08-12,07:56,1,0,1
66,2023-08-12T07:58:00+10:00,2023-08-12,07:58,0,3,3
66,2023-08-12T08:00:00+10:00,2023-08-12,08:00,0,1,1
66,2023-08-12T08:01:00+10:00,2023-08-12,08:01,1,2,3
66,2023-08-12T08:05:00+10:00,2023-08-12,08:05,0,1,1
69,2023-08-12T08:00:00+10:00,2023-08-12,08:00,1,0,1
69,2023-08-12T08:07:00+10:00,2023-08-12,08:07,1,0,1
69,2023-08-12T08:09:00+10:00,2023-08-12,08:09,1,1,2
70,2023-08-12T08:08:00+10:00,2023-08-12,08:08,0,1,1
71,2023-08-12T07:56:00+10:00,2023-08-12,07:56,0,1,1
71,2023-08-12T08:02:00+10:00,2023-08-12,08:02,1,1,2
75,2023-08-12T08:00:00+10:00,2023-08-12,08:00,2,0,2
77,2023-08-12T07:59:00+10:00,2023-08-12,07:59,1,0,1
77,2023-08-12T08:06:00+10:00,2023-08-12,08:06,1,1,2
77,2023-08-12T08:07:00+10:00,2023-08-12,08:07,0,4,4
78,2023-08-12T07:58:00+10:00,2023-08-12,07:58,0,1,1
84,2023-08-12T08:00:00+10:00,2023-08-12,08:00,12,10,22
87,2023-08-12T07:59:00+10:00,2023-08-12,07:59,0,1,1
87,2023-08-12T08:03:00+10:00,2023-08-12,08:03,1,0,1
87,2023-08-12T08:06:00+10:00,2023-08-12,08:06,2,0,2
108,2023-08-12T07:58:00+10:00,2023-08-12,07:58,2,0,2
1,2023-08-12T08:04:00+10:00,2023-08-12,08:04,4,3,7
1,2023-08-12T08:05:00+10:00,2023-08-12,08:05,0,2,2
1,2023-08-12T08:09:00+10:00,2023-08-12,08:09,1,0,1
2,2023-08-12T07:55:00+10:00,2023-08-12,07:55,0,1,1
2,2023-08-12T07:56:00+10:00,2023-08-12,07:56,1,2,3
2,2023-08-12T07:57:00+10:00,2023-08-12,07:57,1,0,1
2,2023-08-12T08:03:00+10:00,2023-08-12,08:03,1,0,1
7,2023-08-12T07:59:00+10:00,2023-08-12,07:59,1,0,1
7,2023-08-12T08:05:00+10:00,2023-08-12,08:05,2,0,2
9,2023-08-12T08:00:00+10:00,2023-08-12,08:00,0,3,3
9,2023-08-12T08:09:00+10:00,2023-08-12,08:09,1,0,1
10,2023-08-12T07:55:00+10:00,2023-08-12,07:55,1,0,1
10,2023-08-12T07:56:00+10:00,2023-08-12,07:56,0,1,1
10,2023-08-12T08:01:00+10:00,2023-08-12,08:01,0,1,1
11,2023-08-12T07:56:00+10:00,2023-08-12,07:56,0,3,3
11,2023-08-12T08:00:00+10:00,2023-08-12,08:00,4,3,7
11,2023-08-12T08:01:00+10:00,2023-08-12,08:01,0,1,1
12,2023-08-12T07:59:00+10:00,2023-08-12,07:59,1,0,1
12,2023-08-12T08:00:00+10:00,2023-08-12,08:00,0,2,2
12,2023-08-12T08:02:00+10:00,2023-08-12,08:02,2,1,3
12,2023-08-12T08:03:00+10:00,2023-08-12,08:03,0,4,4
12,2023-08-12T08:04:00+10:00,2023-08-12,08:04,2,1,3
12,2023-08-12T08:05:00+10:00,2023-08-12,08:05,3,2,5
12,2023-08-12T08:06:00+10:00,2023-08-12,08:06,1,0,1
17,2023-08-12T07:59:00+10:00,2023-08-12,07:59,3,0,3
17,2023-08-12T08:05:00+10:00,2023-08-12,08:05,0,1,1
18,2023-08-12T08:04:00+10:00,2023-08-12,08:04,1,0,1
18,2023-08-12T08:08:00+10:00,2023-08-12,08:08,2,0,2
18,2023-08-12T08:09:00+10:00,2023-08-12,08:09,0,1,1
24,2023-08-12T07:56:00+10:00,2023-08-12,07:56,5,5,10
24,2023-08-12T07:59:00+10:00,2023-08-12,07:59,2,1,3
24,2023-08-12T08:05:00+10:00,2023-08-12,08:05,4,1,5
27,2023-08-12T07:55:00+10:00,2023-08-12,07:55,2,4,6
27,2023-08-12T08:01:00+10:00,2023-08-12,08:01,5,0,5
27,2023-08-12T08:03:00+10:00,2023-08-12,08:03,0,1,1
27,2023-08-12T08:07:00+10:00,2023-08-12,08:07,2,0,2
27,2023-08-12T08:09:00+10:00,2023-08-12,08:09,0,3,3
35,2023-08-12T07:57:00+10:00,2023-08-12,07:57,2,1,3
35,2023-08-12T07:58:00+10:00,2023-08-12,07:58,1,2,3
35,2023-08-12T07:59:00+10:00,2023-08-12,07:59,4,2,6
35,2023-08-12T08:01:00+10:00,2023-08-12,08:01,2,1,3
35,2023-08-12T08:02:00+10:00,2023-08-12,08:02,0,1,1
35,2023-08-12T08:03:00+10:00,2023-08-12,08:03,2,2,4
35,2023-08-12T08:05:00+10:00,2023-08-12,08:05,2,0,2
35,2023-08-12T08:07:00+10:00,2023-08-12,08:07,3,5,8
35,2023-08-12T08:08:00+10:00,2023-08-12,08:08,1,4,5
35,2023-08-12T08:09:00+10:00,2023-08-12,08:09,4,1,5
53,2023-08-12T07:57:00+10:00,2023-08-12,07:57,1,1,2
53,2023-08-12T08:02:00+10:00,2023-08-12,08:02,1,0,1
53,2023-08-12T08:03:00+10:00,2023-08-12,08:03,1,2,3
53,2023-08-12T08:07:00+10:00,2023-08-12,08:07,1,0,1
53,2023-08-12T08:09:00+10:00,2023-08-12,08:09,7,0,7
56,2023-08-12T07:55:00+10:00,2023-08-12,07:55,1,0,1
56,2023-08-12T08:05:00+10:00,2023-08-12,08:05,3,0,3
57,2023-08-12T08:00:00+10:00,2023-08-12,08:00,0,2,2
57,2023-08-12T08:01:00+10:00,2023-08-12,08:01,0,1,1
57,2023-08-12T08:06:00+10:00,2023-08-12,08:06,3,2,5
57,2023-08-12T08:08:00+10:00,2023-08-12,08:08,2,2,4
58,2023-08-12T08:04:00+10:00,2023-08-12,08:04,5,0,5
58,2023-08-12T08:05:00+10:00,2023-08-12,08:05,7,1,8
58,2023-08-12T08:07:00+10:00,2023-08-12,08:07,3,4,7
58,2023-08-12T08:09:00+10:00,2023-08-12,08:09,8,3,11
62,2023-08-12T07:55:00+10:00,2023-08-12,07:55,1,0,1
62,2023-08-12T08:06:00+10:00,2023-08-12,08:06,0,2,2
62,2023-08-12T08:08:00+10:00,2023-08-12,08:08,2,0,2
63,2023-08-12T07:56:00+10:00,2023-08-12,07:56,0,2,2
63,2023-08-12T08:00:00+10:00,2023-08-12,08:00,1,1,2
63,2023-08-12T08:01:00+10:00,2023-08-12,08:01,0,1,1
63,2023-08-12T08:02:00+10:00,2023-08-12,08:02,1,1,2
63,2023-08-12T08:03:00+10:00,2023-08-12,08:03,1,0,1
63,2023-08-12T08:09:00+10:00,2023-08-12,08:09,2,1,3
67,2023-08-12T07:56:00+10:00,2023-08-12,07:56,2,1,3
67,2023-08-12T08:00:00+10:00,2023-08-12,08:00,1,1,2
67,2023-08-12T08:02:00+10:00,2023-08-12,08:02,1,2,3
67,2023-08-12T08:04:00+10:00,2023-08-12,08:04,1,0,1
68,2023-08-12T08:05:00+10:00,2023-08-12,08:05,1,1,2
68,2023-08-12T08:07:00+10:00,2023-08-12,08:07,1,1,2
72,2023-08-12T08:07:00+10:00,2023-08-12,08:07,0,4,4
79,2023-08-12T07:56:00+10:00,2023-08-12,07:56,1,1,2
79,2023-08-12T07:57:00+10:00,2023-08-12,07:57,1,0,1
79,2023-08-12T08:01:00+10:00,2023-08-12,08:01,0,3,3
79,2023-08-12T08:02:00+10:00,2023-08-12,08:02,1,1,2
79,2023-08-12T08:06:00+10:00,2023-08-12,08:06,0,1,1
85,2023-08-12T07:55:00+10:00,2023-08-12,07:55,1,0,1
85,2023-08-12T07:57:00+10:00,2023-08-12,07:57,3,0,3
85,2023-08-12T07:58:00+10:00,2023-08-12,07:58,0,1,1
109,2023-08-12T08:05:00+10:00,2023-08-12,08:05,0,7,7
122,2023-08-12T07:56:00+10:00,2023-08-12,07:56,1,0,1
122,2023-08-12T08:09:00+10:00,2023-08-12,08:09,1,0,1
3,2023-08-12T08:10:00+10:00,2023-08-12,08:10,3,2,5
3,2023-08-12T08:24:00+10:00,2023-08-12,08:24,0,3,3
4,2023-08-12T08:12:00+10:00,2023-08-12,08:12,1,1,2
4,2023-08-12T08:15:00+10:00,2023-08-12,08:15,2,3,5
4,2023-08-12T08:16:00+10:00,2023-08-12,08:16,4,0,4
4,2023-08-12T08:17:00+10:00,2023-08-12,08:17,7,2,9
4,2023-08-12T08:20:00+10:00,2023-08-12,08:20,3,1,4
4,2023-08-12T08:21:00+10:00,2023-08-12,08:21,7,0,7
4,2023-08-12T08:24:00+10:00,2023-08-12,08:24,4,1,5
6,2023-08-12T08:10:00+10:00,2023-08-12,08:10,2,3,5
6,2023-08-12T08:11:00+10:00,2023-08-12,08:11,3,2,5
6,2023-08-12T08:12:00+10:00,2023-08-12,08:12,4,5,9
6,2023-08-12T08:13:00+10:00,2023-08-12,08:13,2,1,3
6,2023-08-12T08:20:00+10:00,2023-08-12,08:20,10,5,15
8,2023-08-12T08:21:00+10:00,2023-08-12,08:21,3,0,3
14,2023-08-12T08:10:00+10:00,2023-08-12,08:10,0,1,1
14,2023-08-12T08:14:00+10:00,2023-08-12,08:14,8,0,8
14,2023-08-12T08:15:00+10:00,2023-08-12,08:15,3,1,4
14,2023-08-12T08:23:00+10:00,2023-08-12,08:23,3,3,6
21,2023-08-12T08:11:00+10:00,2023-08-12,08:11,0,2,2
21,2023-08-12T08:13:00+10:00,2023-08-12,08:13,0,5,5
21,2023-08-12T08:20:00+10:00,2023-08-12,08:20,0,2,2
28,2023-08-12T08:12:00+10:00,2023-08-12,08:12,0,2,2
28,2023-08-12T08:18:00+10:00,2023-08-12,08:18,5,2,7
28,2023-08-12T08:19:00+10:00,2023-08-12,08:19,2,2,4
29,2023-08-12T08:10:00+10:00,2023-08-12,08:10,2,2,4
29,2023-08-12T08:11:00+10:00,2023-08-12,08:11,0,2,2
29,2023-08-12T08:12:00+10:00,2023-08-12,08:12,0,1,1
29,2023-08-12T08:18:00+10:00,2023-08-12,08:18,0,1,1
29,2023-08-12T08:20:00+10:00,2023-08-12,08:20,2,2,4
39,2023-08-12T08:16:00+10:00,2023-08-12,08:16,1,0,1
39,2023-08-12T08:20:00+10:00,2023-08-12,08:20,0,1,1
39,2023-08-12T08:21:00+10:00,2023-08-12,08:21,0,2,2
41,2023-08-12T08:10:00+10:00,2023-08-12,08:10,6,10,16
41,2023-08-12T08:11:00+10:00,2023-08-12,08:11,3,4,7
41,2023-08-12T08:12:00+10:00,2023-08-12,08:12,15,2,17
41,2023-08-12T08:15:00+10:00,2023-08-12,08:15,1,2,3
41,2023-08-12T08:20:00+10:00,2023-08-12,08:20,9,2,11
41,2023-08-12T08:22:00+10:00,2023-08-12,08:22,8,1,9
41,2023-08-12T08:24:00+10:00,2023-08-12,08:24,8,6,14
54,2023-08-12T08:20:00+10:00,2023-08-12,08:20,2,0,2
54,2023-08-12T08:22:00+10:00,2023-08-12,08:22,1,1,2
54,2023-08-12T08:23:00+10:00,2023-08-12,08:23,0,1,1
55,2023-08-12T08:12:00+10:00,2023-08-12,08:12,1,1,2
55,2023-08-12T08:13:00+10:00,2023-08-12,08:13,2,3,5
55,2023-08-12T08:16:00+10:00,2023-08-12,08:16,0,3,3
55,2023-08-12T08:17:00+10:00,2023-08-12,08:17,3,0,3
55,2023-08-12T08:18:00+10:00,2023-08-12,08:18,0,1,1
55,2023-08-12T08:20:00+10:00,2023-08-12,08:20,1,8,9
59,2023-08-12T08:10:00+10:00,2023-08-12,08:10,4,3,7
59,2023-08-12T08:15:00+10:00,2023-08-12,08:15,1,2,3
61,2023-08-12T08:10:00+10:00,2023-08-12,08:10,2,2,4
61,2023-08-12T08:13:00+10:00,2023-08-12,08:13,2,0,2
61,2023-08-12T08:16:00+10:00,2023-08-12,08:16,0,1,1
61,2023-08-12T08:21:00+10:00,2023-08-12,08:21,1,2,3
61,2023-08-12T08:22:00+10:00,2023-08-12,08:22,0,1,1
61,2023-08-12T08:23:00+10:00,2023-08-12,08:23,1,0,1
61,2023-08-12T08:24:00+10:00,2023-08-12,08:24,0,3,3
65,2023-08-12T08:13:00+10:00,2023-08-12,08:13,2,4,6
65,2023-08-12T08:19:00+10:00,2023-08-12,08:19,0,1,1
66,2023-08-12T08:11:00+10:00,2023-08-12,08:11,1,6,7
66,2023-08-12T08:15:00+10:00,2023-08-12,08:15,4,1,5
69,2023-08-12T08:11:00+10:00,2023-08-12,08:11,2,0,2
69,2023-08-12T08:13:00+10:00,2023-08-12,08:13,2,1,3
69,2023-08-12T08:14:00+10:00,2023-08-12,08:14,1,0,1
70,2023-08-12T08:13:00+10:00,2023-08-12,08:13,1,0,1
70,2023-08-12T08:14:00+10:00,2023-08-12,08:14,1,2,3
70,2023-08-12T08:15:00+10:00,2023-08-12,08:15,4,0,4
70,2023-08-12T08:16:00+10:00,2023-08-12,08:16,1,1,2
70,2023-08-12T08:20:00+10:00,2023-08-12,08:20,1,0,1
70,2023-08-12T08:22:00+10:00,2023-08-12,08:22,0,2,2
71,2023-08-12T08:22:00+10:00,2023-08-12,08:22,1,0,1
75,2023-08-12T08:14:00+10:00,2023-08-12,08:14,0,1,1
75,2023-08-12T08:15:00+10:00,2023-08-12,08:15,0,1,1
75,2023-08-12T08:16:00+10:00,2023-08-12,08:16,1,0,1
77,2023-08-12T08:11:00+10:00,2023-08-12,08:11,0,1,1
77,2023-08-12T08:14:00+10:00,2023-08-12,08:14,1,1,2
77,2023-08-12T08:15:00+10:00,2023-08-12,08:15,0,2,2
77,2023-08-12T08:22:00+10:00,2023-08-12,08:22,2,0,2
77,2023-08-12T08:23:00+10:00,2023-08-12,08:23,1,0,1
78,2023-08-12T08:12:00+10:00,2023-08-12,08:12,0,2,2
78,2023-08-12T08:13:00+10:00,2023-08-12,08:13,0,1,1
78,2023-08-12T08:22:00+10:00,2023-08-12,08:22,3,1,4
84,2023-08-12T08:15:00+10:00,2023-08-12,08:15,26,14,40
87,2023-08-12T08:13:00+10:00,2023-08-12,08:13,1,2,3
87,2023-08-12T08:16:00+10:00,2023-08-12,08:16,2,0,2
87,2023-08-12T08:18:00+10:00,2023-08-12,08:18,4,0,4
107,2023-08-12T08:10:00+10:00,2023-08-12,08:10,3,1,4
107,2023-08-12T08:20:00+10:00,2023-08-12,08:20,10,9,19
108,2023-08-12T08:13:00+10:00,2023-08-12,08:13,0,1,1
108,2023-08-12T08:15:00+10:00,2023-08-12,08:15,0,2,2
108,2023-08-12T08:17:00+10:00,2023-08-12,08:17,1,2,3
108,2023-08-12T08:19:00+10:00,2023-08-12,08:19,1,0,1
118,2023-08-12T08:20:00+10:00,2023-08-12,08:20,1,0,1
1,2023-08-12T08:11:00+10:00,2023-08-12,08:11,0,1,1
1,2023-08-12T08:12:00+10:00,2023-08-12,08:12,3,0,3
1,2023-08-12T08:13:00+10:00,2023-08-12,08:13,1,1,2
1,2023-08-12T08:15:00+10:00,2023-08-12,08:15,3,0,3
1,2023-08-12T08:17:00+10:00,2023-08-12,08:17,1,1,2
1,2023-08-12T08:23:00+10:00,2023-08-12,08:23,2,1,3
2,2023-08-12T08:11:00+10:00,2023-08-12,08:11,1,1,2
2,2023-08-12T08:13:00+10:00,2023-08-12,08:13,1,0,1
7,2023-08-12T08:22:00+10:00,2023-08-12,08:22,1,3,4
9,2023-08-12T08:11:00+10:00,2023-08-12,08:11,1,1,2
9,2023-08-12T08:17:00+10:00,2023-08-12,08:17,0,1,1
9,2023-08-12T08:19:00+10:00,2023-08-12,08:19,0,2,2
9,2023-08-12T08:23:00+10:00,2023-08-12,08:23,3,0,3
10,2023-08-12T08:15:00+10:00,2023-08-12,08:15,2,0,2
10,2023-08-12T08:16:00+10:00,2023-08-12,08:16,1,2,3
10,2023-08-12T08:18:00+10:00,2023-08-12,08:18,1,0,1
10,2023-08-12T08:21:00+10:00,2023-08-12,08:21,1,3,4
11,2023-08-12T08:10:00+10:00,2023-08-12,08:10,2,5,7
11,2023-08-12T08:12:00+10:00,2023-08-12,08:12,1,0,1
11,2023-08-12T08:14:00+10:00,2023-08-12,08:14,1,0,1
11,2023-08-12T08:17:00+10:00,2023-08-12,08:17,2,1,3
12,2023-08-12T08:12:00+10:00,2023-08-12,08:12,0,1,1
12,2023-08-12T08:14:00+10:00,2023-08-12,08:14,2,1,3
12,2023-08-12T08:15:00+10:00,2023-08-12,08:15,2,1,3
12,2023-08-12T08:17:00+10:00,2023-08-12,08:17,2,0,2
17,2023-08-12T08:13:00+10:00,2023-08-12,08:13,2,0,2
17,2023-08-12T08:14:00+10:00,2023-08-12,08:14,1,0,1
17,2023-08-12T08:19:00+10:00,2023-08-12,08:19,0,3,3
17,2023-08-12T08:20:00+10:00,2023-08-12,08:20,1,1,2
17,2023-08-12T08:21:00+10:00,2023-08-12,08:21,2,0,2
17,2023-08-12T08:22:00+10:00,2023-08-12,08:22,2,0,2
18,2023-08-12T08:15:00+10:00,2023-08-12,08:15,2,0,2
18,2023-08-12T08:16:00+10:00,2023-08-12,08:16,0,1,1
18,2023-08-12T08:17:00+10:00,2023-08-12,08:17,1,1,2
18,2023-08-12T08:18:00+10:00,2023-08-12,08:18,2,0,2
18,2023-08-12T08:21:00+10:00,2023-08-12,08:21,0,2,2
24,2023-08-12T08:13:00+10:00,2023-08-12,08:13,4,1,5
24,2023-08-12T08:17:00+10:00,2023-08-12,08:17,0,1,1
24,2023-08-12T08:19:00+10:00,2023-08-12,08:19,2,3,5
24,2023-08-12T08:20:00+10:00,2023-08-12,08:20,5,4,9
27,2023-08-12T08:10:00+10:00,2023-08-12,08:10,0,1,1
27,2023-08-12T08:14:00+10:00,2023-08-12,08:14,1,0,1
27,2023-08-12T08:18:00+10:00,2023-08-12,08:18,1,0,1
27,2023-08-12T08:19:00+10:00,2023-08-12,08:19,0,1,1
27,2023-08-12T08:21:00+10:00,2023-08-12,08:21,1,0,1
27,2023-08-12T08:22:00+10:00,2023-08-12,08:22,1,0,1
27,2023-08-12T08:23:00+10:00,2023-08-12,08:23,7,3,10
35,2023-08-12T08:16:00+10:00,2023-08-12,08:16,6,3,9
35,2023-08-12T08:17:00+10:00,2023-08-12,08:17,4,1,5
35,2023-08-12T08:19:00+10:00,2023-08-12,08:19,4,5,9
53,2023-08-12T08:13:00+10:00,2023-08-12,08:13,1,3,4
53,2023-08-12T08:24:00+10:00,2023-08-12,08:24,1,0,1
56,2023-08-12T08:16:00+10:00,2023-08-12,08:16,0,3,3
56,2023-08-12T08:17:00+10:00,2023-08-12,08:17,0,3,3
56,2023-08-12T08:24:00+10:00,2023-08-12,08:24,1,0,1
57,2023-08-12T08:11:00+10:00,2023-08-12,08:11,0,1,1
57,2023-08-12T08:12:00+10:00,2023-08-12,08:12,0,2,2
57,2023-08-12T08:14:00+10:00,2023-08-12,08:14,1,0,1
57,2023-08-12T08:15:00+10:00,2023-08-12,08:15,1,0,1
57,2023-08-12T08:21:00+10:00,2023-08-12,08:21,2,0,2
58,2023-08-12T08:17:00+10:00,2023-08-12,08:17,5,0,5
62,2023-08-12T08:11:00+10:00,2023-08-12,08:11,3,3,6
63,2023-08-12T08:12:00+10:00,2023-08-12,08:12,1,0,1
63,2023-08-12T08:14:00+10:00,2023-08-12,08:14,0,1,1
63,2023-08-12T08:17:00+10:00,2023-08-12,08:17,1,0,1
63,2023-08-12T08:20:00+10:00,2023-08-12,08:20,1,0,1
63,2023-08-12T08:21:00+10:00,2023-08-12,08:21,2,0,2
67,2023-08-12T08:12:00+10:00,2023-08-12,08:12,1,0,1
67,2023-08-12T08:24:00+10:00,2023-08-12,08:24,0,2,2
68,2023-08-12T08:15:00+10:00,2023-08-12,08:15,0,1,1
68,2023-08-12T08:23:00+10:00,2023-08-12,08:23,1,0,1
68,2023-08-12T08:24:00+10:00,2023-08-12,08:24,3,2,5
72,2023-08-12T08:11:00+10:00,2023-08-12,08:11,1,0,1
72,2023-08-12T08:16:00+10:00,2023-08-12,08:16,0,1,1
72,2023-08-12T08:17:00+10:00,2023-08-12,08:17,0,1,1
72,2023-08-12T08:19:00+10:00,2023-08-12,08:19,1,0,1
76,2023-08-12T08:13:00+10:00,2023-08-12,08:13,0,2,2
76,2023-08-12T08:23:00+10:00,2023-08-12,08:23,1,1,2
79,2023-08-12T08:18:00+10:00,2023-08-12,08:18,8,4,12
79,2023-08-12T08:24:00+10:00,2023-08-12,08:24,2,1,3
85,2023-08-12T08:11:00+10:00,2023-08-12,08:11,3,0,3
85,2023-08-12T08:16:00+10:00,2023-08-12,08:16,1,0,1
85,2023-08-12T08:20:00+10:00,2023-08-12,08:20,3,0,3
86,2023-08-12T08:10:00+10:00,2023-08-12,08:10,0,1,1
86,2023-08-12T08:11:00+10:00,2023-08-12,08:11,0,1,1
86,2023-08-12T08:20:00+10:00,2023-08-12,08:20,1,1,2
109,2023-08-12T08:10:00+10:00,2023-08-12,08:10,0,3,3
117,2023-08-12T08:10:00+10:00,2023-08-12,08:10,3,7,10
117,2023-08-12T08:15:00+10:00,2023-08-12,08:15,4,4,8
122,2023-08-12T08:11:00+10:00,2023-08-12,08:11,0,1,1
122,2023-08-12T08:13:00+10:00,2023-08-12,08:13,0,1,1
3,2023-08-12T08:26:00+10:00,2023-08-12,08:26,1,4,5
3,2023-08-12T08:27:00+10:00,2023-08-12,08:27,2,2,4
3,2023-08-12T08:28:00+10:00,2023-08-12,08:28,2,2,4
3,2023-08-12T08:31:00+10:00,2023-08-12,08:31,3,1,4
3,2023-08-12T08:33:00+10:00,2023-08-12,08:33,3,2,5
3,2023-08-12T08:34:00+10:00,2023-08-12,08:34,0,1,1
3,2023-08-12T08:37:00+10:00,2023-08-12,08:37,1,1,2
3,2023-08-12T08:38:00+10:00,2023-08-12,08:38,5,1,6
3,2023-08-12T08:39:00+10:00,2023-08-12,08:39,1,5,6
4,2023-08-12T08:25:00+10:00,2023-08-12,08:25,3,2,5
4,2023-08-12T08:32:00+10:00,2023-08-12,08:32,6,2,8
6,2023-08-12T08:29:00+10:00,2023-08-12,08:29,1,1,2
6,2023-08-12T08:32:00+10:00,2023-08-12,08:32,2,1,3
6,2023-08-12T08:38:00+10:00,2023-08-12,08:38,8,3,11
8,2023-08-12T08:26:00+10:00,2023-08-12,08:26,1,1,2
8,2023-08-12T08:27:00+10:00,2023-08-12,08:27,4,1,5
8,2023-08-12T08:31:00+10:00,2023-08-12,08:31,0,1,1
8,2023-08-12T08:32:00+10:00,2023-08-12,08:32,4,3,7
8,2023-08-12T08:35:00+10:00,2023-08-12,08:35,1,0,1
8,2023-08-12T08:37:00+10:00,2023-08-12,08:37,0,1,1
8,2023-08-12T08:38:00+10:00,2023-08-12,08:38,1,0,1
8,2023-08-12T08:39:00+10:00,2023-08-12,08:39,0,2,2
14,2023-08-12T08:29:00+10:00,2023-08-12,08:29,1,3,4
14,2023-08-12T08:30:00+10:00,2023-08-12,08:30,4,2,6
14,2023-08-12T08:31:00+10:00,2023-08-12,08:31,1,1,2
14,2023-08-12T08:34:00+10:00,2023-08-12,08:34,1,1,2
14,2023-08-12T08:38:00+10:00,2023-08-12,08:38,2,0,2
21,2023-08-12T08:25:00+10:00,2023-08-12,08:25,2,1,3
28,2023-08-12T08:25:00+10:00,2023-08-12,08:25,3,2,5
28,2023-08-12T08:29:00+10:00,2023-08-12,08:29,1,4,5
28,2023-08-12T08:30:00+10:00,2023-08-12,08:30,1,1,2
28,2023-08-12T08:31:00+10:00,2023-08-12,08:31,2,0,2
28,2023-08-12T08:32:00+10:00,2023-08-12,08:32,4,2,6
28,2023-08-12T08:35:00+10:00,2023-08-12,08:35,0,3,3
29,2023-08-12T08:26:00+10:00,2023-08-12,08:26,1,7,8
29,2023-08-12T08:28:00+10:00,2023-08-12,08:28,1,2,3
29,2023-08-12T08:31:00+10:00,2023-08-12,08:31,0,2,2
29,2023-08-12T08:33:00+10:00,2023-08-12,08:33,2,1,3
29,2023-08-12T08:39:00+10:00,2023-08-12,08:39,0,2,2
39,2023-08-12T08:37:00+10:00,2023-08-12,08:37,1,2,3
41,2023-08-12T08:27:00+10:00,2023-08-12,08:27,13,3,16
41,2023-08-12T08:28:00+10:00,2023-08-12,08:28,12,2,14
41,2023-08-12T08:36:00+10:00,2023-08-12,08:36,15,6,21
41,2023-08-12T08:37:00+10:00,2023-08-12,08:37,11,2,13
41,2023-08-12T08:39:00+10:00,2023-08-12,08:39,16,3,19
54,2023-08-12T08:25:00+10:00,2023-08-12,08:25,1,0,1
54,2023-08-12T08:38:00+10:00,2023-08-12,08:38,1,0,1
55,2023-08-12T08:27:00+10:00,2023-08-12,08:27,5,3,8
55,2023-08-12T08:29:00+10:00,2023-08-12,08:29,1,1,2
55,2023-08-12T08:34:00+10:00,2023-08-12,08:34,2,5,7
55,2023-08-12T08:39:00+10:00,2023-08-12,08:39,1,3,4
61,2023-08-12T08:33:00+10:00,2023-08-12,08:33,1,1,2
61,2023-08-12T08:35:00+10:00,2023-08-12,08:35,0,3,3
61,2023-08-12T08:36:00+10:00,2023-08-12,08:36,1,3,4
61,2023-08-12T08:37:00+10:00,2023-08-12,08:37,0,3,3
61,2023-08-12T08:38:00+10:00,2023-08-12,08:38,2,4,6
65,2023-08-12T08:25:00+10:00,2023-08-12,08:25,1,3,4
65,2023-08-12T08:27:00+10:00,2023-08-12,08:27,1,1,2
65,2023-08-12T08:29:00+10:00,2023-08-12,08:29,1,1,2
65,2023-08-12T08:35:00+10:00,2023-08-12,08:35,2,0,2
65,2023-08-12T08:37:00+10:00,2023-08-12,08:37,0,1,1
66,2023-08-12T08:27:00+10:00,2023-08-12,08:27,0,4,4
66,2023-08-12T08:34:00+10:00,2023-08-12,08:34,1,0,1
69,2023-08-12T08:25:00+10:00,2023-08-12,08:25,2,0,2
69,2023-08-12T08:26:00+10:00,2023-08-12,08:26,3,2,5
69,2023-08-12T08:27:00+10:00,2023-08-12,08:27,2,1,3
69,2023-08-12T08:38:00+10:00,2023-08-12,08:38,2,0,2
70,2023-08-12T08:27:00+10:00,2023-08-12,08:27,2,0,2
70,2023-08-12T08:31:00+10:00,2023-08-12,08:31,1,1,2
75,2023-08-12T08:39:00+10:00,2023-08-12,08:39,3,0,3
77,2023-08-12T08:25:00+10:00,2023-08-12,08:25,0,1,1
77,2023-08-12T08:26:00+10:00,2023-08-12,08:26,0,1,1
77,2023-08-12T08:35:00+10:00,2023-08-12,08:35,3,3,6
77,2023-08-12T08:36:00+10:00,2023-08-12,08:36,1,0,1
77,2023-08-12T08:38:00+10:00,2023-08-12,08:38,1,1,2
77,2023-08-12T08:39:00+10:00,2023-08-12,08:39,0,2,2
78,2023-08-12T08:30:00+10:00,2023-08-12,08:30,0,1,1
84,2023-08-12T08:25:00+10:00,2023-08-12,08:25,19,29,48
87,2023-08-12T08:26:00+10:00,2023-08-12,08:26,2,0,2
87,2023-08-12T08:27:00+10:00,2023-08-12,08:27,2,0,2
87,2023-08-12T08:31:00+10:00,2023-08-12,08:31,1,1,2
87,2023-08-12T08:34:00+10:00,2023-08-12,08:34,1,2,3
87,2023-08-12T08:37:00+10:00,2023-08-12,08:37,3,2,5
87,2023-08-12T08:38:00+10:00,2023-08-12,08:38,0,1,1
108,2023-08-12T08:26:00+10:00,2023-08-12,08:26,0,2,2
108,2023-08-12T08:28:00+10:00,2023-08-12,08:28,4,1,5
108,2023-08-12T08:32:00+10:00,2023-08-12,08:32,0,2,2
108,2023-08-12T08:35:00+10:00,2023-08-12,08:35,0,1,1
108,2023-08-12T08:36:00+10:00,2023-08-12,08:36,2,0,2
1,2023-08-12T08:29:00+10:00,2023-08-12,08:29,1,0,1
1,2023-08-12T08:31:00+10:00,2023-08-12,08:31,4,0,4
1,2023-08-12T08:32:00+10:00,2023-08-12,08:32,1,4,5
1,2023-08-12T08:33:00+10:00,2023-08-12,08:33,5,3,8
1,2023-08-12T08:34:00+10:00,2023-08-12,08:34,0,1,1
1,2023-08-12T08:36:00+10:00,2023-08-12,08:36,4,3,7
1,2023-08-12T08:38:00+10:00,2023-08-12,08:38,4,5,9
1,2023-08-12T08:39:00+10:00,2023-08-12,08:39,2,4,6
2,2023-08-12T08:31:00+10:00,2023-08-12,08:31,0,1,1
2,2023-08-12T08:33:00+10:00,2023-08-12,08:33,0,1,1
2,2023-08-12T08:39:00+10:00,2023-08-12,08:39,0,2,2
7,2023-08-12T08:25:00+10:00,2023-08-12,08:25,0,2,2
7,2023-08-12T08:27:00+10:00,2023-08-12,08:27,1,0,1
7,2023-08-12T08:33:00+10:00,2023-08-12,08:33,2,0,2
9,2023-08-12T08:25:00+10:00,2023-08-12,08:25,0,1,1
9,2023-08-12T08:34:00+10:00,2023-08-12,08:34,0,4,4
9,2023-08-12T08:39:00+10:00,2023-08-12,08:39,3,3,6
10,2023-08-12T08:29:00+10:00,2023-08-12,08:29,2,1,3
10,2023-08-12T08:35:00+10:00,2023-08-12,08:35,1,2,3
11,2023-08-12T08:30:00+10:00,2023-08-12,08:30,0,1,1
11,2023-08-12T08:36:00+10:00,2023-08-12,08:36,0,4,4
12,2023-08-12T08:27:00+10:00,2023-08-12,08:27,1,0,1
17,2023-08-12T08:35:00+10:00,2023-08-12,08:35,1,0,1
17,2023-08-12T08:37:00+10:00,2023-08-12,08:37,5,0,5
18,2023-08-12T08:32:00+10:00,2023-08-12,08:32,0,1,1
24,2023-08-12T08:35:00+10:00,2023-08-12,08:35,6,0,6
24,2023-08-12T08:37:00+10:00,2023-08-12,08:37,4,9,13
24,2023-08-12T08:39:00+10:00,2023-08-12,08:39,2,10,12
27,2023-08-12T08:27:00+10:00,2023-08-12,08:27,1,2,3
27,2023-08-12T08:34:00+10:00,2023-08-12,08:34,1,6,7
27,2023-08-12T08:35:00+10:00,2023-08-12,08:35,0,1,1
27,2023-08-12T08:39:00+10:00,2023-08-12,08:39,0,6,6
35,2023-08-12T08:28:00+10:00,2023-08-12,08:28,5,7,12
35,2023-08-12T08:31:00+10:00,2023-08-12,08:31,1,1,2
35,2023-08-12T08:33:00+10:00,2023-08-12,08:33,2,4,6
35,2023-08-12T08:36:00+10:00,2023-08-12,08:36,11,2,13
35,2023-08-12T08:38:00+10:00,2023-08-12,08:38,5,5,10
53,2023-08-12T08:27:00+10:00,2023-08-12,08:27,5,1,6
53,2023-08-12T08:31:00+10:00,2023-08-12,08:31,0,2,2
53,2023-08-12T08:34:00+10:00,2023-08-12,08:34,1,4,5
53,2023-08-12T08:35:00+10:00,2023-08-12,08:35,7,0,7
53,2023-08-12T08:38:00+10:00,2023-08-12,08:38,6,3,9
56,2023-08-12T08:25:00+10:00,2023-08-12,08:25,6,1,7
56,2023-08-12T08:28:00+10:00,2023-08-12,08:28,0,3,3
56,2023-08-12T08:32:00+10:00,2023-08-12,08:32,2,1,3
56,2023-08-12T08:37:00+10:00,2023-08-12,08:37,5,1,6
57,2023-08-12T08:25:00+10:00,2023-08-12,08:25,3,2,5
57,2023-08-12T08:31:00+10:00,2023-08-12,08:31,1,0,1
57,2023-08-12T08:32:00+10:00,2023-08-12,08:32,2,2,4
57,2023-08-12T08:34:00+10:00,2023-08-12,08:34,3,3,6
57,2023-08-12T08:39:00+10:00,2023-08-12,08:39,0,1,1
58,2023-08-12T08:27:00+10:00,2023-08-12,08:27,1,0,1
58,2023-08-12T08:33:00+10:00,2023-08-12,08:33,1,3,4
58,2023-08-12T08:36:00+10:00,2023-08-12,08:36,8,2,10
58,2023-08-12T08:38:00+10:00,2023-08-12,08:38,2,0,2
62,2023-08-12T08:25:00+10:00,2023-08-12,08:25,0,2,2
62,2023-08-12T08:26:00+10:00,2023-08-12,08:26,2,0,2
62,2023-08-12T08:36:00+10:00,2023-08-12,08:36,1,2,3
63,2023-08-12T08:30:00+10:00,2023-08-12,08:30,2,0,2
63,2023-08-12T08:33:00+10:00,2023-08-12,08:33,0,1,1
63,2023-08-12T08:35:00+10:00,2023-08-12,08:35,1,0,1
63,2023-08-12T08:39:00+10:00,2023-08-12,08:39,2,2,4
67,2023-08-12T08:26:00+10:00,2023-08-12,08:26,4,4,8
67,2023-08-12T08:28:00+10:00,2023-08-12,08:28,1,5,6
67,2023-08-12T08:31:00+10:00,2023-08-12,08:31,0,2,2
67,2023-08-12T08:32:00+10:00,2023-08-12,08:32,1,1,2
67,2023-08-12T08:35:00+10:00,2023-08-12,08:35,2,3,5
67,2023-08-12T08:38:00+10:00,2023-08-12,08:38,4,4,8
67,2023-08-12T08:39:00+10:00,2023-08-12,08:39,2,1,3
68,2023-08-12T08:25:00+10:00,2023-08-12,08:25,1,0,1
68,2023-08-12T08:26:00+10:00,2023-08-12,08:26,0,1,1
68,2023-08-12T08:38:00+10:00,2023-08-12,08:38,5,3,8
72,2023-08-12T08:25:00+10:00,2023-08-12,08:25,5,0,5
72,2023-08-12T08:27:00+10:00,2023-08-12,08:27,0,1,1
72,2023-08-12T08:30:00+10:00,2023-08-12,08:30,3,0,3
72,2023-08-12T08:34:00+10:00,2023-08-12,08:34,3,0,3
76,2023-08-12T08:25:00+10:00,2023-08-12,08:25,1,0,1
76,2023-08-12T08:38:00+10:00,2023-08-12,08:38,0,1,1
76,2023-08-12T08:39:00+10:00,2023-08-12,08:39,1,1,2
79,2023-08-12T08:27:00+10:00,2023-08-12,08:27,3,2,5
79,2023-08-12T08:32:00+10:00,2023-08-12,08:32,4,1,5
79,2023-08-12T08:37:00+10:00,2023-08-12,08:37,3,3,6
85,2023-08-12T08:26:00+10:00,2023-08-12,08:26,0,1,1
85,2023-08-12T08:30:00+10:00,2023-08-12,08:30,0,2,2
109,2023-08-12T08:35:00+10:00,2023-08-12,08:35,5,11,16
117,2023-08-12T08:25:00+10:00,2023-08-12,08:25,0,4,4
117,2023-08-12T08:30:00+10:00,2023-08-12,08:30,4,2,6
122,2023-08-12T08:33:00+10:00,2023-08-12,08:33,1,0,1
122,2023-08-12T08:36:00+10:00,2023-08-12,08:36,1,0,1
3,2023-08-12T08:40:00+10:00,2023-08-12,08:40,3,6,9
3,2023-08-12T08:44:00+10:00,2023-08-12,08:44,1,5,6
3,2023-08-12T08:45:00+10:00,2023-08-12,08:45,1,1,2
3,2023-08-12T08:47:00+10:00,2023-08-12,08:47,3,3,6
3,2023-08-12T08:48:00+10:00,2023-08-12,08:48,0,2,2
3,2023-08-12T08:49:00+10:00,2023-08-12,08:49,2,7,9
3,2023-08-12T08:51:00+10:00,2023-08-12,08:51,2,8,10
3,2023-08-12T08:54:00+10:00,2023-08-12,08:54,3,7,10
4,2023-08-12T08:43:00+10:00,2023-08-12,08:43,4,4,8
4,2023-08-12T08:44:00+10:00,2023-08-12,08:44,2,2,4
4,2023-08-12T08:46:00+10:00,2023-08-12,08:46,8,3,11
4,2023-08-12T08:51:00+10:00,2023-08-12,08:51,2,2,4
4,2023-08-12T08:53:00+10:00,2023-08-12,08:53,8,6,14
6,2023-08-12T08:40:00+10:00,2023-08-12,08:40,5,2,7
6,2023-08-12T08:41:00+10:00,2023-08-12,08:41,4,5,9
6,2023-08-12T08:42:00+10:00,2023-08-12,08:42,1,3,4
6,2023-08-12T08:43:00+10:00,2023-08-12,08:43,6,3,9
6,2023-08-12T08:46:00+10:00,2023-08-12,08:46,8,2,10
6,2023-08-12T08:48:00+10:00,2023-08-12,08:48,2,4,6
6,2023-08-12T08:49:00+10:00,2023-08-12,08:49,14,5,19
6,2023-08-12T08:50:00+10:00,2023-08-12,08:50,3,1,4
6,2023-08-12T08:53:00+10:00,2023-08-12,08:53,5,4,9
8,2023-08-12T08:40:00+10:00,2023-08-12,08:40,0,1,1
8,2023-08-12T08:44:00+10:00,2023-08-12,08:44,1,1,2
8,2023-08-12T08:46:00+10:00,2023-08-12,08:46,0,3,3
8,2023-08-12T08:53:00+10:00,2023-08-12,08:53,1,4,5
14,2023-08-12T08:41:00+10:00,2023-08-12,08:41,4,0,4
14,2023-08-12T08:43:00+10:00,2023-08-12,08:43,4,0,4
14,2023-08-12T08:48:00+10:00,2023-08-12,08:48,1,1,2
14,2023-08-12T08:52:00+10:00,2023-08-12,08:52,1,0,1
21,2023-08-12T08:45:00+10:00,2023-08-12,08:45,0,5,5
21,2023-08-12T08:53:00+10:00,2023-08-12,08:53,0,2,2
21,2023-08-12T08:54:00+10:00,2023-08-12,08:54,0,1,1
28,2023-08-12T08:43:00+10:00,2023-08-12,08:43,3,4,7
28,2023-08-12T08:47:00+10:00,2023-08-12,08:47,1,4,5
28,2023-08-12T08:53:00+10:00,2023-08-12,08:53,1,0,1
29,2023-08-12T08:43:00+10:00,2023-08-12,08:43,1,6,7
29,2023-08-12T08:46:00+10:00,2023-08-12,08:46,1,0,1
39,2023-08-12T08:49:00+10:00,2023-08-12,08:49,0,1,1
41,2023-08-12T08:40:00+10:00,2023-08-12,08:40,13,5,18
41,2023-08-12T08:44:00+10:00,2023-08-12,08:44,10,7,17
41,2023-08-12T08:46:00+10:00,2023-08-12,08:46,7,6,13
41,2023-08-12T08:49:00+10:00,2023-08-12,08:49,34,2,36
41,2023-08-12T08:51:00+10:00,2023-08-12,08:51,14,4,18
41,2023-08-12T08:53:00+10:00,2023-08-12,08:53,5,5,10
54,2023-08-12T08:43:00+10:00,2023-08-12,08:43,1,0,1
54,2023-08-12T08:47:00+10:00,2023-08-12,08:47,1,0,1
54,2023-08-12T08:54:00+10:00,2023-08-12,08:54,2,0,2
55,2023-08-12T08:40:00+10:00,2023-08-12,08:40,5,10,15
55,2023-08-12T08:41:00+10:00,2023-08-12,08:41,5,6,11
55,2023-08-12T08:42:00+10:00,2023-08-12,08:42,3,4,7
55,2023-08-12T08:49:00+10:00,2023-08-12,08:49,4,10,14
55,2023-08-12T08:50:00+10:00,2023-08-12,08:50,2,5,7
55,2023-08-12T08:52:00+10:00,2023-08-12,08:52,2,8,10
59,2023-08-12T08:50:00+10:00,2023-08-12,08:50,7,10,17
61,2023-08-12T08:42:00+10:00,2023-08-12,08:42,3,2,5
61,2023-08-12T08:47:00+10:00,2023-08-12,08:47,4,2,6
61,2023-08-12T08:49:00+10:00,2023-08-12,08:49,4,5,9
61,2023-08-12T08:50:00+10:00,2023-08-12,08:50,0,1,1
61,2023-08-12T08:52:00+10:00,2023-08-12,08:52,1,1,2
61,2023-08-12T08:53:00+10:00,2023-08-12,08:53,1,2,3
65,2023-08-12T08:45:00+10:00,2023-08-12,08:45,1,0,1
65,2023-08-12T08:47:00+10:00,2023-08-12,08:47,7,1,8
65,2023-08-12T08:50:00+10:00,2023-08-12,08:50,1,0,1
65,2023-08-12T08:52:00+10:00,2023-08-12,08:52,4,3,7
66,2023-08-12T08:40:00+10:00,2023-08-12,08:40,1,0,1
66,2023-08-12T08:42:00+10:00,2023-08-12,08:42,4,4,8
66,2023-08-12T08:44:00+10:00,2023-08-12,08:44,3,3,6
66,2023-08-12T08:45:00+10:00,2023-08-12,08:45,2,2,4
66,2023-08-12T08:50:00+10:00,2023-08-12,08:50,3,0,3
69,2023-08-12T08:46:00+10:00,2023-08-12,08:46,2,0,2
69,2023-08-12T08:54:00+10:00,2023-08-12,08:54,2,0,2
70,2023-08-12T08:45:00+10:00,2023-08-12,08:45,1,2,3
70,2023-08-12T08:49:00+10:00,2023-08-12,08:49,2,0,2
70,2023-08-12T08:50:00+10:00,2023-08-12,08:50,0,1,1
70,2023-08-12T08:51:00+10:00,2023-08-12,08:51,0,4,4
71,2023-08-12T08:47:00+10:00,2023-08-12,08:47,1,0,1
71,2023-08-12T08:51:00+10:00,2023-08-12,08:51,1,0,1
75,2023-08-12T08:43:00+10:00,2023-08-12,08:43,0,2,2
75,2023-08-12T08:52:00+10:00,2023-08-12,08:52,1,0,1
77,2023-08-12T08:41:00+10:00,2023-08-12,08:41,1,7,8
77,2023-08-12T08:43:00+10:00,2023-08-12,08:43,0,5,5
77,2023-08-12T08:47:00+10:00,2023-08-12,08:47,0,4,4
77,2023-08-12T08:48:00+10:00,2023-08-12,08:48,1,2,3
77,2023-08-12T08:49:00+10:00,2023-08-12,08:49,1,0,1
77,2023-08-12T08:53:00+10:00,2023-08-12,08:53,2,0,2
77,2023-08-12T08:54:00+10:00,2023-08-12,08:54,0,1,1
78,2023-08-12T08:42:00+10:00,2023-08-12,08:42,1,1,2
78,2023-08-12T08:44:00+10:00,2023-08-12,08:44,2,1,3
84,2023-08-12T08:40:00+10:00,2023-08-12,08:40,31,34,65
87,2023-08-12T08:40:00+10:00,2023-08-12,08:40,1,1,2
87,2023-08-12T08:42:00+10:00,2023-08-12,08:42,1,4,5
87,2023-08-12T08:43:00+10:00,2023-08-12,08:43,0,1,1
87,2023-08-12T08:47:00+10:00,2023-08-12,08:47,2,4,6
87,2023-08-12T08:49:00+10:00,2023-08-12,08:49,1,0,1
87,2023-08-12T08:51:00+10:00,2023-08-12,08:51,3,1,4
87,2023-08-12T08:53:00+10:00,2023-08-12,08:53,1,1,2
107,2023-08-12T08:50:00+10:00,2023-08-12,08:50,2,12,14
108,2023-08-12T08:40:00+10:00,2023-08-12,08:40,0,2,2
108,2023-08-12T08:43:00+10:00,2023-08-12,08:43,3,3,6
108,2023-08-12T08:45:00+10:00,2023-08-12,08:45,0,2,2
108,2023-08-12T08:47:00+10:00,2023-08-12,08:47,1,0,1
108,2023-08-12T08:49:00+10:00,2023-08-12,08:49,2,1,3
108,2023-08-12T08:52:00+10:00,2023-08-12,08:52,4,0,4
108,2023-08-12T08:53:00+10:00,2023-08-12,08:53,5,2,7
1,2023-08-12T08:41:00+10:00,2023-08-12,08:41,1,5,6
1,2023-08-12T08:44:00+10:00,2023-08-12,08:44,0,5,5
1,2023-08-12T08:45:00+10:00,2023-08-12,08:45,1,4,5
1,2023-08-12T08:47:00+10:00,2023-08-12,08:47,0,4,4
1,2023-08-12T08:52:00+10:00,2023-08-12,08:52,3,1,4
1,2023-08-12T08:53:00+10:00,2023-08-12,08:53,0,3,3
1,2023-08-12T08:54:00+10:00,2023-08-12,08:54,1,12,13
2,2023-08-12T08:49:00+10:00,2023-08-12,08:49,1,4,5
2,2023-08-12T08:51:00+10:00,2023-08-12,08:51,0,3,3
7,2023-08-12T08:40:00+10:00,2023-08-12,08:40,1,1,2
7,2023-08-12T08:42:00+10:00,2023-08-12,08:42,1,0,1
7,2023-08-12T08:48:00+10:00,2023-08-12,08:48,0,1,1
7,2023-08-12T08:51:00+10:00,2023-08-12,08:51,2,0,2
7,2023-08-12T08:52:00+10:00,2023-08-12,08:52,1,1,2
9,2023-08-12T08:42:00+10:00,2023-08-12,08:42,0,1,1
9,2023-08-12T08:44:00+10:00,2023-08-12,08:44,0,2,2
9,2023-08-12T08:53:00+10:00,2023-08-12,08:53,0,3,3
10,2023-08-12T08:40:00+10:00,2023-08-12,08:40,2,0,2
10,2023-08-12T08:42:00+10:00,2023-08-12,08:42,1,0,1
10,2023-08-12T08:45:00+10:00,2023-08-12,08:45,1,0,1
10,2023-08-12T08:49:00+10:00,2023-08-12,08:49,2,0,2
10,2023-08-12T08:52:00+10:00,2023-08-12,08:52,1,1,2
11,2023-08-12T08:50:00+10:00,2023-08-12,08:50,0,1,1
11,2023-08-12T08:52:00+10:00,2023-08-12,08:52,1,0,1
12,2023-08-12T08:45:00+10:00,2023-08-12,08:45,1,1,2
12,2023-08-12T08:54:00+10:00,2023-08-12,08:54,0,1,1
17,2023-08-12T08:40:00+10:00,2023-08-12,08:40,3,1,4
17,2023-08-12T08:42:00+10:00,2023-08-12,08:42,4,0,4
17,2023-08-12T08:45:00+10:00,2023-08-12,08:45,2,2,4
17,2023-08-12T08:46:00+10:00,2023-08-12,08:46,1,3,4
17,2023-08-12T08:49:00+10:00,2023-08-12,08:49,1,0,1
17,2023-08-12T08:50:00+10:00,2023-08-12,08:50,1,2,3
17,2023-08-12T08:51:00+10:00,2023-08-12,08:51,1,1,2
17,2023-08-12T08:52:00+10:00,2023-08-12,08:52,4,0,4
18,2023-08-12T08:44:00+10:00,2023-08-12,08:44,6,1,7
24,2023-08-12T08:40:00+10:00,2023-08-12,08:40,1,4,5
24,2023-08-12T08:41:00+10:00,2023-08-12,08:41,23,0,23
24,2023-08-12T08:43:00+10:00,2023-08-12,08:43,4,4,8
24,2023-08-12T08:44:00+10:00,2023-08-12,08:44,10,0,10
24,2023-08-12T08:45:00+10:00,2023-08-12,08:45,12,2,14
24,2023-08-12T08:48:00+10:00,2023-08-12,08:48,3,12,15
24,2023-08-12T08:51:00+10:00,2023-08-12,08:51,2,3,5
27,2023-08-12T08:40:00+10:00,2023-08-12,08:40,1,0,1
27,2023-08-12T08:49:00+10:00,2023-08-12,08:49,1,0,1
27,2023-08-12T08:53:00+10:00,2023-08-12,08:53,1,0,1
35,2023-08-12T08:44:00+10:00,2023-08-12,08:44,6,4,10
35,2023-08-12T08:46:00+10:00,2023-08-12,08:46,2,4,6
35,2023-08-12T08:49:00+10:00,2023-08-12,08:49,4,4,8
35,2023-08-12T08:54:00+10:00,2023-08-12,08:54,5,3,8
53,2023-08-12T08:41:00+10:00,2023-08-12,08:41,3,2,5
53,2023-08-12T08:43:00+10:00,2023-08-12,08:43,5,3,8
53,2023-08-12T08:44:00+10:00,2023-08-12,08:44,2,2,4
53,2023-08-12T08:46:00+10:00,2023-08-12,08:46,3,0,3
53,2023-08-12T08:48:00+10:00,2023-08-12,08:48,1,4,5
53,2023-08-12T08:49:00+10:00,2023-08-12,08:49,3,3,6
53,2023-08-12T08:51:00+10:00,2023-08-12,08:51,1,10,11
53,2023-08-12T08:54:00+10:00,2023-08-12,08:54,2,1,3
56,2023-08-12T08:47:00+10:00,2023-08-12,08:47,3,1,4
56,2023-08-12T08:50:00+10:00,2023-08-12,08:50,2,4,6
56,2023-08-12T08:51:00+10:00,2023-08-12,08:51,3,0,3
57,2023-08-12T08:41:00+10:00,2023-08-12,08:41,2,4,6
57,2023-08-12T08:43:00+10:00,2023-08-12,08:43,0,4,4
57,2023-08-12T08:44:00+10:00,2023-08-12,08:44,3,1,4
57,2023-08-12T08:46:00+10:00,2023-08-12,08:46,3,1,4
57,2023-08-12T08:49:00+10:00,2023-08-12,08:49,2,1,3
57,2023-08-12T08:53:00+10:00,2023-08-12,08:53,1,0,1
58,2023-08-12T08:40:00+10:00,2023-08-12,08:40,9,5,14
58,2023-08-12T08:41:00+10:00,2023-08-12,08:41,19,1,20
58,2023-08-12T08:46:00+10:00,2023-08-12,08:46,3,0,3
58,2023-08-12T08:48:00+10:00,2023-08-12,08:48,8,2,10
58,2023-08-12T08:50:00+10:00,2023-08-12,08:50,8,3,11
62,2023-08-12T08:40:00+10:00,2023-08-12,08:40,1,0,1
62,2023-08-12T08:44:00+10:00,2023-08-12,08:44,3,0,3
62,2023-08-12T08:47:00+10:00,2023-08-12,08:47,0,2,2
62,2023-08-12T08:48:00+10:00,2023-08-12,08:48,2,1,3
62,2023-08-12T08:49:00+10:00,2023-08-12,08:49,0,1,1
62,2023-08-12T08:51:00+10:00,2023-08-12,08:51,2,2,4
63,2023-08-12T08:51:00+10:00,2023-08-12,08:51,1,0,1
67,2023-08-12T08:41:00+10:00,2023-08-12,08:41,4,1,5
67,2023-08-12T08:42:00+10:00,2023-08-12,08:42,7,6,13
67,2023-08-12T08:45:00+10:00,2023-08-12,08:45,8,0,8
67,2023-08-12T08:46:00+10:00,2023-08-12,08:46,2,5,7
67,2023-08-12T08:50:00+10:00,2023-08-12,08:50,4,7,11
67,2023-08-12T08:53:00+10:00,2023-08-12,08:53,8,2,10
67,2023-08-12T08:54:00+10:00,2023-08-12,08:54,4,4,8
68,2023-08-12T08:41:00+10:00,2023-08-12,08:41,3,0,3
68,2023-08-12T08:44:00+10:00,2023-08-12,08:44,2,3,5
68,2023-08-12T08:46:00+10:00,2023-08-12,08:46,2,1,3
68,2023-08-12T08:48:00+10:00,2023-08-12,08:48,1,0,1
68,2023-08-12T08:50:00+10:00,2023-08-12,08:50,7,4,11
68,2023-08-12T08:54:00+10:00,2023-08-12,08:54,1,1,2
72,2023-08-12T08:40:00+10:00,2023-08-12,08:40,4,0,4
72,2023-08-12T08:43:00+10:00,2023-08-12,08:43,1,5,6
72,2023-08-12T08:44:00+10:00,2023-08-12,08:44,2,0,2
72,2023-08-12T08:46:00+10:00,2023-08-12,08:46,1,1,2
72,2023-08-12T08:48:00+10:00,2023-08-12,08:48,8,1,9
72,2023-08-12T08:49:00+10:00,2023-08-12,08:49,12,0,12
72,2023-08-12T08:51:00+10:00,2023-08-12,08:51,1,0,1
76,2023-08-12T08:40:00+10:00,2023-08-12,08:40,1,1,2
76,2023-08-12T08:41:00+10:00,2023-08-12,08:41,1,0,1
76,2023-08-12T08:48:00+10:00,2023-08-12,08:48,2,0,2
79,2023-08-12T08:46:00+10:00,2023-08-12,08:46,0,1,1
79,2023-08-12T08:50:00+10:00,2023-08-12,08:50,2,6,8
79,2023-08-12T08:51:00+10:00,2023-08-12,08:51,2,6,8
79,2023-08-12T08:54:00+10:00,2023-08-12,08:54,2,8,10
85,2023-08-12T08:51:00+10:00,2023-08-12,08:51,0,1,1
85,2023-08-12T08:52:00+10:00,2023-08-12,08:52,0,1,1
85,2023-08-12T08:53:00+10:00,2023-08-12,08:53,1,0,1
86,2023-08-12T08:45:00+10:00,2023-08-12,08:45,2,0,2
86,2023-08-12T08:49:00+10:00,2023-08-12,08:49,1,0,1
109,2023-08-12T08:45:00+10:00,2023-08-12,08:45,0,6,6
117,2023-08-12T08:45:00+10:00,2023-08-12,08:45,2,10,12
122,2023-08-12T08:43:00+10:00,2023-08-12,08:43,0,1,1
122,2023-08-12T08:46:00+10:00,2023-08-12,08:46,0,1,1
122,2023-08-12T08:53:00+10:00,2023-08-12,08:53,4,1,5
3,2023-08-12T08:55:00+10:00,2023-08-12,08:55,3,4,7
3,2023-08-12T08:57:00+10:00,2023-08-12,08:57,4,3,7
3,2023-08-12T09:00:00+10:00,2023-08-12,09:00,2,2,4
3,2023-08-12T09:05:00+10:00,2023-08-12,09:05,2,0,2
3,2023-08-12T09:06:00+10:00,2023-08-12,09:06,1,3,4
3,2023-08-12T09:07:00+10:00,2023-08-12,09:07,2,1,3
3,2023-08-12T09:09:00+10:00,2023-08-12,09:09,0,13,13
4,2023-08-12T08:55:00+10:00,2023-08-12,08:55,6,2,8
4,2023-08-12T08:58:00+10:00,2023-08-12,08:58,9,4,13
4,2023-08-12T09:00:00+10:00,2023-08-12,09:00,5,3,8
4,2023-08-12T09:05:00+10:00,2023-08-12,09:05,5,2,7
4,2023-08-12T09:08:00+10:00,2023-08-12,09:08,2,4,6
6,2023-08-12T09:00:00+10:00,2023-08-12,09:00,2,5,7
6,2023-08-12T09:02:00+10:00,2023-08-12,09:02,4,5,9
6,2023-08-12T09:03:00+10:00,2023-08-12,09:03,1,0,1
8,2023-08-12T08:56:00+10:00,2023-08-12,08:56,0,2,2
8,2023-08-12T09:02:00+10:00,2023-08-12,09:02,2,1,3
14,2023-08-12T08:55:00+10:00,2023-08-12,08:55,2,0,2
14,2023-08-12T09:01:00+10:00,2023-08-12,09:01,3,4,7
14,2023-08-12T09:05:00+10:00,2023-08-12,09:05,1,1,2
14,2023-08-12T09:09:00+10:00,2023-08-12,09:09,2,0,2
21,2023-08-12T08:55:00+10:00,2023-08-12,08:55,1,1,2
21,2023-08-12T08:56:00+10:00,2023-08-12,08:56,2,6,8
21,2023-08-12T09:01:00+10:00,2023-08-12,09:01,4,2,6
21,2023-08-12T09:07:00+10:00,2023-08-12,09:07,4,3,7
28,2023-08-12T09:07:00+10:00,2023-08-12,09:07,1,2,3
29,2023-08-12T08:57:00+10:00,2023-08-12,08:57,0,2,2
29,2023-08-12T08:58:00+10:00,2023-08-12,08:58,1,3,4
29,2023-08-12T09:01:00+10:00,2023-08-12,09:01,4,2,6
29,2023-08-12T09:05:00+10:00,2023-08-12,09:05,3,0,3
29,2023-08-12T09:06:00+10:00,2023-08-12,09:06,3,1,4
39,2023-08-12T09:02:00+10:00,2023-08-12,09:02,2,3,5
39,2023-08-12T09:04:00+10:00,2023-08-12,09:04,0,1,1
39,2023-08-12T09:07:00+10:00,2023-08-12,09:07,1,1,2
39,2023-08-12T09:08:00+10:00,2023-08-12,09:08,1,0,1
39,2023-08-12T09:09:00+10:00,2023-08-12,09:09,1,2,3
41,2023-08-12T08:55:00+10:00,2023-08-12,08:55,26,4,30
41,2023-08-12T08:56:00+10:00,2023-08-12,08:56,11,7,18
41,2023-08-12T08:57:00+10:00,2023-08-12,08:57,5,8,13
41,2023-08-12T08:58:00+10:00,2023-08-12,08:58,15,5,20
41,2023-08-12T09:04:00+10:00,2023-08-12,09:04,11,8,19
41,2023-08-12T09:07:00+10:00,2023-08-12,09:07,22,6,28
41,2023-08-12T09:08:00+10:00,2023-08-12,09:08,15,12,27
54,2023-08-12T08:59:00+10:00,2023-08-12,08:59,0,3,3
54,2023-08-12T09:00:00+10:00,2023-08-12,09:00,0,1,1
54,2023-08-12T09:01:00+10:00,2023-08-12,09:01,1,0,1
54,2023-08-12T09:09:00+10:00,2023-08-12,09:09,1,0,1
55,2023-08-12T08:59:00+10:00,2023-08-12,08:59,4,6,10
55,2023-08-12T09:01:00+10:00,2023-08-12,09:01,0,3,3
55,2023-08-12T09:06:00+10:00,2023-08-12,09:06,4,5,9
55,2023-08-12T09:08:00+10:00,2023-08-12,09:08,8,11,19
55,2023-08-12T09:09:00+10:00,2023-08-12,09:09,4,7,11
59,2023-08-12T09:05:00+10:00,2023-08-12,09:05,16,34,50
61,2023-08-12T09:00:00+10:00,2023-08-12,09:00,1,2,3
61,2023-08-12T09:01:00+10:00,2023-08-12,09:01,0,1,1
61,2023-08-12T09:02:00+10:00,2023-08-12,09:02,2,3,5
65,2023-08-12T09:01:00+10:00,2023-08-12,09:01,0,2,2
65,2023-08-12T09:02:00+10:00,2023-08-12,09:02,1,0,1
65,2023-08-12T09:05:00+10:00,2023-08-12,09:05,5,0,5
66,2023-08-12T08:56:00+10:00,2023-08-12,08:56,0,3,3
66,2023-08-12T09:03:00+10:00,2023-08-12,09:03,3,1,4
66,2023-08-12T09:04:00+10:00,2023-08-12,09:04,1,6,7
66,2023-08-12T09:05:00+10:00,2023-08-12,09:05,1,1,2
69,2023-08-12T09:07:00+10:00,2023-08-12,09:07,4,1,5
70,2023-08-12T08:58:00+10:00,2023-08-12,08:58,2,3,5
70,2023-08-12T09:02:00+10:00,2023-08-12,09:02,2,1,3
70,2023-08-12T09:03:00+10:00,2023-08-12,09:03,1,1,2
70,2023-08-12T09:05:00+10:00,2023-08-12,09:05,1,0,1
70,2023-08-12T09:09:00+10:00,2023-08-12,09:09,2,2,4
71,2023-08-12T08:57:00+10:00,2023-08-12,08:57,0,1,1
75,2023-08-12T09:00:00+10:00,2023-08-12,09:00,2,0,2
75,2023-08-12T09:03:00+10:00,2023-08-12,09:03,1,0,1
75,2023-08-12T09:09:00+10:00,2023-08-12,09:09,1,0,1
77,2023-08-12T08:58:00+10:00,2023-08-12,08:58,1,1,2
77,2023-08-12T08:59:00+10:00,2023-08-12,08:59,1,0,1
77,2023-08-12T09:06:00+10:00,2023-08-12,09:06,1,1,2
77,2023-08-12T09:08:00+10:00,2023-08-12,09:08,1,0,1
78,2023-08-12T09:03:00+10:00,2023-08-12,09:03,3,2,5
84,2023-08-12T09:00:00+10:00,2023-08-12,09:00,53,19,72
87,2023-08-12T08:56:00+10:00,2023-08-12,08:56,1,0,1
87,2023-08-12T08:57:00+10:00,2023-08-12,08:57,1,0,1
87,2023-08-12T08:58:00+10:00,2023-08-12,08:58,0,1,1
87,2023-08-12T09:03:00+10:00,2023-08-12,09:03,3,3,6
87,2023-08-12T09:04:00+10:00,2023-08-12,09:04,1,2,3
87,2023-08-12T09:06:00+10:00,2023-08-12,09:06,3,4,7
87,2023-08-12T09:09:00+10:00,2023-08-12,09:09,4,3,7
107,2023-08-12T09:05:00+10:00,2023-08-12,09:05,3,10,13
108,2023-08-12T08:56:00+10:00,2023-08-12,08:56,1,3,4
108,2023-08-12T08:57:00+10:00,2023-08-12,08:57,0,2,2
108,2023-08-12T08:58:00+10:00,2023-08-12,08:58,0,1,1
108,2023-08-12T09:00:00+10:00,2023-08-12,09:00,0,5,5
108,2023-08-12T09:02:00+10:00,2023-08-12,09:02,1,2,3
108,2023-08-12T09:08:00+10:00,2023-08-12,09:08,0,1,1
1,2023-08-12T08:59:00+10:00,2023-08-12,08:59,2,0,2
1,2023-08-12T09:06:00+10:00,2023-08-12,09:06,0,3,3
1,2023-08-12T09:07:00+10:00,2023-08-12,09:07,5,8,13
1,2023-08-12T09:09:00+10:00,2023-08-12,09:09,1,5,6
2,2023-08-12T08:55:00+10:00,2023-08-12,08:55,3,4,7
2,2023-08-12T08:57:00+10:00,2023-08-12,08:57,2,3,5
2,2023-08-12T09:02:00+10:00,2023-08-12,09:02,3,1,4
2,2023-08-12T09:03:00+10:00,2023-08-12,09:03,1,1,2
2,2023-08-12T09:07:00+10:00,2023-08-12,09:07,3,0,3
9,2023-08-12T09:04:00+10:00,2023-08-12,09:04,0,5,5
9,2023-08-12T09:06:00+10:00,2023-08-12,09:06,0,2,2
9,2023-08-12T09:09:00+10:00,2023-08-12,09:09,1,0,1
10,2023-08-12T09:03:00+10:00,2023-08-12,09:03,1,1,2
10,2023-08-12T09:04:00+10:00,2023-08-12,09:04,3,0,3
11,2023-08-12T09:00:00+10:00,2023-08-12,09:00,1,0,1
12,2023-08-12T08:56:00+10:00,2023-08-12,08:56,1,2,3
12,2023-08-12T09:04:00+10:00,2023-08-12,09:04,8,2,10
17,2023-08-12T08:55:00+10:00,2023-08-12,08:55,5,4,9
17,2023-08-12T08:57:00+10:00,2023-08-12,08:57,3,0,3
17,2023-08-12T08:58:00+10:00,2023-08-12,08:58,3,2,5
17,2023-08-12T08:59:00+10:00,2023-08-12,08:59,2,1,3
17,2023-08-12T09:02:00+10:00,2023-08-12,09:02,1,1,2
17,2023-08-12T09:04:00+10:00,2023-08-12,09:04,3,2,5
17,2023-08-12T09:05:00+10:00,2023-08-12,09:05,0,4,4
18,2023-08-12T08:55:00+10:00,2023-08-12,08:55,1,3,4
18,2023-08-12T08:58:00+10:00,2023-08-12,08:58,1,0,1
24,2023-08-12T08:55:00+10:00,2023-08-12,08:55,2,4,6
24,2023-08-12T08:59:00+10:00,2023-08-12,08:59,4,6,10
24,2023-08-12T09:00:00+10:00,2023-08-12,09:00,8,3,11
24,2023-08-12T09:01:00+10:00,2023-08-12,09:01,1,0,1
24,2023-08-12T09:08:00+10:00,2023-08-12,09:08,4,7,11
24,2023-08-12T09:09:00+10:00,2023-08-12,09:09,5,1,6
27,2023-08-12T08:55:00+10:00,2023-08-12,08:55,0,3,3
27,2023-08-12T08:57:00+10:00,2023-08-12,08:57,4,1,5
27,2023-08-12T09:07:00+10:00,2023-08-12,09:07,2,0,2
27,2023-08-12T09:09:00+10:00,2023-08-12,09:09,4,0,4
35,2023-08-12T08:58:00+10:00,2023-08-12,08:58,11,3,14
35,2023-08-12T08:59:00+10:00,2023-08-12,08:59,4,4,8
35,2023-08-12T09:00:00+10:00,2023-08-12,09:00,6,5,11
35,2023-08-12T09:01:00+10:00,2023-08-12,09:01,6,11,17
35,2023-08-12T09:03:00+10:00,2023-08-12,09:03,5,3,8
35,2023-08-12T09:04:00+10:00,2023-08-12,09:04,4,5,9
35,2023-08-12T09:06:00+10:00,2023-08-12,09:06,9,5,14
35,2023-08-12T09:09:00+10:00,2023-08-12,09:09,9,6,15
53,2023-08-12T08:55:00+10:00,2023-08-12,08:55,5,0,5
53,2023-08-12T09:03:00+10:00,2023-08-12,09:03,2,3,5
56,2023-08-12T08:56:00+10:00,2023-08-12,08:56,0,4,4
56,2023-08-12T09:02:00+10:00,2023-08-12,09:02,2,1,3
56,2023-08-12T09:05:00+10:00,2023-08-12,09:05,2,2,4
56,2023-08-12T09:08:00+10:00,2023-08-12,09:08,2,0,2
56,2023-08-12T09:09:00+10:00,2023-08-12,09:09,1,1,2
57,2023-08-12T08:56:00+10:00,2023-08-12,08:56,0,1,1
57,2023-08-12T08:59:00+10:00,2023-08-12,08:59,0,1,1
57,2023-08-12T09:05:00+10:00,2023-08-12,09:05,1,2,3
58,2023-08-12T08:55:00+10:00,2023-08-12,08:55,4,0,4
58,2023-08-12T08:56:00+10:00,2023-08-12,08:56,3,4,7
58,2023-08-12T09:01:00+10:00,2023-08-12,09:01,11,3,14
58,2023-08-12T09:02:00+10:00,2023-08-12,09:02,9,1,10
58,2023-08-12T09:07:00+10:00,2023-08-12,09:07,3,0,3
58,2023-08-12T09:09:00+10:00,2023-08-12,09:09,2,0,2
62,2023-08-12T09:02:00+10:00,2023-08-12,09:02,1,1,2
62,2023-08-12T09:04:00+10:00,2023-08-12,09:04,1,1,2
62,2023-08-12T09:06:00+10:00,2023-08-12,09:06,0,2,2
62,2023-08-12T09:08:00+10:00,2023-08-12,09:08,0,3,3
63,2023-08-12T08:57:00+10:00,2023-08-12,08:57,2,1,3
63,2023-08-12T09:05:00+10:00,2023-08-12,09:05,0,1,1
63,2023-08-12T09:07:00+10:00,2023-08-12,09:07,1,1,2
63,2023-08-12T09:08:00+10:00,2023-08-12,09:08,0,1,1
67,2023-08-12T08:56:00+10:00,2023-08-12,08:56,5,5,10
67,2023-08-12T09:01:00+10:00,2023-08-12,09:01,5,4,9
67,2023-08-12T09:02:00+10:00,2023-08-12,09:02,3,3,6
67,2023-08-12T09:06:00+10:00,2023-08-12,09:06,1,1,2
67,2023-08-12T09:07:00+10:00,2023-08-12,09:07,4,3,7
68,2023-08-12T08:55:00+10:00,2023-08-12,08:55,0,1,1
68,2023-08-12T08:57:00+10:00,2023-08-12,08:57,2,1,3
68,2023-08-12T09:04:00+10:00,2023-08-12,09:04,2,1,3
68,2023-08-12T09:05:00+10:00,2023-08-12,09:05,9,1,10
68,2023-08-12T09:06:00+10:00,2023-08-12,09:06,1,2,3
72,2023-08-12T09:02:00+10:00,2023-08-12,09:02,2,0,2
76,2023-08-12T08:59:00+10:00,2023-08-12,08:59,1,0,1
76,2023-08-12T09:00:00+10:00,2023-08-12,09:00,0,1,1
76,2023-08-12T09:05:00+10:00,2023-08-12,09:05,3,1,4
76,2023-08-12T09:06:00+10:00,2023-08-12,09:06,3,0,3
76,2023-08-12T09:07:00+10:00,2023-08-12,09:07,0,1,1
79,2023-08-12T09:04:00+10:00,2023-08-12,09:04,6,3,9
79,2023-08-12T09:05:00+10:00,2023-08-12,09:05,5,0,5
79,2023-08-12T09:07:00+10:00,2023-08-12,09:07,4,1,5
85,2023-08-12T08:55:00+10:00,2023-08-12,08:55,0,1,1
85,2023-08-12T08:59:00+10:00,2023-08-12,08:59,1,0,1
85,2023-08-12T09:06:00+10:00,2023-08-12,09:06,1,3,4
85,2023-08-12T09:07:00+10:00,2023-08-12,09:07,3,1,4
86,2023-08-12T09:01:00+10:00,2023-08-12,09:01,2,0,2
86,2023-08-12T09:09:00+10:00,2023-08-12,09:09,1,1,2
122,2023-08-12T08:58:00+10:00,2023-08-12,08:58,1,1,2
122,2023-08-12T08:59:00+10:00,2023-08-12,08:59,0,1,1
122,2023-08-12T09:07:00+10:00,2023-08-12,09:07,1,0,1
3,2023-08-12T09:10:00+10:00,2023-08-12,09:10,2,1,3
3,2023-08-12T09:11:00+10:00,2023-08-12,09:11,1,4,5
3,2023-08-12T09:13:00+10:00,2023-08-12,09:13,4,2,6
3,2023-08-12T09:15:00+10:00,2023-08-12,09:15,6,4,10
3,2023-08-12T09:18:00+10:00,2023-08-12,09:18,3,2,5
3,2023-08-12T09:23:00+10:00,2023-08-12,09:23,4,3,7
4,2023-08-12T09:10:00+10:00,2023-08-12,09:10,15,2,17
4,2023-08-12T09:14:00+10:00,2023-08-12,09:14,8,6,14
4,2023-08-12T09:18:00+10:00,2023-08-12,09:18,9,0,9
4,2023-08-12T09:21:00+10:00,2023-08-12,09:21,5,4,9
4,2023-08-12T09:22:00+10:00,2023-08-12,09:22,9,6,15
6,2023-08-12T09:10:00+10:00,2023-08-12,09:10,1,4,5
6,2023-08-12T09:12:00+10:00,2023-08-12,09:12,2,0,2
6,2023-08-12T09:17:00+10:00,2023-08-12,09:17,11,2,13
6,2023-08-12T09:19:00+10:00,2023-08-12,09:19,4,2,6
6,2023-08-12T09:21:00+10:00,2023-08-12,09:21,8,1,9
6,2023-08-12T09:22:00+10:00,2023-08-12,09:22,10,2,12
6,2023-08-12T09:24:00+10:00,2023-08-12,09:24,4,4,8
8,2023-08-12T09:10:00+10:00,2023-08-12,09:10,0,1,1
8,2023-08-12T09:14:00+10:00,2023-08-12,09:14,2,1,3
8,2023-08-12T09:18:00+10:00,2023-08-12,09:18,0,1,1
8,2023-08-12T09:22:00+10:00,2023-08-12,09:22,3,0,3
14,2023-08-12T09:13:00+10:00,2023-08-12,09:13,4,0,4
14,2023-08-12T09:16:00+10:00,2023-08-12,09:16,2,1,3
14,2023-08-12T09:21:00+10:00,2023-08-12,09:21,2,3,5
14,2023-08-12T09:23:00+10:00,2023-08-12,09:23,6,2,8
21,2023-08-12T09:10:00+10:00,2023-08-12,09:10,2,2,4
21,2023-08-12T09:18:00+10:00,2023-08-12,09:18,2,2,4
21,2023-08-12T09:23:00+10:00,2023-08-12,09:23,2,1,3
28,2023-08-12T09:10:00+10:00,2023-08-12,09:10,3,2,5
28,2023-08-12T09:12:00+10:00,2023-08-12,09:12,4,6,10
28,2023-08-12T09:21:00+10:00,2023-08-12,09:21,4,1,5
28,2023-08-12T09:23:00+10:00,2023-08-12,09:23,5,1,6
29,2023-08-12T09:11:00+10:00,2023-08-12,09:11,0,4,4
29,2023-08-12T09:14:00+10:00,2023-08-12,09:14,8,3,11
39,2023-08-12T09:12:00+10:00,2023-08-12,09:12,1,4,5
39,2023-08-12T09:13:00+10:00,2023-08-12,09:13,5,1,6
39,2023-08-12T09:16:00+10:00,2023-08-12,09:16,2,3,5
39,2023-08-12T09:17:00+10:00,2023-08-12,09:17,1,0,1
39,2023-08-12T09:20:00+10:00,2023-08-12,09:20,2,1,3
39,2023-08-12T09:23:00+10:00,2023-08-12,09:23,0,2,2
41,2023-08-12T09:11:00+10:00,2023-08-12,09:11,14,12,26
41,2023-08-12T09:13:00+10:00,2023-08-12,09:13,29,10,39
41,2023-08-12T09:14:00+10:00,2023-08-12,09:14,9,1,10
41,2023-08-12T09:19:00+10:00,2023-08-12,09:19,20,3,23
41,2023-08-12T09:21:00+10:00,2023-08-12,09:21,19,4,23
41,2023-08-12T09:22:00+10:00,2023-08-12,09:22,17,3,20
54,2023-08-12T09:10:00+10:00,2023-08-12,09:10,1,0,1
54,2023-08-12T09:12:00+10:00,2023-08-12,09:12,1,3,4
54,2023-08-12T09:21:00+10:00,2023-08-12,09:21,0,1,1
55,2023-08-12T09:10:00+10:00,2023-08-12,09:10,6,8,14
55,2023-08-12T09:11:00+10:00,2023-08-12,09:11,5,1,6
55,2023-08-12T09:12:00+10:00,2023-08-12,09:12,2,2,4
55,2023-08-12T09:13:00+10:00,2023-08-12,09:13,6,6,12
55,2023-08-12T09:15:00+10:00,2023-08-12,09:15,1,10,11
55,2023-08-12T09:17:00+10:00,2023-08-12,09:17,5,4,9
55,2023-08-12T09:19:00+10:00,2023-08-12,09:19,5,11,16
55,2023-08-12T09:22:00+10:00,2023-08-12,09:22,1,4,5
55,2023-08-12T09:24:00+10:00,2023-08-12,09:24,4,3,7
59,2023-08-12T09:10:00+10:00,2023-08-12,09:10,12,7,19
59,2023-08-12T09:20:00+10:00,2023-08-12,09:20,15,21,36
61,2023-08-12T09:17:00+10:00,2023-08-12,09:17,0,7,7
61,2023-08-12T09:18:00+10:00,2023-08-12,09:18,0,6,6
61,2023-08-12T09:19:00+10:00,2023-08-12,09:19,4,4,8
61,2023-08-12T09:22:00+10:00,2023-08-12,09:22,0,4,4
61,2023-08-12T09:23:00+10:00,2023-08-12,09:23,3,2,5
65,2023-08-12T09:11:00+10:00,2023-08-12,09:11,2,4,6
65,2023-08-12T09:17:00+10:00,2023-08-12,09:17,5,1,6
65,2023-08-12T09:21:00+10:00,2023-08-12,09:21,1,0,1
66,2023-08-12T09:10:00+10:00,2023-08-12,09:10,0,2,2
66,2023-08-12T09:20:00+10:00,2023-08-12,09:20,2,11,13
66,2023-08-12T09:23:00+10:00,2023-08-12,09:23,3,5,8
66,2023-08-12T09:24:00+10:00,2023-08-12,09:24,1,5,6
69,2023-08-12T09:10:00+10:00,2023-08-12,09:10,4,2,6
69,2023-08-12T09:12:00+10:00,2023-08-12,09:12,2,5,7
69,2023-08-12T09:13:00+10:00,2023-08-12,09:13,1,0,1
69,2023-08-12T09:14:00+10:00,2023-08-12,09:14,4,1,5
69,2023-08-12T09:15:00+10:00,2023-08-12,09:15,3,8,11
69,2023-08-12T09:16:00+10:00,2023-08-12,09:16,6,3,9
69,2023-08-12T09:18:00+10:00,2023-08-12,09:18,4,2,6
69,2023-08-12T09:21:00+10:00,2023-08-12,09:21,4,2,6
69,2023-08-12T09:22:00+10:00,2023-08-12,09:22,6,3,9
70,2023-08-12T09:13:00+10:00,2023-08-12,09:13,0,1,1
70,2023-08-12T09:18:00+10:00,2023-08-12,09:18,4,0,4
70,2023-08-12T09:20:00+10:00,2023-08-12,09:20,3,2,5
70,2023-08-12T09:21:00+10:00,2023-08-12,09:21,1,1,2
70,2023-08-12T09:22:00+10:00,2023-08-12,09:22,3,1,4
70,2023-08-12T09:23:00+10:00,2023-08-12,09:23,2,0,2
75,2023-08-12T09:16:00+10:00,2023-08-12,09:16,0,2,2
77,2023-08-12T09:14:00+10:00,2023-08-12,09:14,0,3,3
77,2023-08-12T09:23:00+10:00,2023-08-12,09:23,0,1,1
77,2023-08-12T09:24:00+10:00,2023-08-12,09:24,1,1,2
78,2023-08-12T09:15:00+10:00,2023-08-12,09:15,1,0,1
78,2023-08-12T09:17:00+10:00,2023-08-12,09:17,0,1,1
78,2023-08-12T09:18:00+10:00,2023-08-12,09:18,0,2,2
84,2023-08-12T09:20:00+10:00,2023-08-12,09:20,41,22,63
87,2023-08-12T09:14:00+10:00,2023-08-12,09:14,3,1,4
87,2023-08-12T09:15:00+10:00,2023-08-12,09:15,0,1,1
87,2023-08-12T09:16:00+10:00,2023-08-12,09:16,2,2,4
87,2023-08-12T09:18:00+10:00,2023-08-12,09:18,3,4,7
87,2023-08-12T09:22:00+10:00,2023-08-12,09:22,3,1,4
87,2023-08-12T09:24:00+10:00,2023-08-12,09:24,1,1,2
107,2023-08-12T09:10:00+10:00,2023-08-12,09:10,6,6,12
108,2023-08-12T09:15:00+10:00,2023-08-12,09:15,1,0,1
108,2023-08-12T09:19:00+10:00,2023-08-12,09:19,3,1,4
118,2023-08-12T09:15:00+10:00,2023-08-12,09:15,0,2,2
1,2023-08-12T09:10:00+10:00,2023-08-12,09:10,4,5,9
1,2023-08-12T09:11:00+10:00,2023-08-12,09:11,3,8,11
1,2023-08-12T09:14:00+10:00,2023-08-12,09:14,5,4,9
1,2023-08-12T09:16:00+10:00,2023-08-12,09:16,2,7,9
1,2023-08-12T09:21:00+10:00,2023-08-12,09:21,8,12,20
1,2023-08-12T09:23:00+10:00,2023-08-12,09:23,0,3,3
2,2023-08-12T09:10:00+10:00,2023-08-12,09:10,2,1,3
2,2023-08-12T09:14:00+10:00,2023-08-12,09:14,0,6,6
2,2023-08-12T09:18:00+10:00,2023-08-12,09:18,0,2,2
2,2023-08-12T09:20:00+10:00,2023-08-12,09:20,0,4,4
2,2023-08-12T09:21:00+10:00,2023-08-12,09:21,2,5,7
2,2023-08-12T09:23:00+10:00,2023-08-12,09:23,1,4,5
7,2023-08-12T09:11:00+10:00,2023-08-12,09:11,1,1,2
7,2023-08-12T09:12:00+10:00,2023-08-12,09:12,1,1,2
7,2023-08-12T09:15:00+10:00,2023-08-12,09:15,0,1,1
9,2023-08-12T09:16:00+10:00,2023-08-12,09:16,0,1,1
9,2023-08-12T09:19:00+10:00,2023-08-12,09:19,3,3,6
9,2023-08-12T09:24:00+10:00,2023-08-12,09:24,2,1,3
10,2023-08-12T09:12:00+10:00,2023-08-12,09:12,0,1,1
10,2023-08-12T09:13:00+10:00,2023-08-12,09:13,0,1,1
10,2023-08-12T09:14:00+10:00,2023-08-12,09:14,1,0,1
10,2023-08-12T09:19:00+10:00,2023-08-12,09:19,2,1,3
10,2023-08-12T09:20:00+10:00,2023-08-12,09:20,3,1,4
11,2023-08-12T09:19:00+10:00,2023-08-12,09:19,1,2,3
12,2023-08-12T09:10:00+10:00,2023-08-12,09:10,0,2,2
12,2023-08-12T09:16:00+10:00,2023-08-12,09:16,1,1,2
12,2023-08-12T09:17:00+10:00,2023-08-12,09:17,2,0,2
12,2023-08-12T09:21:00+10:00,2023-08-12,09:21,3,1,4
12,2023-08-12T09:23:00+10:00,2023-08-12,09:23,0,2,2
12,2023-08-12T09:24:00+10:00,2023-08-12,09:24,3,3,6
17,2023-08-12T09:12:00+10:00,2023-08-12,09:12,0,1,1
17,2023-08-12T09:13:00+10:00,2023-08-12,09:13,1,1,2
17,2023-08-12T09:21:00+10:00,2023-08-12,09:21,3,0,3
18,2023-08-12T09:13:00+10:00,2023-08-12,09:13,2,0,2
18,2023-08-12T09:19:00+10:00,2023-08-12,09:19,2,0,2
24,2023-08-12T09:10:00+10:00,2023-08-12,09:10,6,3,9
24,2023-08-12T09:13:00+10:00,2023-08-12,09:13,5,3,8
24,2023-08-12T09:16:00+10:00,2023-08-12,09:16,9,0,9
24,2023-08-12T09:20:00+10:00,2023-08-12,09:20,4,4,8
24,2023-08-12T09:22:00+10:00,2023-08-12,09:22,10,1,11
24,2023-08-12T09:23:00+10:00,2023-08-12,09:23,5,1,6
27,2023-08-12T09:14:00+10:00,2023-08-12,09:14,3,0,3
27,2023-08-12T09:18:00+10:00,2023-08-12,09:18,3,0,3
27,2023-08-12T09:19:00+10:00,2023-08-12,09:19,2,0,2
27,2023-08-12T09:21:00+10:00,2023-08-12,09:21,0,1,1
27,2023-08-12T09:22:00+10:00,2023-08-12,09:22,2,2,4
27,2023-08-12T09:24:00+10:00,2023-08-12,09:24,3,5,8
35,2023-08-12T09:11:00+10:00,2023-08-12,09:11,3,5,8
35,2023-08-12T09:14:00+10:00,2023-08-12,09:14,11,2,13
35,2023-08-12T09:20:00+10:00,2023-08-12,09:20,11,4,15
35,2023-08-12T09:23:00+10:00,2023-08-12,09:23,3,2,5
53,2023-08-12T09:10:00+10:00,2023-08-12,09:10,1,0,1
53,2023-08-12T09:11:00+10:00,2023-08-12,09:11,1,2,3
53,2023-08-12T09:19:00+10:00,2023-08-12,09:19,4,5,9
53,2023-08-12T09:21:00+10:00,2023-08-12,09:21,7,5,12
53,2023-08-12T09:23:00+10:00,2023-08-12,09:23,7,2,9
56,2023-08-12T09:10:00+10:00,2023-08-12,09:10,2,0,2
56,2023-08-12T09:14:00+10:00,2023-08-12,09:14,0,2,2
56,2023-08-12T09:16:00+10:00,2023-08-12,09:16,4,0,4
56,2023-08-12T09:20:00+10:00,2023-08-12,09:20,1,0,1
57,2023-08-12T09:15:00+10:00,2023-08-12,09:15,3,1,4
57,2023-08-12T09:17:00+10:00,2023-08-12,09:17,1,1,2
57,2023-08-12T09:20:00+10:00,2023-08-12,09:20,1,1,2
57,2023-08-12T09:24:00+10:00,2023-08-12,09:24,2,1,3
58,2023-08-12T09:10:00+10:00,2023-08-12,09:10,1,0,1
58,2023-08-12T09:18:00+10:00,2023-08-12,09:18,8,0,8
58,2023-08-12T09:19:00+10:00,2023-08-12,09:19,12,2,14
58,2023-08-12T09:23:00+10:00,2023-08-12,09:23,9,1,10
58,2023-08-12T09:24:00+10:00,2023-08-12,09:24,14,0,14
62,2023-08-12T09:10:00+10:00,2023-08-12,09:10,3,1,4
62,2023-08-12T09:20:00+10:00,2023-08-12,09:20,3,0,3
63,2023-08-12T09:10:00+10:00,2023-08-12,09:10,2,0,2
63,2023-08-12T09:11:00+10:00,2023-08-12,09:11,2,2,4
63,2023-08-12T09:14:00+10:00,2023-08-12,09:14,2,1,3
63,2023-08-12T09:19:00+10:00,2023-08-12,09:19,1,2,3
63,2023-08-12T09:24:00+10:00,2023-08-12,09:24,3,1,4
67,2023-08-12T09:12:00+10:00,2023-08-12,09:12,3,0,3
67,2023-08-12T09:13:00+10:00,2023-08-12,09:13,4,0,4
67,2023-08-12T09:16:00+10:00,2023-08-12,09:16,5,5,10
67,2023-08-12T09:17:00+10:00,2023-08-12,09:17,1,2,3
67,2023-08-12T09:19:00+10:00,2023-08-12,09:19,2,2,4
67,2023-08-12T09:21:00+10:00,2023-08-12,09:21,1,6,7
68,2023-08-12T09:15:00+10:00,2023-08-12,09:15,3,3,6
68,2023-08-12T09:18:00+10:00,2023-08-12,09:18,4,1,5
68,2023-08-12T09:22:00+10:00,2023-08-12,09:22,2,0,2
68,2023-08-12T09:23:00+10:00,2023-08-12,09:23,2,1,3
72,2023-08-12T09:10:00+10:00,2023-08-12,09:10,6,1,7
72,2023-08-12T09:16:00+10:00,2023-08-12,09:16,3,1,4
72,2023-08-12T09:17:00+10:00,2023-08-12,09:17,1,0,1
72,2023-08-12T09:18:00+10:00,2023-08-12,09:18,4,1,5
76,2023-08-12T09:10:00+10:00,2023-08-12,09:10,1,3,4
76,2023-08-12T09:18:00+10:00,2023-08-12,09:18,0,1,1
76,2023-08-12T09:22:00+10:00,2023-08-12,09:22,0,1,1
76,2023-08-12T09:24:00+10:00,2023-08-12,09:24,1,0,1
79,2023-08-12T09:16:00+10:00,2023-08-12,09:16,5,4,9
79,2023-08-12T09:19:00+10:00,2023-08-12,09:19,4,5,9
79,2023-08-12T09:21:00+10:00,2023-08-12,09:21,2,4,6
79,2023-08-12T09:22:00+10:00,2023-08-12,09:22,0,2,2
79,2023-08-12T09:23:00+10:00,2023-08-12,09:23,3,3,6
85,2023-08-12T09:10:00+10:00,2023-08-12,09:10,1,0,1
85,2023-08-12T09:20:00+10:00,2023-08-12,09:20,1,3,4
86,2023-08-12T09:15:00+10:00,2023-08-12,09:15,1,1,2
86,2023-08-12T09:21:00+10:00,2023-08-12,09:21,0,2,2
86,2023-08-12T09:23:00+10:00,2023-08-12,09:23,5,0,5
117,2023-08-12T09:15:00+10:00,2023-08-12,09:15,7,7,14
117,2023-08-12T09:20:00+10:00,2023-08-12,09:20,7,1,8
122,2023-08-12T09:11:00+10:00,2023-08-12,09:11,1,0,1
122,2023-08-12T09:13:00+10:00,2023-08-12,09:13,1,0,1
122,2023-08-12T09:17:00+10:00,2023-08-12,09:17,0,2,2
41,2023-08-12T09:25:00+10:00,2023-08-12,09:25,28,7,35
41,2023-08-12T09:28:00+10:00,2023-08-12,09:28,32,7,39
41,2023-08-12T09:30:00+10:00,2023-08-12,09:30,8,5,13
54,2023-08-12T09:25:00+10:00,2023-08-12,09:25,0,1,1
54,2023-08-12T09:26:00+10:00,2023-08-12,09:26,1,3,4
54,2023-08-12T09:29:00+10:00,2023-08-12,09:29,1,2,3
54,2023-08-12T09:30:00+10:00,2023-08-12,09:30,0,1,1
54,2023-08-12T09:32:00+10:00,2023-08-12,09:32,1,0,1
54,2023-08-12T09:34:00+10:00,2023-08-12,09:34,0,3,3
54,2023-08-12T09:38:00+10:00,2023-08-12,09:38,1,0,1
55,2023-08-12T09:25:00+10:00,2023-08-12,09:25,0,2,2
55,2023-08-12T09:26:00+10:00,2023-08-12,09:26,8,10,18
55,2023-08-12T09:27:00+10:00,2023-08-12,09:27,4,7,11
55,2023-08-12T09:28:00+10:00,2023-08-12,09:28,2,7,9
55,2023-08-12T09:35:00+10:00,2023-08-12,09:35,7,11,18
61,2023-08-12T09:29:00+10:00,2023-08-12,09:29,1,2,3
61,2023-08-12T09:36:00+10:00,2023-08-12,09:36,1,5,6
61,2023-08-12T09:37:00+10:00,2023-08-12,09:37,1,7,8
61,2023-08-12T09:39:00+10:00,2023-08-12,09:39,0,5,5
65,2023-08-12T09:30:00+10:00,2023-08-12,09:30,1,1,2
65,2023-08-12T09:31:00+10:00,2023-08-12,09:31,3,1,4
66,2023-08-12T09:27:00+10:00,2023-08-12,09:27,9,0,9
66,2023-08-12T09:30:00+10:00,2023-08-12,09:30,4,4,8
66,2023-08-12T09:31:00+10:00,2023-08-12,09:31,3,4,7
66,2023-08-12T09:33:00+10:00,2023-08-12,09:33,3,8,11
66,2023-08-12T09:35:00+10:00,2023-08-12,09:35,4,1,5
66,2023-08-12T09:36:00+10:00,2023-08-12,09:36,3,4,7
66,2023-08-12T09:38:00+10:00,2023-08-12,09:38,0,4,4
69,2023-08-12T09:25:00+10:00,2023-08-12,09:25,1,0,1
69,2023-08-12T09:26:00+10:00,2023-08-12,09:26,3,5,8
69,2023-08-12T09:37:00+10:00,2023-08-12,09:37,4,2,6
69,2023-08-12T09:38:00+10:00,2023-08-12,09:38,2,1,3
70,2023-08-12T09:25:00+10:00,2023-08-12,09:25,0,2,2
70,2023-08-12T09:27:00+10:00,2023-08-12,09:27,0,3,3
70,2023-08-12T09:28:00+10:00,2023-08-12,09:28,1,2,3
70,2023-08-12T09:30:00+10:00,2023-08-12,09:30,6,0,6
70,2023-08-12T09:31:00+10:00,2023-08-12,09:31,4,3,7
70,2023-08-12T09:32:00+10:00,2023-08-12,09:32,1,0,1
70,2023-08-12T09:33:00+10:00,2023-08-12,09:33,0,2,2
70,2023-08-12T09:34:00+10:00,2023-08-12,09:34,0,2,2
70,2023-08-12T09:35:00+10:00,2023-08-12,09:35,1,1,2
70,2023-08-12T09:37:00+10:00,2023-08-12,09:37,2,1,3
70,2023-08-12T09:39:00+10:00,2023-08-12,09:39,2,1,3
71,2023-08-12T09:26:00+10:00,2023-08-12,09:26,1,1,2
75,2023-08-12T09:31:00+10:00,2023-08-12,09:31,4,0,4
77,2023-08-12T09:25:00+10:00,2023-08-12,09:25,0,3,3
77,2023-08-12T09:33:00+10:00,2023-08-12,09:33,0,1,1
77,2023-08-12T09:34:00+10:00,2023-08-12,09:34,2,1,3
77,2023-08-12T09:35:00+10:00,2023-08-12,09:35,4,0,4
77,2023-08-12T09:36:00+10:00,2023-08-12,09:36,2,2,4
77,2023-08-12T09:39:00+10:00,2023-08-12,09:39,0,2,2
78,2023-08-12T09:26:00+10:00,2023-08-12,09:26,0,3,3
84,2023-08-12T09:30:00+10:00,2023-08-12,09:30,46,50,96
84,2023-08-12T09:35:00+10:00,2023-08-12,09:35,39,49,88
87,2023-08-12T09:25:00+10:00,2023-08-12,09:25,2,3,5
107,2023-08-12T09:30:00+10:00,2023-08-12,09:30,3,2,5
107,2023-08-12T09:35:00+10:00,2023-08-12,09:35,6,6,12
108,2023-08-12T09:25:00+10:00,2023-08-12,09:25,0,1,1
108,2023-08-12T09:29:00+10:00,2023-08-12,09:29,1,0,1
108,2023-08-12T09:35:00+10:00,2023-08-12,09:35,2,2,4
108,2023-08-12T09:37:00+10:00,2023-08-12,09:37,0,2,2
118,2023-08-12T09:30:00+10:00,2023-08-12,09:30,1,0,1
118,2023-08-12T09:35:00+10:00,2023-08-12,09:35,4,0,4
1,2023-08-12T09:27:00+10:00,2023-08-12,09:27,2,7,9
1,2023-08-12T09:29:00+10:00,2023-08-12,09:29,6,7,13
1,2023-08-12T09:32:00+10:00,2023-08-12,09:32,4,11,15
1,2023-08-12T09:33:00+10:00,2023-08-12,09:33,4,11,15
1,2023-08-12T09:35:00+10:00,2023-08-12,09:35,1,4,5
1,2023-08-12T09:36:00+10:00,2023-08-12,09:36,6,5,11
1,2023-08-12T09:38:00+10:00,2023-08-12,09:38,0,4,4
2,2023-08-12T09:25:00+10:00,2023-08-12,09:25,3,0,3
2,2023-08-12T09:26:00+10:00,2023-08-12,09:26,0,3,3
2,2023-08-12T09:27:00+10:00,2023-08-12,09:27,0,5,5
2,2023-08-12T09:29:00+10:00,2023-08-12,09:29,8,2,10
2,2023-08-12T09:36:00+10:00,2023-08-12,09:36,1,3,4
7,2023-08-12T09:30:00+10:00,2023-08-12,09:30,2,0,2
7,2023-08-12T09:31:00+10:00,2023-08-12,09:31,2,1,3
7,2023-08-12T09:35:00+10:00,2023-08-12,09:35,2,0,2
7,2023-08-12T09:38:00+10:00,2023-08-12,09:38,0,1,1
9,2023-08-12T09:28:00+10:00,2023-08-12,09:28,0,2,2
9,2023-08-12T09:32:00+10:00,2023-08-12,09:32,0,1,1
9,2023-08-12T09:34:00+10:00,2023-08-12,09:34,1,0,1
9,2023-08-12T09:37:00+10:00,2023-08-12,09:37,0,1,1
9,2023-08-12T09:38:00+10:00,2023-08-12,09:38,1,5,6
9,2023-08-12T09:39:00+10:00,2023-08-12,09:39,3,0,3
10,2023-08-12T09:26:00+10:00,2023-08-12,09:26,1,4,5
10,2023-08-12T09:32:00+10:00,2023-08-12,09:32,1,0,1
10,2023-08-12T09:34:00+10:00,2023-08-12,09:34,0,1,1
11,2023-08-12T09:28:00+10:00,2023-08-12,09:28,0,3,3
11,2023-08-12T09:33:00+10:00,2023-08-12,09:33,1,0,1
11,2023-08-12T09:35:00+10:00,2023-08-12,09:35,3,7,10
11,2023-08-12T09:38:00+10:00,2023-08-12,09:38,0,3,3
12,2023-08-12T09:25:00+10:00,2023-08-12,09:25,2,0,2
12,2023-08-12T09:27:00+10:00,2023-08-12,09:27,1,1,2
12,2023-08-12T09:28:00+10:00,2023-08-12,09:28,2,0,2
12,2023-08-12T09:29:00+10:00,2023-08-12,09:29,1,1,2
12,2023-08-12T09:31:00+10:00,2023-08-12,09:31,2,0,2
17,2023-08-12T09:29:00+10:00,2023-08-12,09:29,1,2,3
17,2023-08-12T09:31:00+10:00,2023-08-12,09:31,4,4,8
17,2023-08-12T09:33:00+10:00,2023-08-12,09:33,1,0,1
17,2023-08-12T09:38:00+10:00,2023-08-12,09:38,4,2,6
24,2023-08-12T09:25:00+10:00,2023-08-12,09:25,4,5,9
24,2023-08-12T09:30:00+10:00,2023-08-12,09:30,2,7,9
24,2023-08-12T09:33:00+10:00,2023-08-12,09:33,7,2,9
24,2023-08-12T09:34:00+10:00,2023-08-12,09:34,16,4,20
24,2023-08-12T09:35:00+10:00,2023-08-12,09:35,9,7,16
24,2023-08-12T09:36:00+10:00,2023-08-12,09:36,7,3,10
27,2023-08-12T09:35:00+10:00,2023-08-12,09:35,3,0,3
27,2023-08-12T09:36:00+10:00,2023-08-12,09:36,1,3,4
35,2023-08-12T09:25:00+10:00,2023-08-12,09:25,7,7,14
35,2023-08-12T09:28:00+10:00,2023-08-12,09:28,6,7,13
35,2023-08-12T09:30:00+10:00,2023-08-12,09:30,16,3,19
35,2023-08-12T09:32:00+10:00,2023-08-12,09:32,11,1,12
35,2023-08-12T09:34:00+10:00,2023-08-12,09:34,5,5,10
35,2023-08-12T09:35:00+10:00,2023-08-12,09:35,7,6,13
35,2023-08-12T09:38:00+10:00,2023-08-12,09:38,3,7,10
53,2023-08-12T09:28:00+10:00,2023-08-12,09:28,2,5,7
53,2023-08-12T09:29:00+10:00,2023-08-12,09:29,2,4,6
53,2023-08-12T09:31:00+10:00,2023-08-12,09:31,3,4,7
56,2023-08-12T09:25:00+10:00,2023-08-12,09:25,1,0,1
56,2023-08-12T09:28:00+10:00,2023-08-12,09:28,1,1,2
56,2023-08-12T09:30:00+10:00,2023-08-12,09:30,3,0,3
56,2023-08-12T09:32:00+10:00,2023-08-12,09:32,1,2,3
56,2023-08-12T09:37:00+10:00,2023-08-12,09:37,4,1,5
56,2023-08-12T09:39:00+10:00,2023-08-12,09:39,0,2,2
57,2023-08-12T09:25:00+10:00,2023-08-12,09:25,1,2,3
57,2023-08-12T09:36:00+10:00,2023-08-12,09:36,0,2,2
57,2023-08-12T09:38:00+10:00,2023-08-12,09:38,0,2,2
58,2023-08-12T09:26:00+10:00,2023-08-12,09:26,9,0,9
58,2023-08-12T09:27:00+10:00,2023-08-12,09:27,2,10,12
58,2023-08-12T09:29:00+10:00,2023-08-12,09:29,15,3,18
58,2023-08-12T09:31:00+10:00,2023-08-12,09:31,7,8,15
58,2023-08-12T09:35:00+10:00,2023-08-12,09:35,10,5,15
58,2023-08-12T09:36:00+10:00,2023-08-12,09:36,3,2,5
62,2023-08-12T09:25:00+10:00,2023-08-12,09:25,3,3,6
62,2023-08-12T09:26:00+10:00,2023-08-12,09:26,6,1,7
62,2023-08-12T09:27:00+10:00,2023-08-12,09:27,1,2,3
62,2023-08-12T09:31:00+10:00,2023-08-12,09:31,3,4,7
62,2023-08-12T09:32:00+10:00,2023-08-12,09:32,0,6,6
62,2023-08-12T09:35:00+10:00,2023-08-12,09:35,2,3,5
63,2023-08-12T09:28:00+10:00,2023-08-12,09:28,0,1,1
63,2023-08-12T09:33:00+10:00,2023-08-12,09:33,1,3,4
63,2023-08-12T09:34:00+10:00,2023-08-12,09:34,6,7,13
63,2023-08-12T09:36:00+10:00,2023-08-12,09:36,2,3,5
63,2023-08-12T09:37:00+10:00,2023-08-12,09:37,4,0,4
67,2023-08-12T09:29:00+10:00,2023-08-12,09:29,1,4,5
67,2023-08-12T09:30:00+10:00,2023-08-12,09:30,12,9,21
67,2023-08-12T09:31:00+10:00,2023-08-12,09:31,1,9,10
67,2023-08-12T09:34:00+10:00,2023-08-12,09:34,5,2,7
68,2023-08-12T09:29:00+10:00,2023-08-12,09:29,4,3,7
68,2023-08-12T09:31:00+10:00,2023-08-12,09:31,5,2,7
68,2023-08-12T09:32:00+10:00,2023-08-12,09:32,0,1,1
68,2023-08-12T09:35:00+10:00,2023-08-12,09:35,4,2,6
68,2023-08-12T09:39:00+10:00,2023-08-12,09:39,3,3,6
72,2023-08-12T09:25:00+10:00,2023-08-12,09:25,4,3,7
72,2023-08-12T09:31:00+10:00,2023-08-12,09:31,1,0,1
72,2023-08-12T09:34:00+10:00,2023-08-12,09:34,3,2,5
72,2023-08-12T09:37:00+10:00,2023-08-12,09:37,1,0,1
72,2023-08-12T09:38:00+10:00,2023-08-12,09:38,2,4,6
76,2023-08-12T09:27:00+10:00,2023-08-12,09:27,0,3,3
79,2023-08-12T09:30:00+10:00,2023-08-12,09:30,1,4,5
79,2023-08-12T09:35:00+10:00,2023-08-12,09:35,4,2,6
79,2023-08-12T09:37:00+10:00,2023-08-12,09:37,9,1,10
85,2023-08-12T09:25:00+10:00,2023-08-12,09:25,3,0,3
86,2023-08-12T09:28:00+10:00,2023-08-12,09:28,0,2,2
86,2023-08-12T09:32:00+10:00,2023-08-12,09:32,2,2,4
86,2023-08-12T09:33:00+10:00,2023-08-12,09:33,1,1,2
86,2023-08-12T09:37:00+10:00,2023-08-12,09:37,0,1,1
86,2023-08-12T09:38:00+10:00,2023-08-12,09:38,0,2,2
109,2023-08-12T09:30:00+10:00,2023-08-12,09:30,7,4,11
117,2023-08-12T09:25:00+10:00,2023-08-12,09:25,2,1,3
117,2023-08-12T09:30:00+10:00,2023-08-12,09:30,6,1,7
122,2023-08-12T09:34:00+10:00,2023-08-12,09:34,1,0,1
3,2023-08-12T09:26:00+10:00,2023-08-12,09:26,11,4,15
3,2023-08-12T09:30:00+10:00,2023-08-12,09:30,0,8,8
3,2023-08-12T09:38:00+10:00,2023-08-12,09:38,3,3,6
3,2023-08-12T09:39:00+10:00,2023-08-12,09:39,7,4,11
4,2023-08-12T09:25:00+10:00,2023-08-12,09:25,2,4,6
4,2023-08-12T09:26:00+10:00,2023-08-12,09:26,14,4,18
4,2023-08-12T09:29:00+10:00,2023-08-12,09:29,9,1,10
4,2023-08-12T09:32:00+10:00,2023-08-12,09:32,11,5,16
4,2023-08-12T09:37:00+10:00,2023-08-12,09:37,13,5,18
4,2023-08-12T09:38:00+10:00,2023-08-12,09:38,13,1,14
4,2023-08-12T09:39:00+10:00,2023-08-12,09:39,7,6,13
6,2023-08-12T09:27:00+10:00,2023-08-12,09:27,5,2,7
6,2023-08-12T09:33:00+10:00,2023-08-12,09:33,2,4,6
6,2023-08-12T09:34:00+10:00,2023-08-12,09:34,8,6,14
6,2023-08-12T09:35:00+10:00,2023-08-12,09:35,7,2,9
6,2023-08-12T09:39:00+10:00,2023-08-12,09:39,6,4,10
8,2023-08-12T09:28:00+10:00,2023-08-12,09:28,1,0,1
8,2023-08-12T09:30:00+10:00,2023-08-12,09:30,0,4,4
8,2023-08-12T09:33:00+10:00,2023-08-12,09:33,0,2,2
8,2023-08-12T09:34:00+10:00,2023-08-12,09:34,0,4,4
8,2023-08-12T09:36:00+10:00,2023-08-12,09:36,1,2,3
8,2023-08-12T09:38:00+10:00,2023-08-12,09:38,2,0,2
14,2023-08-12T09:25:00+10:00,2023-08-12,09:25,2,0,2
14,2023-08-12T09:30:00+10:00,2023-08-12,09:30,0,1,1
14,2023-08-12T09:31:00+10:00,2023-08-12,09:31,5,3,8
21,2023-08-12T09:25:00+10:00,2023-08-12,09:25,1,0,1
21,2023-08-12T09:27:00+10:00,2023-08-12,09:27,2,2,4
21,2023-08-12T09:30:00+10:00,2023-08-12,09:30,4,2,6
21,2023-08-12T09:31:00+10:00,2023-08-12,09:31,2,1,3
21,2023-08-12T09:34:00+10:00,2023-08-12,09:34,2,4,6
21,2023-08-12T09:36:00+10:00,2023-08-12,09:36,0,3,3
21,2023-08-12T09:38:00+10:00,2023-08-12,09:38,3,1,4
21,2023-08-12T09:39:00+10:00,2023-08-12,09:39,3,0,3
28,2023-08-12T09:25:00+10:00,2023-08-12,09:25,1,3,4
28,2023-08-12T09:34:00+10:00,2023-08-12,09:34,1,2,3
29,2023-08-12T09:27:00+10:00,2023-08-12,09:27,0,1,1
29,2023-08-12T09:32:00+10:00,2023-08-12,09:32,1,0,1
29,2023-08-12T09:33:00+10:00,2023-08-12,09:33,0,7,7
29,2023-08-12T09:34:00+10:00,2023-08-12,09:34,2,8,10
39,2023-08-12T09:25:00+10:00,2023-08-12,09:25,1,0,1
39,2023-08-12T09:26:00+10:00,2023-08-12,09:26,1,1,2
39,2023-08-12T09:35:00+10:00,2023-08-12,09:35,1,2,3
39,2023-08-12T09:36:00+10:00,2023-08-12,09:36,1,1,2
39,2023-08-12T09:38:00+10:00,2023-08-12,09:38,1,3,4
3,2023-08-12T09:44:00+10:00,2023-08-12,09:44,4,5,9
3,2023-08-12T09:46:00+10:00,2023-08-12,09:46,1,4,5
3,2023-08-12T09:48:00+10:00,2023-08-12,09:48,3,4,7
3,2023-08-12T09:52:00+10:00,2023-08-12,09:52,1,8,9
4,2023-08-12T09:50:00+10:00,2023-08-12,09:50,18,2,20
4,2023-08-12T09:52:00+10:00,2023-08-12,09:52,8,5,13
4,2023-08-12T09:53:00+10:00,2023-08-12,09:53,11,13,24
4,2023-08-12T09:54:00+10:00,2023-08-12,09:54,6,5,11
6,2023-08-12T09:42:00+10:00,2023-08-12,09:42,7,0,7
6,2023-08-12T09:46:00+10:00,2023-08-12,09:46,13,7,20
6,2023-08-12T09:49:00+10:00,2023-08-12,09:49,11,7,18
6,2023-08-12T09:52:00+10:00,2023-08-12,09:52,20,4,24
6,2023-08-12T09:54:00+10:00,2023-08-12,09:54,4,4,8
8,2023-08-12T09:41:00+10:00,2023-08-12,09:41,0,1,1
8,2023-08-12T09:47:00+10:00,2023-08-12,09:47,0,4,4
8,2023-08-12T09:51:00+10:00,2023-08-12,09:51,2,3,5
8,2023-08-12T09:53:00+10:00,2023-08-12,09:53,2,2,4
14,2023-08-12T09:40:00+10:00,2023-08-12,09:40,8,4,12
14,2023-08-12T09:42:00+10:00,2023-08-12,09:42,5,3,8
14,2023-08-12T09:44:00+10:00,2023-08-12,09:44,0,2,2
14,2023-08-12T09:49:00+10:00,2023-08-12,09:49,11,0,11
14,2023-08-12T09:51:00+10:00,2023-08-12,09:51,3,1,4
14,2023-08-12T09:52:00+10:00,2023-08-12,09:52,2,1,3
14,2023-08-12T09:53:00+10:00,2023-08-12,09:53,4,0,4
21,2023-08-12T09:42:00+10:00,2023-08-12,09:42,1,2,3
21,2023-08-12T09:43:00+10:00,2023-08-12,09:43,4,0,4
21,2023-08-12T09:45:00+10:00,2023-08-12,09:45,0,6,6
21,2023-08-12T09:49:00+10:00,2023-08-12,09:49,3,0,3
21,2023-08-12T09:51:00+10:00,2023-08-12,09:51,1,1,2
28,2023-08-12T09:43:00+10:00,2023-08-12,09:43,4,12,16
28,2023-08-12T09:46:00+10:00,2023-08-12,09:46,1,3,4
28,2023-08-12T09:48:00+10:00,2023-08-12,09:48,8,3,11
28,2023-08-12T09:49:00+10:00,2023-08-12,09:49,5,5,10
28,2023-08-12T09:52:00+10:00,2023-08-12,09:52,14,10,24
29,2023-08-12T09:47:00+10:00,2023-08-12,09:47,2,1,3
29,2023-08-12T09:48:00+10:00,2023-08-12,09:48,4,3,7
41,2023-08-12T09:42:00+10:00,2023-08-12,09:42,87,4,91
41,2023-08-12T09:44:00+10:00,2023-08-12,09:44,13,12,25
41,2023-08-12T09:45:00+10:00,2023-08-12,09:45,10,6,16
41,2023-08-12T09:48:00+10:00,2023-08-12,09:48,23,2,25
41,2023-08-12T09:51:00+10:00,2023-08-12,09:51,16,17,33
41,2023-08-12T09:53:00+10:00,2023-08-12,09:53,22,9,31
54,2023-08-12T09:41:00+10:00,2023-08-12,09:41,1,2,3
54,2023-08-12T09:43:00+10:00,2023-08-12,09:43,0,1,1
54,2023-08-12T09:44:00+10:00,2023-08-12,09:44,1,0,1
54,2023-08-12T09:47:00+10:00,2023-08-12,09:47,7,0,7
55,2023-08-12T09:42:00+10:00,2023-08-12,09:42,2,6,8
55,2023-08-12T09:43:00+10:00,2023-08-12,09:43,5,5,10
55,2023-08-12T09:45:00+10:00,2023-08-12,09:45,5,1,6
55,2023-08-12T09:46:00+10:00,2023-08-12,09:46,1,11,12
55,2023-08-12T09:49:00+10:00,2023-08-12,09:49,2,11,13
55,2023-08-12T09:50:00+10:00,2023-08-12,09:50,9,11,20
55,2023-08-12T09:52:00+10:00,2023-08-12,09:52,10,10,20
55,2023-08-12T09:53:00+10:00,2023-08-12,09:53,7,9,16
59,2023-08-12T09:45:00+10:00,2023-08-12,09:45,13,13,26
61,2023-08-12T09:40:00+10:00,2023-08-12,09:40,2,3,5
61,2023-08-12T09:44:00+10:00,2023-08-12,09:44,1,2,3
61,2023-08-12T09:51:00+10:00,2023-08-12,09:51,3,7,10
61,2023-08-12T09:53:00+10:00,2023-08-12,09:53,1,4,5
61,2023-08-12T09:54:00+10:00,2023-08-12,09:54,1,3,4
65,2023-08-12T09:41:00+10:00,2023-08-12,09:41,5,0,5
65,2023-08-12T09:43:00+10:00,2023-08-12,09:43,3,1,4
65,2023-08-12T09:45:00+10:00,2023-08-12,09:45,3,2,5
65,2023-08-12T09:46:00+10:00,2023-08-12,09:46,1,1,2
65,2023-08-12T09:48:00+10:00,2023-08-12,09:48,8,3,11
65,2023-08-12T09:49:00+10:00,2023-08-12,09:49,5,4,9
65,2023-08-12T09:50:00+10:00,2023-08-12,09:50,4,3,7
65,2023-08-12T09:52:00+10:00,2023-08-12,09:52,2,2,4
65,2023-08-12T09:53:00+10:00,2023-08-12,09:53,0,4,4
65,2023-08-12T09:54:00+10:00,2023-08-12,09:54,3,6,9
66,2023-08-12T09:40:00+10:00,2023-08-12,09:40,5,6,11
66,2023-08-12T09:44:00+10:00,2023-08-12,09:44,1,3,4
66,2023-08-12T09:45:00+10:00,2023-08-12,09:45,3,2,5
66,2023-08-12T09:47:00+10:00,2023-08-12,09:47,1,8,9
69,2023-08-12T09:42:00+10:00,2023-08-12,09:42,2,3,5
69,2023-08-12T09:46:00+10:00,2023-08-12,09:46,1,7,8
69,2023-08-12T09:47:00+10:00,2023-08-12,09:47,0,1,1
69,2023-08-12T09:50:00+10:00,2023-08-12,09:50,4,5,9
69,2023-08-12T09:52:00+10:00,2023-08-12,09:52,8,2,10
70,2023-08-12T09:41:00+10:00,2023-08-12,09:41,0,1,1
70,2023-08-12T09:49:00+10:00,2023-08-12,09:49,3,2,5
71,2023-08-12T09:50:00+10:00,2023-08-12,09:50,1,0,1
75,2023-08-12T09:42:00+10:00,2023-08-12,09:42,0,1,1
75,2023-08-12T09:43:00+10:00,2023-08-12,09:43,4,0,4
75,2023-08-12T09:52:00+10:00,2023-08-12,09:52,0,1,1
77,2023-08-12T09:42:00+10:00,2023-08-12,09:42,0,1,1
77,2023-08-12T09:44:00+10:00,2023-08-12,09:44,2,3,5
77,2023-08-12T09:49:00+10:00,2023-08-12,09:49,1,0,1
77,2023-08-12T09:51:00+10:00,2023-08-12,09:51,1,0,1
77,2023-08-12T09:53:00+10:00,2023-08-12,09:53,3,3,6
78,2023-08-12T09:43:00+10:00,2023-08-12,09:43,0,4,4
78,2023-08-12T09:46:00+10:00,2023-08-12,09:46,2,0,2
78,2023-08-12T09:51:00+10:00,2023-08-12,09:51,0,1,1
84,2023-08-12T09:40:00+10:00,2023-08-12,09:40,65,20,85
87,2023-08-12T09:43:00+10:00,2023-08-12,09:43,0,2,2
87,2023-08-12T09:48:00+10:00,2023-08-12,09:48,3,2,5
87,2023-08-12T09:50:00+10:00,2023-08-12,09:50,1,4,5
107,2023-08-12T09:40:00+10:00,2023-08-12,09:40,3,7,10
108,2023-08-12T09:42:00+10:00,2023-08-12,09:42,0,1,1
108,2023-08-12T09:44:00+10:00,2023-08-12,09:44,2,1,3
108,2023-08-12T09:52:00+10:00,2023-08-12,09:52,3,3,6
118,2023-08-12T09:40:00+10:00,2023-08-12,09:40,0,1,1
1,2023-08-12T09:43:00+10:00,2023-08-12,09:43,4,9,13
1,2023-08-12T09:45:00+10:00,2023-08-12,09:45,7,15,22
1,2023-08-12T09:47:00+10:00,2023-08-12,09:47,3,4,7
1,2023-08-12T09:48:00+10:00,2023-08-12,09:48,7,4,11
1,2023-08-12T09:51:00+10:00,2023-08-12,09:51,9,10,19
1,2023-08-12T09:53:00+10:00,2023-08-12,09:53,6,9,15
2,2023-08-12T09:43:00+10:00,2023-08-12,09:43,4,12,16
2,2023-08-12T09:45:00+10:00,2023-08-12,09:45,0,2,2
2,2023-08-12T09:46:00+10:00,2023-08-12,09:46,1,2,3
2,2023-08-12T09:47:00+10:00,2023-08-12,09:47,8,9,17
2,2023-08-12T09:48:00+10:00,2023-08-12,09:48,1,3,4
2,2023-08-12T09:49:00+10:00,2023-08-12,09:49,0,1,1
2,2023-08-12T09:52:00+10:00,2023-08-12,09:52,4,4,8
7,2023-08-12T09:42:00+10:00,2023-08-12,09:42,1,1,2
7,2023-08-12T09:44:00+10:00,2023-08-12,09:44,0,2,2
7,2023-08-12T09:45:00+10:00,2023-08-12,09:45,1,0,1
7,2023-08-12T09:46:00+10:00,2023-08-12,09:46,0,1,1
7,2023-08-12T09:47:00+10:00,2023-08-12,09:47,0,1,1
7,2023-08-12T09:49:00+10:00,2023-08-12,09:49,0,2,2
9,2023-08-12T09:40:00+10:00,2023-08-12,09:40,3,1,4
9,2023-08-12T09:42:00+10:00,2023-08-12,09:42,1,0,1
9,2023-08-12T09:50:00+10:00,2023-08-12,09:50,0,1,1
9,2023-08-12T09:51:00+10:00,2023-08-12,09:51,0,2,2
9,2023-08-12T09:52:00+10:00,2023-08-12,09:52,0,1,1
10,2023-08-12T09:43:00+10:00,2023-08-12,09:43,1,3,4
10,2023-08-12T09:44:00+10:00,2023-08-12,09:44,2,1,3
10,2023-08-12T09:49:00+10:00,2023-08-12,09:49,0,2,2
10,2023-08-12T09:51:00+10:00,2023-08-12,09:51,1,0,1
10,2023-08-12T09:52:00+10:00,2023-08-12,09:52,0,1,1
10,2023-08-12T09:54:00+10:00,2023-08-12,09:54,4,2,6
11,2023-08-12T09:51:00+10:00,2023-08-12,09:51,0,2,2
12,2023-08-12T09:43:00+10:00,2023-08-12,09:43,1,3,4
12,2023-08-12T09:44:00+10:00,2023-08-12,09:44,5,2,7
12,2023-08-12T09:47:00+10:00,2023-08-12,09:47,0,4,4
12,2023-08-12T09:51:00+10:00,2023-08-12,09:51,2,2,4
12,2023-08-12T09:52:00+10:00,2023-08-12,09:52,1,0,1
12,2023-08-12T09:53:00+10:00,2023-08-12,09:53,3,0,3
17,2023-08-12T09:44:00+10:00,2023-08-12,09:44,1,5,6
17,2023-08-12T09:52:00+10:00,2023-08-12,09:52,2,2,4
17,2023-08-12T09:53:00+10:00,2023-08-12,09:53,3,4,7
18,2023-08-12T09:44:00+10:00,2023-08-12,09:44,2,0,2
18,2023-08-12T09:46:00+10:00,2023-08-12,09:46,2,1,3
18,2023-08-12T09:50:00+10:00,2023-08-12,09:50,1,0,1
18,2023-08-12T09:52:00+10:00,2023-08-12,09:52,1,0,1
24,2023-08-12T09:40:00+10:00,2023-08-12,09:40,5,7,12
24,2023-08-12T09:43:00+10:00,2023-08-12,09:43,7,10,17
24,2023-08-12T09:46:00+10:00,2023-08-12,09:46,7,16,23
24,2023-08-12T09:48:00+10:00,2023-08-12,09:48,4,0,4
24,2023-08-12T09:52:00+10:00,2023-08-12,09:52,6,5,11
24,2023-08-12T09:53:00+10:00,2023-08-12,09:53,2,1,3
27,2023-08-12T09:47:00+10:00,2023-08-12,09:47,2,3,5
27,2023-08-12T09:48:00+10:00,2023-08-12,09:48,1,2,3
27,2023-08-12T09:50:00+10:00,2023-08-12,09:50,3,1,4
27,2023-08-12T09:51:00+10:00,2023-08-12,09:51,6,9,15
27,2023-08-12T09:53:00+10:00,2023-08-12,09:53,0,3,3
35,2023-08-12T09:42:00+10:00,2023-08-12,09:42,13,6,19
35,2023-08-12T09:46:00+10:00,2023-08-12,09:46,8,5,13
53,2023-08-12T09:45:00+10:00,2023-08-12,09:45,5,3,8
53,2023-08-12T09:48:00+10:00,2023-08-12,09:48,5,4,9
53,2023-08-12T09:49:00+10:00,2023-08-12,09:49,5,0,5
53,2023-08-12T09:54:00+10:00,2023-08-12,09:54,10,3,13
56,2023-08-12T09:40:00+10:00,2023-08-12,09:40,4,1,5
56,2023-08-12T09:47:00+10:00,2023-08-12,09:47,0,3,3
56,2023-08-12T09:51:00+10:00,2023-08-12,09:51,0,1,1
57,2023-08-12T09:50:00+10:00,2023-08-12,09:50,1,1,2
57,2023-08-12T09:52:00+10:00,2023-08-12,09:52,0,4,4
57,2023-08-12T09:54:00+10:00,2023-08-12,09:54,2,2,4
58,2023-08-12T09:42:00+10:00,2023-08-12,09:42,9,1,10
58,2023-08-12T09:48:00+10:00,2023-08-12,09:48,3,9,12
58,2023-08-12T09:49:00+10:00,2023-08-12,09:49,6,2,8
58,2023-08-12T09:54:00+10:00,2023-08-12,09:54,9,2,11
62,2023-08-12T09:43:00+10:00,2023-08-12,09:43,1,3,4
62,2023-08-12T09:45:00+10:00,2023-08-12,09:45,0,2,2
62,2023-08-12T09:47:00+10:00,2023-08-12,09:47,4,0,4
62,2023-08-12T09:49:00+10:00,2023-08-12,09:49,0,6,6
62,2023-08-12T09:53:00+10:00,2023-08-12,09:53,1,3,4
63,2023-08-12T09:41:00+10:00,2023-08-12,09:41,0,2,2
63,2023-08-12T09:42:00+10:00,2023-08-12,09:42,2,4,6
63,2023-08-12T09:50:00+10:00,2023-08-12,09:50,5,4,9
63,2023-08-12T09:51:00+10:00,2023-08-12,09:51,1,6,7
63,2023-08-12T09:53:00+10:00,2023-08-12,09:53,1,3,4
67,2023-08-12T09:43:00+10:00,2023-08-12,09:43,5,7,12
67,2023-08-12T09:47:00+10:00,2023-08-12,09:47,3,7,10
67,2023-08-12T09:54:00+10:00,2023-08-12,09:54,7,15,22
68,2023-08-12T09:40:00+10:00,2023-08-12,09:40,2,7,9
68,2023-08-12T09:41:00+10:00,2023-08-12,09:41,2,1,3
68,2023-08-12T09:42:00+10:00,2023-08-12,09:42,1,2,3
68,2023-08-12T09:43:00+10:00,2023-08-12,09:43,0,2,2
68,2023-08-12T09:44:00+10:00,2023-08-12,09:44,2,1,3
68,2023-08-12T09:45:00+10:00,2023-08-12,09:45,2,1,3
68,2023-08-12T09:49:00+10:00,2023-08-12,09:49,6,2,8
68,2023-08-12T09:51:00+10:00,2023-08-12,09:51,0,2,2
72,2023-08-12T09:45:00+10:00,2023-08-12,09:45,2,0,2
72,2023-08-12T09:49:00+10:00,2023-08-12,09:49,1,2,3
72,2023-08-12T09:51:00+10:00,2023-08-12,09:51,2,6,8
72,2023-08-12T09:54:00+10:00,2023-08-12,09:54,2,0,2
76,2023-08-12T09:43:00+10:00,2023-08-12,09:43,2,0,2
76,2023-08-12T09:44:00+10:00,2023-08-12,09:44,1,3,4
76,2023-08-12T09:49:00+10:00,2023-08-12,09:49,1,0,1
76,2023-08-12T09:51:00+10:00,2023-08-12,09:51,3,1,4
76,2023-08-12T09:52:00+10:00,2023-08-12,09:52,1,0,1
76,2023-08-12T09:54:00+10:00,2023-08-12,09:54,3,0,3
79,2023-08-12T09:43:00+10:00,2023-08-12,09:43,2,3,5
79,2023-08-12T09:45:00+10:00,2023-08-12,09:45,4,2,6
79,2023-08-12T09:48:00+10:00,2023-08-12,09:48,19,2,21
79,2023-08-12T09:53:00+10:00,2023-08-12,09:53,3,8,11
85,2023-08-12T09:45:00+10:00,2023-08-12,09:45,0,1,1
85,2023-08-12T09:47:00+10:00,2023-08-12,09:47,2,1,3
85,2023-08-12T09:50:00+10:00,2023-08-12,09:50,1,0,1
85,2023-08-12T09:54:00+10:00,2023-08-12,09:54,1,1,2
86,2023-08-12T09:43:00+10:00,2023-08-12,09:43,0,2,2
86,2023-08-12T09:45:00+10:00,2023-08-12,09:45,0,3,3
86,2023-08-12T09:50:00+10:00,2023-08-12,09:50,0,1,1
86,2023-08-12T09:53:00+10:00,2023-08-12,09:53,1,0,1
109,2023-08-12T09:45:00+10:00,2023-08-12,09:45,5,25,30
109,2023-08-12T09:50:00+10:00,2023-08-12,09:50,8,10,18
117,2023-08-12T09:50:00+10:00,2023-08-12,09:50,13,7,20
122,2023-08-12T09:44:00+10:00,2023-08-12,09:44,0,1,1
122,2023-08-12T09:47:00+10:00,2023-08-12,09:47,1,0,1
122,2023-08-12T09:52:00+10:00,2023-08-12,09:52,0,1,1
122,2023-08-12T09:53:00+10:00,2023-08-12,09:53,0,1,1
122,2023-08-12T09:54:00+10:00,2023-08-12,09:54,1,1,2
39,2023-08-12T10:15:00+10:00,2023-08-12,10:15,1,2,3
39,2023-08-12T10:18:00+10:00,2023-08-12,10:18,5,1,6
39,2023-08-12T10:19:00+10:00,2023-08-12,10:19,0,2,2
39,2023-08-12T10:23:00+10:00,2023-08-12,10:23,4,0,4
39,2023-08-12T10:25:00+10:00,2023-08-12,10:25,3,0,3
39,2023-08-12T10:28:00+10:00,2023-08-12,10:28,3,2,5
39,2023-08-12T10:33:00+10:00,2023-08-12,10:33,1,3,4
39,2023-08-12T10:34:00+10:00,2023-08-12,10:34,0,2,2
39,2023-08-12T10:37:00+10:00,2023-08-12,10:37,0,3,3
39,2023-08-12T10:39:00+10:00,2023-08-12,10:39,1,2,3
39,2023-08-12T10:45:00+10:00,2023-08-12,10:45,0,1,1
39,2023-08-12T10:46:00+10:00,2023-08-12,10:46,2,1,3
39,2023-08-12T10:54:00+10:00,2023-08-12,10:54,1,0,1
39,2023-08-12T10:55:00+10:00,2023-08-12,10:55,2,4,6
41,2023-08-12T09:55:00+10:00,2023-08-12,09:55,16,4,20
41,2023-08-12T09:56:00+10:00,2023-08-12,09:56,18,3,21
41,2023-08-12T09:57:00+10:00,2023-08-12,09:57,16,12,28
41,2023-08-12T09:59:00+10:00,2023-08-12,09:59,16,13,29
41,2023-08-12T10:00:00+10:00,2023-08-12,10:00,17,6,23
41,2023-08-12T10:03:00+10:00,2023-08-12,10:03,14,13,27
41,2023-08-12T10:04:00+10:00,2023-08-12,10:04,21,16,37
41,2023-08-12T10:10:00+10:00,2023-08-12,10:10,16,13,29
41,2023-08-12T10:11:00+10:00,2023-08-12,10:11,13,9,22
41,2023-08-12T10:12:00+10:00,2023-08-12,10:12,48,4,52
41,2023-08-12T10:13:00+10:00,2023-08-12,10:13,38,9,47
41,2023-08-12T10:17:00+10:00,2023-08-12,10:17,8,18,26
41,2023-08-12T10:18:00+10:00,2023-08-12,10:18,23,11,34
41,2023-08-12T10:19:00+10:00,2023-08-12,10:19,18,15,33
41,2023-08-12T10:24:00+10:00,2023-08-12,10:24,7,2,9
41,2023-08-12T10:28:00+10:00,2023-08-12,10:28,34,8,42
41,2023-08-12T10:35:00+10:00,2023-08-12,10:35,19,15,34
41,2023-08-12T10:38:00+10:00,2023-08-12,10:38,35,10,45
41,2023-08-12T10:40:00+10:00,2023-08-12,10:40,21,7,28
41,2023-08-12T10:43:00+10:00,2023-08-12,10:43,30,6,36
41,2023-08-12T10:44:00+10:00,2023-08-12,10:44,5,11,16
41,2023-08-12T10:46:00+10:00,2023-08-12,10:46,19,13,32
41,2023-08-12T10:48:00+10:00,2023-08-12,10:48,9,16,25
41,2023-08-12T10:52:00+10:00,2023-08-12,10:52,24,17,41
41,2023-08-12T10:54:00+10:00,2023-08-12,10:54,39,10,49
54,2023-08-12T09:56:00+10:00,2023-08-12,09:56,2,0,2
54,2023-08-12T09:57:00+10:00,2023-08-12,09:57,1,0,1
54,2023-08-12T09:59:00+10:00,2023-08-12,09:59,0,1,1
54,2023-08-12T10:07:00+10:00,2023-08-12,10:07,1,1,2
54,2023-08-12T10:10:00+10:00,2023-08-12,10:10,3,1,4
54,2023-08-12T10:16:00+10:00,2023-08-12,10:16,5,0,5
54,2023-08-12T10:17:00+10:00,2023-08-12,10:17,0,6,6
54,2023-08-12T10:23:00+10:00,2023-08-12,10:23,1,4,5
54,2023-08-12T10:25:00+10:00,2023-08-12,10:25,3,0,3
54,2023-08-12T10:28:00+10:00,2023-08-12,10:28,2,0,2
54,2023-08-12T10:29:00+10:00,2023-08-12,10:29,0,1,1
54,2023-08-12T10:31:00+10:00,2023-08-12,10:31,1,1,2
54,2023-08-12T10:34:00+10:00,2023-08-12,10:34,0,1,1
54,2023-08-12T10:38:00+10:00,2023-08-12,10:38,1,1,2
54,2023-08-12T10:39:00+10:00,2023-08-12,10:39,0,2,2
54,2023-08-12T10:40:00+10:00,2023-08-12,10:40,4,0,4
54,2023-08-12T10:46:00+10:00,2023-08-12,10:46,6,0,6
54,2023-08-12T10:48:00+10:00,2023-08-12,10:48,4,0,4
54,2023-08-12T10:52:00+10:00,2023-08-12,10:52,1,1,2
54,2023-08-12T10:55:00+10:00,2023-08-12,10:55,3,0,3
55,2023-08-12T10:00:00+10:00,2023-08-12,10:00,9,4,13
55,2023-08-12T10:07:00+10:00,2023-08-12,10:07,0,19,19
55,2023-08-12T10:09:00+10:00,2023-08-12,10:09,2,11,13
55,2023-08-12T10:13:00+10:00,2023-08-12,10:13,3,8,11
55,2023-08-12T10:15:00+10:00,2023-08-12,10:15,10,6,16
55,2023-08-12T10:22:00+10:00,2023-08-12,10:22,1,12,13
55,2023-08-12T10:23:00+10:00,2023-08-12,10:23,6,11,17
55,2023-08-12T10:24:00+10:00,2023-08-12,10:24,6,9,15
55,2023-08-12T10:26:00+10:00,2023-08-12,10:26,9,19,28
55,2023-08-12T10:28:00+10:00,2023-08-12,10:28,3,10,13
55,2023-08-12T10:33:00+10:00,2023-08-12,10:33,2,14,16
55,2023-08-12T10:34:00+10:00,2023-08-12,10:34,14,6,20
55,2023-08-12T10:36:00+10:00,2023-08-12,10:36,4,22,26
55,2023-08-12T10:40:00+10:00,2023-08-12,10:40,4,8,12
55,2023-08-12T10:44:00+10:00,2023-08-12,10:44,2,14,16
55,2023-08-12T10:47:00+10:00,2023-08-12,10:47,3,15,18
55,2023-08-12T10:49:00+10:00,2023-08-12,10:49,11,11,22
55,2023-08-12T10:54:00+10:00,2023-08-12,10:54,11,7,18
59,2023-08-12T09:55:00+10:00,2023-08-12,09:55,19,30,49
59,2023-08-12T10:05:00+10:00,2023-08-12,10:05,14,17,31
59,2023-08-12T10:15:00+10:00,2023-08-12,10:15,34,16,50
59,2023-08-12T10:25:00+10:00,2023-08-12,10:25,28,24,52
59,2023-08-12T10:35:00+10:00,2023-08-12,10:35,22,14,36
59,2023-08-12T10:45:00+10:00,2023-08-12,10:45,22,41,63
61,2023-08-12T09:55:00+10:00,2023-08-12,09:55,2,6,8
61,2023-08-12T09:56:00+10:00,2023-08-12,09:56,3,0,3
61,2023-08-12T09:59:00+10:00,2023-08-12,09:59,4,4,8
61,2023-08-12T10:03:00+10:00,2023-08-12,10:03,6,1,7
61,2023-08-12T10:05:00+10:00,2023-08-12,10:05,3,5,8
61,2023-08-12T10:12:00+10:00,2023-08-12,10:12,0,6,6
61,2023-08-12T10:14:00+10:00,2023-08-12,10:14,6,4,10
61,2023-08-12T10:16:00+10:00,2023-08-12,10:16,0,2,2
61,2023-08-12T10:17:00+10:00,2023-08-12,10:17,0,9,9
61,2023-08-12T10:28:00+10:00,2023-08-12,10:28,1,2,3
61,2023-08-12T10:31:00+10:00,2023-08-12,10:31,2,15,17
61,2023-08-12T10:35:00+10:00,2023-08-12,10:35,2,10,12
61,2023-08-12T10:41:00+10:00,2023-08-12,10:41,1,7,8
61,2023-08-12T10:47:00+10:00,2023-08-12,10:47,4,12,16
61,2023-08-12T10:48:00+10:00,2023-08-12,10:48,3,8,11
61,2023-08-12T10:49:00+10:00,2023-08-12,10:49,3,9,12
61,2023-08-12T10:51:00+10:00,2023-08-12,10:51,0,6,6
61,2023-08-12T10:55:00+10:00,2023-08-12,10:55,1,2,3
65,2023-08-12T09:55:00+10:00,2023-08-12,09:55,0,3,3
65,2023-08-12T09:56:00+10:00,2023-08-12,09:56,1,1,2
65,2023-08-12T09:58:00+10:00,2023-08-12,09:58,2,4,6
65,2023-08-12T10:02:00+10:00,2023-08-12,10:02,1,7,8
65,2023-08-12T10:03:00+10:00,2023-08-12,10:03,3,4,7
65,2023-08-12T10:07:00+10:00,2023-08-12,10:07,6,3,9
65,2023-08-12T10:12:00+10:00,2023-08-12,10:12,5,0,5
65,2023-08-12T10:13:00+10:00,2023-08-12,10:13,5,0,5
65,2023-08-12T10:15:00+10:00,2023-08-12,10:15,2,4,6
65,2023-08-12T10:16:00+10:00,2023-08-12,10:16,6,7,13
65,2023-08-12T10:21:00+10:00,2023-08-12,10:21,1,3,4
65,2023-08-12T10:23:00+10:00,2023-08-12,10:23,2,10,12
65,2023-08-12T10:24:00+10:00,2023-08-12,10:24,3,6,9
65,2023-08-12T10:25:00+10:00,2023-08-12,10:25,5,6,11
65,2023-08-12T10:27:00+10:00,2023-08-12,10:27,0,7,7
65,2023-08-12T10:29:00+10:00,2023-08-12,10:29,6,5,11
65,2023-08-12T10:35:00+10:00,2023-08-12,10:35,3,6,9
65,2023-08-12T10:36:00+10:00,2023-08-12,10:36,0,5,5
65,2023-08-12T10:38:00+10:00,2023-08-12,10:38,9,5,14
65,2023-08-12T10:41:00+10:00,2023-08-12,10:41,0,2,2
65,2023-08-12T10:43:00+10:00,2023-08-12,10:43,7,3,10
65,2023-08-12T10:44:00+10:00,2023-08-12,10:44,6,3,9
66,2023-08-12T09:57:00+10:00,2023-08-12,09:57,2,4,6
66,2023-08-12T10:00:00+10:00,2023-08-12,10:00,7,4,11
66,2023-08-12T10:01:00+10:00,2023-08-12,10:01,5,16,21
66,2023-08-12T10:03:00+10:00,2023-08-12,10:03,3,8,11
66,2023-08-12T10:04:00+10:00,2023-08-12,10:04,2,8,10
66,2023-08-12T10:06:00+10:00,2023-08-12,10:06,14,6,20
66,2023-08-12T10:07:00+10:00,2023-08-12,10:07,5,3,8
66,2023-08-12T10:12:00+10:00,2023-08-12,10:12,5,2,7
66,2023-08-12T10:13:00+10:00,2023-08-12,10:13,2,2,4
66,2023-08-12T10:16:00+10:00,2023-08-12,10:16,5,10,15
66,2023-08-12T10:18:00+10:00,2023-08-12,10:18,7,5,12
66,2023-08-12T10:19:00+10:00,2023-08-12,10:19,14,6,20
66,2023-08-12T10:25:00+10:00,2023-08-12,10:25,9,6,15
66,2023-08-12T10:27:00+10:00,2023-08-12,10:27,6,7,13
66,2023-08-12T10:28:00+10:00,2023-08-12,10:28,7,8,15
66,2023-08-12T10:30:00+10:00,2023-08-12,10:30,7,6,13
66,2023-08-12T10:32:00+10:00,2023-08-12,10:32,6,7,13
66,2023-08-12T10:34:00+10:00,2023-08-12,10:34,4,7,11
66,2023-08-12T10:35:00+10:00,2023-08-12,10:35,12,14,26
66,2023-08-12T10:41:00+10:00,2023-08-12,10:41,4,8,12
66,2023-08-12T10:46:00+10:00,2023-08-12,10:46,12,3,15
66,2023-08-12T10:47:00+10:00,2023-08-12,10:47,11,9,20
66,2023-08-12T10:49:00+10:00,2023-08-12,10:49,9,2,11
66,2023-08-12T10:50:00+10:00,2023-08-12,10:50,11,22,33
66,2023-08-12T10:52:00+10:00,2023-08-12,10:52,5,4,9
69,2023-08-12T09:55:00+10:00,2023-08-12,09:55,0,3,3
69,2023-08-12T09:58:00+10:00,2023-08-12,09:58,1,0,1
69,2023-08-12T10:01:00+10:00,2023-08-12,10:01,4,1,5
69,2023-08-12T10:05:00+10:00,2023-08-12,10:05,4,0,4
69,2023-08-12T10:08:00+10:00,2023-08-12,10:08,5,2,7
69,2023-08-12T10:09:00+10:00,2023-08-12,10:09,1,1,2
69,2023-08-12T10:15:00+10:00,2023-08-12,10:15,0,4,4
69,2023-08-12T10:16:00+10:00,2023-08-12,10:16,3,1,4
69,2023-08-12T10:17:00+10:00,2023-08-12,10:17,1,1,2
69,2023-08-12T10:18:00+10:00,2023-08-12,10:18,4,2,6
69,2023-08-12T10:21:00+10:00,2023-08-12,10:21,3,1,4
69,2023-08-12T10:22:00+10:00,2023-08-12,10:22,10,0,10
69,2023-08-12T10:28:00+10:00,2023-08-12,10:28,8,1,9
69,2023-08-12T10:29:00+10:00,2023-08-12,10:29,11,0,11
69,2023-08-12T10:32:00+10:00,2023-08-12,10:32,3,4,7
69,2023-08-12T10:33:00+10:00,2023-08-12,10:33,2,17,19
69,2023-08-12T10:35:00+10:00,2023-08-12,10:35,3,2,5
69,2023-08-12T10:38:00+10:00,2023-08-12,10:38,3,1,4
69,2023-08-12T10:45:00+10:00,2023-08-12,10:45,5,3,8
69,2023-08-12T10:46:00+10:00,2023-08-12,10:46,6,1,7
69,2023-08-12T10:47:00+10:00,2023-08-12,10:47,5,0,5
69,2023-08-12T10:51:00+10:00,2023-08-12,10:51,7,6,13
69,2023-08-12T10:52:00+10:00,2023-08-12,10:52,1,0,1
69,2023-08-12T10:53:00+10:00,2023-08-12,10:53,2,1,3
69,2023-08-12T10:54:00+10:00,2023-08-12,10:54,4,3,7
70,2023-08-12T09:58:00+10:00,2023-08-12,09:58,1,2,3
70,2023-08-12T10:02:00+10:00,2023-08-12,10:02,2,1,3
70,2023-08-12T10:09:00+10:00,2023-08-12,10:09,1,6,7
70,2023-08-12T10:13:00+10:00,2023-08-12,10:13,3,4,7
70,2023-08-12T10:16:00+10:00,2023-08-12,10:16,1,0,1
70,2023-08-12T10:20:00+10:00,2023-08-12,10:20,2,6,8
70,2023-08-12T10:24:00+10:00,2023-08-12,10:24,0,2,2
70,2023-08-12T10:25:00+10:00,2023-08-12,10:25,1,2,3
70,2023-08-12T10:31:00+10:00,2023-08-12,10:31,2,3,5
70,2023-08-12T10:34:00+10:00,2023-08-12,10:34,6,2,8
70,2023-08-12T10:36:00+10:00,2023-08-12,10:36,2,7,9
70,2023-08-12T10:37:00+10:00,2023-08-12,10:37,7,7,14
70,2023-08-12T10:42:00+10:00,2023-08-12,10:42,7,2,9
70,2023-08-12T10:45:00+10:00,2023-08-12,10:45,2,1,3
70,2023-08-12T10:51:00+10:00,2023-08-12,10:51,2,3,5
70,2023-08-12T10:53:00+10:00,2023-08-12,10:53,1,3,4
71,2023-08-12T09:59:00+10:00,2023-08-12,09:59,0,1,1
71,2023-08-12T10:08:00+10:00,2023-08-12,10:08,1,0,1
71,2023-08-12T10:42:00+10:00,2023-08-12,10:42,0,1,1
71,2023-08-12T10:45:00+10:00,2023-08-12,10:45,1,0,1
75,2023-08-12T09:55:00+10:00,2023-08-12,09:55,0,2,2
75,2023-08-12T09:58:00+10:00,2023-08-12,09:58,0,3,3
75,2023-08-12T10:01:00+10:00,2023-08-12,10:01,4,0,4
75,2023-08-12T10:10:00+10:00,2023-08-12,10:10,2,0,2
75,2023-08-12T10:11:00+10:00,2023-08-12,10:11,0,1,1
75,2023-08-12T10:21:00+10:00,2023-08-12,10:21,9,0,9
75,2023-08-12T10:25:00+10:00,2023-08-12,10:25,0,1,1
75,2023-08-12T10:28:00+10:00,2023-08-12,10:28,3,0,3
75,2023-08-12T10:30:00+10:00,2023-08-12,10:30,7,0,7
75,2023-08-12T10:37:00+10:00,2023-08-12,10:37,1,0,1
75,2023-08-12T10:38:00+10:00,2023-08-12,10:38,2,1,3
75,2023-08-12T10:39:00+10:00,2023-08-12,10:39,1,0,1
75,2023-08-12T10:40:00+10:00,2023-08-12,10:40,1,0,1
75,2023-08-12T10:44:00+10:00,2023-08-12,10:44,5,0,5
75,2023-08-12T10:48:00+10:00,2023-08-12,10:48,1,0,1
75,2023-08-12T10:51:00+10:00,2023-08-12,10:51,1,2,3
75,2023-08-12T10:55:00+10:00,2023-08-12,10:55,2,0,2
77,2023-08-12T09:56:00+10:00,2023-08-12,09:56,3,2,5
77,2023-08-12T09:57:00+10:00,2023-08-12,09:57,0,1,1
77,2023-08-12T10:03:00+10:00,2023-08-12,10:03,1,1,2
77,2023-08-12T10:04:00+10:00,2023-08-12,10:04,2,2,4
77,2023-08-12T10:06:00+10:00,2023-08-12,10:06,2,2,4
77,2023-08-12T10:07:00+10:00,2023-08-12,10:07,0,3,3
77,2023-08-12T10:11:00+10:00,2023-08-12,10:11,1,3,4
77,2023-08-12T10:13:00+10:00,2023-08-12,10:13,11,0,11
77,2023-08-12T10:14:00+10:00,2023-08-12,10:14,7,1,8
77,2023-08-12T10:15:00+10:00,2023-08-12,10:15,1,0,1
77,2023-08-12T10:17:00+10:00,2023-08-12,10:17,0,2,2
77,2023-08-12T10:18:00+10:00,2023-08-12,10:18,1,0,1
77,2023-08-12T10:19:00+10:00,2023-08-12,10:19,6,2,8
77,2023-08-12T10:22:00+10:00,2023-08-12,10:22,0,6,6
77,2023-08-12T10:25:00+10:00,2023-08-12,10:25,3,0,3
77,2023-08-12T10:27:00+10:00,2023-08-12,10:27,3,2,5
77,2023-08-12T10:29:00+10:00,2023-08-12,10:29,2,2,4
77,2023-08-12T10:31:00+10:00,2023-08-12,10:31,0,4,4
77,2023-08-12T10:32:00+10:00,2023-08-12,10:32,3,0,3
77,2023-08-12T10:34:00+10:00,2023-08-12,10:34,0,2,2
77,2023-08-12T10:39:00+10:00,2023-08-12,10:39,1,1,2
77,2023-08-12T10:40:00+10:00,2023-08-12,10:40,5,1,6
77,2023-08-12T10:45:00+10:00,2023-08-12,10:45,13,5,18
77,2023-08-12T10:47:00+10:00,2023-08-12,10:47,4,1,5
77,2023-08-12T10:50:00+10:00,2023-08-12,10:50,5,4,9
77,2023-08-12T10:51:00+10:00,2023-08-12,10:51,1,0,1
77,2023-08-12T10:52:00+10:00,2023-08-12,10:52,3,4,7
77,2023-08-12T10:54:00+10:00,2023-08-12,10:54,3,0,3
77,2023-08-12T10:55:00+10:00,2023-08-12,10:55,6,0,6
78,2023-08-12T10:00:00+10:00,2023-08-12,10:00,0,1,1
78,2023-08-12T10:02:00+10:00,2023-08-12,10:02,1,1,2
78,2023-08-12T10:03:00+10:00,2023-08-12,10:03,1,0,1
78,2023-08-12T10:10:00+10:00,2023-08-12,10:10,0,1,1
78,2023-08-12T10:18:00+10:00,2023-08-12,10:18,0,1,1
78,2023-08-12T10:19:00+10:00,2023-08-12,10:19,0,2,2
78,2023-08-12T10:22:00+10:00,2023-08-12,10:22,2,0,2
78,2023-08-12T10:30:00+10:00,2023-08-12,10:30,0,1,1
78,2023-08-12T10:36:00+10:00,2023-08-12,10:36,0,1,1
78,2023-08-12T10:43:00+10:00,2023-08-12,10:43,0,1,1
78,2023-08-12T10:45:00+10:00,2023-08-12,10:45,0,3,3
78,2023-08-12T10:47:00+10:00,2023-08-12,10:47,0,1,1
78,2023-08-12T10:50:00+10:00,2023-08-12,10:50,0,3,3
84,2023-08-12T09:55:00+10:00,2023-08-12,09:55,65,26,91
84,2023-08-12T10:00:00+10:00,2023-08-12,10:00,44,42,86
84,2023-08-12T10:25:00+10:00,2023-08-12,10:25,86,55,141
84,2023-08-12T10:40:00+10:00,2023-08-12,10:40,82,51,133
84,2023-08-12T10:45:00+10:00,2023-08-12,10:45,83,43,126
84,2023-08-12T10:55:00+10:00,2023-08-12,10:55,66,50,116
87,2023-08-12T09:55:00+10:00,2023-08-12,09:55,3,3,6
87,2023-08-12T09:57:00+10:00,2023-08-12,09:57,2,4,6
87,2023-08-12T10:01:00+10:00,2023-08-12,10:01,0,4,4
87,2023-08-12T10:02:00+10:00,2023-08-12,10:02,2,1,3
87,2023-08-12T10:08:00+10:00,2023-08-12,10:08,2,2,4
87,2023-08-12T10:12:00+10:00,2023-08-12,10:12,1,2,3
87,2023-08-12T10:19:00+10:00,2023-08-12,10:19,2,4,6
87,2023-08-12T10:22:00+10:00,2023-08-12,10:22,0,2,2
87,2023-08-12T10:30:00+10:00,2023-08-12,10:30,2,1,3
87,2023-08-12T10:31:00+10:00,2023-08-12,10:31,1,1,2
87,2023-08-12T10:38:00+10:00,2023-08-12,10:38,3,1,4
87,2023-08-12T10:41:00+10:00,2023-08-12,10:41,3,1,4
87,2023-08-12T10:43:00+10:00,2023-08-12,10:43,3,10,13
87,2023-08-12T10:44:00+10:00,2023-08-12,10:44,0,4,4
87,2023-08-12T10:46:00+10:00,2023-08-12,10:46,3,2,5
87,2023-08-12T10:54:00+10:00,2023-08-12,10:54,4,4,8
107,2023-08-12T10:15:00+10:00,2023-08-12,10:15,1,12,13
107,2023-08-12T10:30:00+10:00,2023-08-12,10:30,5,5,10
107,2023-08-12T10:35:00+10:00,2023-08-12,10:35,3,13,16
107,2023-08-12T10:40:00+10:00,2023-08-12,10:40,4,12,16
107,2023-08-12T10:50:00+10:00,2023-08-12,10:50,6,9,15
108,2023-08-12T09:55:00+10:00,2023-08-12,09:55,8,0,8
108,2023-08-12T09:57:00+10:00,2023-08-12,09:57,3,4,7
108,2023-08-12T10:03:00+10:00,2023-08-12,10:03,2,2,4
108,2023-08-12T10:04:00+10:00,2023-08-12,10:04,1,1,2
108,2023-08-12T10:13:00+10:00,2023-08-12,10:13,1,1,2
108,2023-08-12T10:14:00+10:00,2023-08-12,10:14,3,1,4
108,2023-08-12T10:18:00+10:00,2023-08-12,10:18,0,4,4
108,2023-08-12T10:19:00+10:00,2023-08-12,10:19,5,0,5
108,2023-08-12T10:20:00+10:00,2023-08-12,10:20,2,1,3
108,2023-08-12T10:23:00+10:00,2023-08-12,10:23,1,2,3
108,2023-08-12T10:26:00+10:00,2023-08-12,10:26,4,1,5
108,2023-08-12T10:27:00+10:00,2023-08-12,10:27,2,7,9
108,2023-08-12T10:35:00+10:00,2023-08-12,10:35,0,3,3
108,2023-08-12T10:37:00+10:00,2023-08-12,10:37,0,4,4
108,2023-08-12T10:45:00+10:00,2023-08-12,10:45,1,3,4
108,2023-08-12T10:46:00+10:00,2023-08-12,10:46,1,2,3
108,2023-08-12T10:47:00+10:00,2023-08-12,10:47,4,0,4
108,2023-08-12T10:49:00+10:00,2023-08-12,10:49,1,0,1
108,2023-08-12T10:54:00+10:00,2023-08-12,10:54,5,1,6
108,2023-08-12T10:55:00+10:00,2023-08-12,10:55,3,0,3
118,2023-08-12T10:05:00+10:00,2023-08-12,10:05,0,1,1
118,2023-08-12T10:15:00+10:00,2023-08-12,10:15,6,3,9
118,2023-08-12T10:30:00+10:00,2023-08-12,10:30,0,2,2
118,2023-08-12T10:40:00+10:00,2023-08-12,10:40,1,1,2
118,2023-08-12T10:50:00+10:00,2023-08-12,10:50,3,0,3
1,2023-08-12T09:57:00+10:00,2023-08-12,09:57,16,10,26
1,2023-08-12T09:59:00+10:00,2023-08-12,09:59,4,5,9
1,2023-08-12T10:01:00+10:00,2023-08-12,10:01,1,6,7
1,2023-08-12T10:02:00+10:00,2023-08-12,10:02,4,8,12
1,2023-08-12T10:08:00+10:00,2023-08-12,10:08,10,13,23
1,2023-08-12T10:09:00+10:00,2023-08-12,10:09,1,10,11
1,2023-08-12T10:10:00+10:00,2023-08-12,10:10,9,8,17
1,2023-08-12T10:14:00+10:00,2023-08-12,10:14,7,9,16
1,2023-08-12T10:17:00+10:00,2023-08-12,10:17,11,8,19
1,2023-08-12T10:22:00+10:00,2023-08-12,10:22,5,10,15
1,2023-08-12T10:24:00+10:00,2023-08-12,10:24,11,5,16
1,2023-08-12T10:28:00+10:00,2023-08-12,10:28,10,14,24
1,2023-08-12T10:29:00+10:00,2023-08-12,10:29,12,9,21
1,2023-08-12T10:34:00+10:00,2023-08-12,10:34,9,4,13
1,2023-08-12T10:36:00+10:00,2023-08-12,10:36,6,14,20
1,2023-08-12T10:37:00+10:00,2023-08-12,10:37,9,11,20
1,2023-08-12T10:38:00+10:00,2023-08-12,10:38,7,9,16
1,2023-08-12T10:42:00+10:00,2023-08-12,10:42,11,12,23
1,2023-08-12T10:52:00+10:00,2023-08-12,10:52,10,10,20
1,2023-08-12T10:54:00+10:00,2023-08-12,10:54,17,17,34
2,2023-08-12T09:55:00+10:00,2023-08-12,09:55,4,8,12
2,2023-08-12T10:04:00+10:00,2023-08-12,10:04,2,1,3
2,2023-08-12T10:09:00+10:00,2023-08-12,10:09,1,7,8
2,2023-08-12T10:10:00+10:00,2023-08-12,10:10,5,5,10
2,2023-08-12T10:11:00+10:00,2023-08-12,10:11,8,6,14
2,2023-08-12T10:14:00+10:00,2023-08-12,10:14,7,6,13
2,2023-08-12T10:17:00+10:00,2023-08-12,10:17,8,10,18
2,2023-08-12T10:20:00+10:00,2023-08-12,10:20,2,7,9
2,2023-08-12T10:23:00+10:00,2023-08-12,10:23,10,7,17
2,2023-08-12T10:28:00+10:00,2023-08-12,10:28,22,2,24
2,2023-08-12T10:35:00+10:00,2023-08-12,10:35,3,8,11
2,2023-08-12T10:36:00+10:00,2023-08-12,10:36,14,6,20
2,2023-08-12T10:38:00+10:00,2023-08-12,10:38,10,8,18
2,2023-08-12T10:40:00+10:00,2023-08-12,10:40,0,12,12
2,2023-08-12T10:42:00+10:00,2023-08-12,10:42,5,4,9
2,2023-08-12T10:45:00+10:00,2023-08-12,10:45,3,7,10
2,2023-08-12T10:47:00+10:00,2023-08-12,10:47,12,3,15
7,2023-08-12T09:58:00+10:00,2023-08-12,09:58,0,2,2
7,2023-08-12T10:01:00+10:00,2023-08-12,10:01,1,1,2
7,2023-08-12T10:04:00+10:00,2023-08-12,10:04,2,1,3
7,2023-08-12T10:07:00+10:00,2023-08-12,10:07,2,2,4
7,2023-08-12T10:10:00+10:00,2023-08-12,10:10,1,1,2
7,2023-08-12T10:17:00+10:00,2023-08-12,10:17,4,2,6
7,2023-08-12T10:22:00+10:00,2023-08-12,10:22,1,3,4
7,2023-08-12T10:35:00+10:00,2023-08-12,10:35,0,1,1
7,2023-08-12T10:45:00+10:00,2023-08-12,10:45,2,0,2
7,2023-08-12T10:49:00+10:00,2023-08-12,10:49,1,1,2
9,2023-08-12T09:58:00+10:00,2023-08-12,09:58,0,2,2
9,2023-08-12T09:59:00+10:00,2023-08-12,09:59,0,1,1
9,2023-08-12T10:04:00+10:00,2023-08-12,10:04,1,0,1
9,2023-08-12T10:05:00+10:00,2023-08-12,10:05,0,4,4
9,2023-08-12T10:08:00+10:00,2023-08-12,10:08,0,2,2
9,2023-08-12T10:09:00+10:00,2023-08-12,10:09,1,4,5
9,2023-08-12T10:12:00+10:00,2023-08-12,10:12,3,0,3
9,2023-08-12T10:14:00+10:00,2023-08-12,10:14,2,0,2
9,2023-08-12T10:18:00+10:00,2023-08-12,10:18,3,1,4
9,2023-08-12T10:20:00+10:00,2023-08-12,10:20,0,1,1
9,2023-08-12T10:22:00+10:00,2023-08-12,10:22,1,1,2
9,2023-08-12T10:24:00+10:00,2023-08-12,10:24,0,1,1
9,2023-08-12T10:27:00+10:00,2023-08-12,10:27,1,0,1
9,2023-08-12T10:30:00+10:00,2023-08-12,10:30,0,1,1
9,2023-08-12T10:35:00+10:00,2023-08-12,10:35,2,0,2
9,2023-08-12T10:39:00+10:00,2023-08-12,10:39,1,5,6
9,2023-08-12T10:46:00+10:00,2023-08-12,10:46,0,4,4
9,2023-08-12T10:47:00+10:00,2023-08-12,10:47,7,3,10
9,2023-08-12T10:49:00+10:00,2023-08-12,10:49,1,11,12
9,2023-08-12T10:55:00+10:00,2023-08-12,10:55,2,2,4
10,2023-08-12T09:55:00+10:00,2023-08-12,09:55,0,2,2
10,2023-08-12T09:56:00+10:00,2023-08-12,09:56,1,0,1
10,2023-08-12T10:05:00+10:00,2023-08-12,10:05,0,3,3
10,2023-08-12T10:07:00+10:00,2023-08-12,10:07,1,0,1
10,2023-08-12T10:08:00+10:00,2023-08-12,10:08,3,1,4
10,2023-08-12T10:11:00+10:00,2023-08-12,10:11,2,2,4
10,2023-08-12T10:13:00+10:00,2023-08-12,10:13,1,0,1
10,2023-08-12T10:20:00+10:00,2023-08-12,10:20,4,0,4
10,2023-08-12T10:21:00+10:00,2023-08-12,10:21,1,0,1
10,2023-08-12T10:22:00+10:00,2023-08-12,10:22,3,0,3
10,2023-08-12T10:36:00+10:00,2023-08-12,10:36,1,0,1
10,2023-08-12T10:40:00+10:00,2023-08-12,10:40,0,2,2
10,2023-08-12T10:43:00+10:00,2023-08-12,10:43,2,0,2
10,2023-08-12T10:44:00+10:00,2023-08-12,10:44,0,2,2
10,2023-08-12T10:48:00+10:00,2023-08-12,10:48,1,2,3
10,2023-08-12T10:49:00+10:00,2023-08-12,10:49,4,1,5
10,2023-08-12T10:52:00+10:00,2023-08-12,10:52,3,3,6
11,2023-08-12T09:55:00+10:00,2023-08-12,09:55,5,2,7
11,2023-08-12T09:56:00+10:00,2023-08-12,09:56,0,1,1
11,2023-08-12T09:58:00+10:00,2023-08-12,09:58,0,2,2
11,2023-08-12T10:11:00+10:00,2023-08-12,10:11,0,1,1
11,2023-08-12T10:15:00+10:00,2023-08-12,10:15,2,0,2
11,2023-08-12T10:18:00+10:00,2023-08-12,10:18,2,0,2
11,2023-08-12T10:20:00+10:00,2023-08-12,10:20,3,3,6
11,2023-08-12T10:21:00+10:00,2023-08-12,10:21,1,2,3
11,2023-08-12T10:27:00+10:00,2023-08-12,10:27,2,0,2
11,2023-08-12T10:40:00+10:00,2023-08-12,10:40,4,3,7
11,2023-08-12T10:48:00+10:00,2023-08-12,10:48,1,0,1
12,2023-08-12T09:55:00+10:00,2023-08-12,09:55,0,1,1
12,2023-08-12T09:56:00+10:00,2023-08-12,09:56,1,5,6
12,2023-08-12T09:58:00+10:00,2023-08-12,09:58,1,1,2
12,2023-08-12T10:01:00+10:00,2023-08-12,10:01,3,2,5
12,2023-08-12T10:04:00+10:00,2023-08-12,10:04,6,1,7
12,2023-08-12T10:07:00+10:00,2023-08-12,10:07,0,1,1
12,2023-08-12T10:09:00+10:00,2023-08-12,10:09,1,5,6
12,2023-08-12T10:10:00+10:00,2023-08-12,10:10,4,4,8
12,2023-08-12T10:13:00+10:00,2023-08-12,10:13,2,3,5
12,2023-08-12T10:16:00+10:00,2023-08-12,10:16,5,5,10
12,2023-08-12T10:19:00+10:00,2023-08-12,10:19,6,2,8
12,2023-08-12T10:22:00+10:00,2023-08-12,10:22,1,2,3
12,2023-08-12T10:23:00+10:00,2023-08-12,10:23,2,4,6
12,2023-08-12T10:27:00+10:00,2023-08-12,10:27,4,6,10
12,2023-08-12T10:28:00+10:00,2023-08-12,10:28,3,1,4
12,2023-08-12T10:43:00+10:00,2023-08-12,10:43,2,3,5
12,2023-08-12T10:45:00+10:00,2023-08-12,10:45,2,0,2
12,2023-08-12T10:46:00+10:00,2023-08-12,10:46,3,1,4
12,2023-08-12T10:47:00+10:00,2023-08-12,10:47,0,4,4
12,2023-08-12T10:48:00+10:00,2023-08-12,10:48,4,6,10
12,2023-08-12T10:49:00+10:00,2023-08-12,10:49,2,0,2
12,2023-08-12T10:51:00+10:00,2023-08-12,10:51,1,5,6
17,2023-08-12T09:55:00+10:00,2023-08-12,09:55,9,0,9
17,2023-08-12T10:06:00+10:00,2023-08-12,10:06,4,0,4
17,2023-08-12T10:08:00+10:00,2023-08-12,10:08,4,5,9
17,2023-08-12T10:14:00+10:00,2023-08-12,10:14,14,0,14
17,2023-08-12T10:17:00+10:00,2023-08-12,10:17,0,2,2
17,2023-08-12T10:19:00+10:00,2023-08-12,10:19,1,4,5
17,2023-08-12T10:21:00+10:00,2023-08-12,10:21,4,1,5
17,2023-08-12T10:23:00+10:00,2023-08-12,10:23,2,4,6
17,2023-08-12T10:25:00+10:00,2023-08-12,10:25,1,4,5
17,2023-08-12T10:26:00+10:00,2023-08-12,10:26,3,3,6
17,2023-08-12T10:38:00+10:00,2023-08-12,10:38,6,0,6
17,2023-08-12T10:42:00+10:00,2023-08-12,10:42,7,0,7
17,2023-08-12T10:45:00+10:00,2023-08-12,10:45,0,4,4
17,2023-08-12T10:47:00+10:00,2023-08-12,10:47,4,4,8
17,2023-08-12T10:53:00+10:00,2023-08-12,10:53,3,4,7
17,2023-08-12T10:55:00+10:00,2023-08-12,10:55,10,2,12
18,2023-08-12T09:56:00+10:00,2023-08-12,09:56,2,1,3
18,2023-08-12T09:57:00+10:00,2023-08-12,09:57,0,1,1
18,2023-08-12T09:58:00+10:00,2023-08-12,09:58,1,2,3
18,2023-08-12T09:59:00+10:00,2023-08-12,09:59,1,1,2
18,2023-08-12T10:04:00+10:00,2023-08-12,10:04,0,2,2
18,2023-08-12T10:05:00+10:00,2023-08-12,10:05,0,1,1
18,2023-08-12T10:13:00+10:00,2023-08-12,10:13,2,1,3
18,2023-08-12T10:15:00+10:00,2023-08-12,10:15,1,4,5
18,2023-08-12T10:17:00+10:00,2023-08-12,10:17,0,2,2
18,2023-08-12T10:20:00+10:00,2023-08-12,10:20,1,0,1
18,2023-08-12T10:27:00+10:00,2023-08-12,10:27,0,2,2
18,2023-08-12T10:31:00+10:00,2023-08-12,10:31,0,2,2
18,2023-08-12T10:40:00+10:00,2023-08-12,10:40,1,1,2
18,2023-08-12T10:45:00+10:00,2023-08-12,10:45,1,1,2
18,2023-08-12T10:48:00+10:00,2023-08-12,10:48,2,0,2
18,2023-08-12T10:50:00+10:00,2023-08-12,10:50,0,4,4
18,2023-08-12T10:51:00+10:00,2023-08-12,10:51,1,0,1
18,2023-08-12T10:52:00+10:00,2023-08-12,10:52,3,0,3
18,2023-08-12T10:53:00+10:00,2023-08-12,10:53,1,0,1
24,2023-08-12T09:55:00+10:00,2023-08-12,09:55,9,2,11
24,2023-08-12T09:56:00+10:00,2023-08-12,09:56,7,3,10
24,2023-08-12T09:58:00+10:00,2023-08-12,09:58,4,2,6
24,2023-08-12T10:00:00+10:00,2023-08-12,10:00,5,10,15
24,2023-08-12T10:07:00+10:00,2023-08-12,10:07,7,7,14
24,2023-08-12T10:08:00+10:00,2023-08-12,10:08,4,11,15
24,2023-08-12T10:16:00+10:00,2023-08-12,10:16,5,4,9
24,2023-08-12T10:19:00+10:00,2023-08-12,10:19,7,4,11
24,2023-08-12T10:21:00+10:00,2023-08-12,10:21,12,6,18
24,2023-08-12T10:22:00+10:00,2023-08-12,10:22,7,1,8
24,2023-08-12T10:26:00+10:00,2023-08-12,10:26,5,1,6
24,2023-08-12T10:27:00+10:00,2023-08-12,10:27,13,4,17
24,2023-08-12T10:28:00+10:00,2023-08-12,10:28,6,2,8
24,2023-08-12T10:31:00+10:00,2023-08-12,10:31,4,5,9
24,2023-08-12T10:40:00+10:00,2023-08-12,10:40,5,5,10
24,2023-08-12T10:44:00+10:00,2023-08-12,10:44,7,2,9
24,2023-08-12T10:45:00+10:00,2023-08-12,10:45,22,1,23
24,2023-08-12T10:47:00+10:00,2023-08-12,10:47,13,11,24
24,2023-08-12T10:51:00+10:00,2023-08-12,10:51,8,3,11
24,2023-08-12T10:52:00+10:00,2023-08-12,10:52,10,4,14
24,2023-08-12T10:54:00+10:00,2023-08-12,10:54,5,5,10
27,2023-08-12T10:00:00+10:00,2023-08-12,10:00,1,4,5
27,2023-08-12T10:07:00+10:00,2023-08-12,10:07,1,2,3
27,2023-08-12T10:13:00+10:00,2023-08-12,10:13,0,3,3
27,2023-08-12T10:25:00+10:00,2023-08-12,10:25,0,3,3
27,2023-08-12T10:28:00+10:00,2023-08-12,10:28,2,0,2
27,2023-08-12T10:30:00+10:00,2023-08-12,10:30,5,1,6
27,2023-08-12T10:32:00+10:00,2023-08-12,10:32,5,4,9
27,2023-08-12T10:34:00+10:00,2023-08-12,10:34,3,2,5
27,2023-08-12T10:41:00+10:00,2023-08-12,10:41,1,1,2
27,2023-08-12T10:42:00+10:00,2023-08-12,10:42,1,6,7
27,2023-08-12T10:43:00+10:00,2023-08-12,10:43,2,0,2
27,2023-08-12T10:45:00+10:00,2023-08-12,10:45,0,7,7
27,2023-08-12T10:51:00+10:00,2023-08-12,10:51,5,0,5
27,2023-08-12T10:54:00+10:00,2023-08-12,10:54,4,5,9
35,2023-08-12T09:55:00+10:00,2023-08-12,09:55,8,9,17
35,2023-08-12T09:56:00+10:00,2023-08-12,09:56,9,4,13
35,2023-08-12T09:57:00+10:00,2023-08-12,09:57,4,10,14
35,2023-08-12T09:59:00+10:00,2023-08-12,09:59,8,3,11
35,2023-08-12T10:02:00+10:00,2023-08-12,10:02,11,4,15
35,2023-08-12T10:03:00+10:00,2023-08-12,10:03,8,7,15
35,2023-08-12T10:04:00+10:00,2023-08-12,10:04,11,5,16
35,2023-08-12T10:09:00+10:00,2023-08-12,10:09,6,7,13
35,2023-08-12T10:10:00+10:00,2023-08-12,10:10,8,8,16
35,2023-08-12T10:12:00+10:00,2023-08-12,10:12,10,7,17
35,2023-08-12T10:15:00+10:00,2023-08-12,10:15,12,5,17
35,2023-08-12T10:16:00+10:00,2023-08-12,10:16,11,5,16
35,2023-08-12T10:25:00+10:00,2023-08-12,10:25,8,10,18
35,2023-08-12T10:26:00+10:00,2023-08-12,10:26,5,7,12
35,2023-08-12T10:27:00+10:00,2023-08-12,10:27,6,6,12
35,2023-08-12T10:31:00+10:00,2023-08-12,10:31,9,5,14
35,2023-08-12T10:32:00+10:00,2023-08-12,10:32,7,3,10
35,2023-08-12T10:33:00+10:00,2023-08-12,10:33,4,17,21
35,2023-08-12T10:39:00+10:00,2023-08-12,10:39,11,7,18
35,2023-08-12T10:42:00+10:00,2023-08-12,10:42,11,8,19
35,2023-08-12T10:44:00+10:00,2023-08-12,10:44,4,6,10
35,2023-08-12T10:49:00+10:00,2023-08-12,10:49,4,13,17
35,2023-08-12T10:50:00+10:00,2023-08-12,10:50,9,11,20
53,2023-08-12T09:59:00+10:00,2023-08-12,09:59,4,9,13
53,2023-08-12T10:06:00+10:00,2023-08-12,10:06,7,5,12
53,2023-08-12T10:08:00+10:00,2023-08-12,10:08,5,4,9
53,2023-08-12T10:11:00+10:00,2023-08-12,10:11,4,1,5
53,2023-08-12T10:18:00+10:00,2023-08-12,10:18,6,10,16
53,2023-08-12T10:19:00+10:00,2023-08-12,10:19,9,2,11
53,2023-08-12T10:20:00+10:00,2023-08-12,10:20,6,8,14
53,2023-08-12T10:23:00+10:00,2023-08-12,10:23,2,3,5
53,2023-08-12T10:25:00+10:00,2023-08-12,10:25,7,3,10
53,2023-08-12T10:30:00+10:00,2023-08-12,10:30,5,8,13
53,2023-08-12T10:35:00+10:00,2023-08-12,10:35,7,4,11
53,2023-08-12T10:42:00+10:00,2023-08-12,10:42,4,5,9
53,2023-08-12T10:50:00+10:00,2023-08-12,10:50,7,7,14
53,2023-08-12T10:54:00+10:00,2023-08-12,10:54,4,7,11
56,2023-08-12T10:01:00+10:00,2023-08-12,10:01,0,5,5
56,2023-08-12T10:05:00+10:00,2023-08-12,10:05,3,1,4
56,2023-08-12T10:06:00+10:00,2023-08-12,10:06,3,1,4
56,2023-08-12T10:11:00+10:00,2023-08-12,10:11,0,1,1
56,2023-08-12T10:12:00+10:00,2023-08-12,10:12,2,0,2
56,2023-08-12T10:13:00+10:00,2023-08-12,10:13,5,0,5
56,2023-08-12T10:16:00+10:00,2023-08-12,10:16,7,0,7
56,2023-08-12T10:19:00+10:00,2023-08-12,10:19,1,1,2
56,2023-08-12T10:22:00+10:00,2023-08-12,10:22,4,5,9
56,2023-08-12T10:25:00+10:00,2023-08-12,10:25,11,0,11
56,2023-08-12T10:26:00+10:00,2023-08-12,10:26,8,3,11
56,2023-08-12T10:28:00+10:00,2023-08-12,10:28,4,1,5
56,2023-08-12T10:34:00+10:00,2023-08-12,10:34,6,2,8
56,2023-08-12T10:36:00+10:00,2023-08-12,10:36,3,0,3
56,2023-08-12T10:37:00+10:00,2023-08-12,10:37,3,0,3
56,2023-08-12T10:38:00+10:00,2023-08-12,10:38,10,2,12
56,2023-08-12T10:49:00+10:00,2023-08-12,10:49,2,1,3
56,2023-08-12T10:51:00+10:00,2023-08-12,10:51,6,7,13
56,2023-08-12T10:52:00+10:00,2023-08-12,10:52,2,2,4
56,2023-08-12T10:54:00+10:00,2023-08-12,10:54,2,3,5
57,2023-08-12T09:58:00+10:00,2023-08-12,09:58,0,4,4
57,2023-08-12T10:00:00+10:00,2023-08-12,10:00,0,2,2
57,2023-08-12T10:05:00+10:00,2023-08-12,10:05,6,1,7
57,2023-08-12T10:06:00+10:00,2023-08-12,10:06,7,4,11
57,2023-08-12T10:09:00+10:00,2023-08-12,10:09,0,1,1
57,2023-08-12T10:12:00+10:00,2023-08-12,10:12,0,2,2
57,2023-08-12T10:15:00+10:00,2023-08-12,10:15,3,4,7
57,2023-08-12T10:17:00+10:00,2023-08-12,10:17,4,1,5
57,2023-08-12T10:18:00+10:00,2023-08-12,10:18,2,1,3
57,2023-08-12T10:23:00+10:00,2023-08-12,10:23,4,2,6
57,2023-08-12T10:25:00+10:00,2023-08-12,10:25,0,1,1
57,2023-08-12T10:26:00+10:00,2023-08-12,10:26,0,3,3
57,2023-08-12T10:27:00+10:00,2023-08-12,10:27,4,1,5
57,2023-08-12T10:29:00+10:00,2023-08-12,10:29,4,2,6
57,2023-08-12T10:30:00+10:00,2023-08-12,10:30,0,3,3
57,2023-08-12T10:33:00+10:00,2023-08-12,10:33,0,4,4
57,2023-08-12T10:34:00+10:00,2023-08-12,10:34,2,6,8
57,2023-08-12T10:35:00+10:00,2023-08-12,10:35,0,3,3
57,2023-08-12T10:37:00+10:00,2023-08-12,10:37,3,1,4
57,2023-08-12T10:38:00+10:00,2023-08-12,10:38,4,2,6
57,2023-08-12T10:43:00+10:00,2023-08-12,10:43,2,0,2
57,2023-08-12T10:44:00+10:00,2023-08-12,10:44,1,3,4
57,2023-08-12T10:46:00+10:00,2023-08-12,10:46,0,2,2
57,2023-08-12T10:47:00+10:00,2023-08-12,10:47,3,5,8
57,2023-08-12T10:49:00+10:00,2023-08-12,10:49,4,4,8
57,2023-08-12T10:50:00+10:00,2023-08-12,10:50,1,3,4
57,2023-08-12T10:52:00+10:00,2023-08-12,10:52,3,9,12
58,2023-08-12T10:01:00+10:00,2023-08-12,10:01,13,3,16
58,2023-08-12T10:05:00+10:00,2023-08-12,10:05,4,9,13
58,2023-08-12T10:11:00+10:00,2023-08-12,10:11,9,7,16
58,2023-08-12T10:16:00+10:00,2023-08-12,10:16,15,1,16
58,2023-08-12T10:17:00+10:00,2023-08-12,10:17,12,6,18
58,2023-08-12T10:18:00+10:00,2023-08-12,10:18,23,1,24
58,2023-08-12T10:19:00+10:00,2023-08-12,10:19,7,1,8
58,2023-08-12T10:21:00+10:00,2023-08-12,10:21,24,7,31
58,2023-08-12T10:24:00+10:00,2023-08-12,10:24,5,1,6
58,2023-08-12T10:28:00+10:00,2023-08-12,10:28,12,3,15
58,2023-08-12T10:29:00+10:00,2023-08-12,10:29,10,1,11
58,2023-08-12T10:33:00+10:00,2023-08-12,10:33,6,3,9
58,2023-08-12T10:35:00+10:00,2023-08-12,10:35,1,1,2
58,2023-08-12T10:37:00+10:00,2023-08-12,10:37,17,1,18
58,2023-08-12T10:39:00+10:00,2023-08-12,10:39,21,4,25
58,2023-08-12T10:40:00+10:00,2023-08-12,10:40,24,1,25
58,2023-08-12T10:41:00+10:00,2023-08-12,10:41,11,8,19
58,2023-08-12T10:50:00+10:00,2023-08-12,10:50,9,0,9
58,2023-08-12T10:51:00+10:00,2023-08-12,10:51,6,3,9
58,2023-08-12T10:53:00+10:00,2023-08-12,10:53,3,3,6
58,2023-08-12T10:54:00+10:00,2023-08-12,10:54,20,5,25
62,2023-08-12T09:58:00+10:00,2023-08-12,09:58,2,2,4
62,2023-08-12T10:00:00+10:00,2023-08-12,10:00,1,2,3
62,2023-08-12T10:02:00+10:00,2023-08-12,10:02,0,3,3
62,2023-08-12T10:04:00+10:00,2023-08-12,10:04,3,7,10
62,2023-08-12T10:11:00+10:00,2023-08-12,10:11,1,1,2
62,2023-08-12T10:17:00+10:00,2023-08-12,10:17,2,6,8
62,2023-08-12T10:23:00+10:00,2023-08-12,10:23,0,5,5
62,2023-08-12T10:24:00+10:00,2023-08-12,10:24,0,3,3
62,2023-08-12T10:28:00+10:00,2023-08-12,10:28,1,4,5
62,2023-08-12T10:37:00+10:00,2023-08-12,10:37,2,0,2
62,2023-08-12T10:40:00+10:00,2023-08-12,10:40,4,3,7
62,2023-08-12T10:47:00+10:00,2023-08-12,10:47,4,5,9
62,2023-08-12T10:48:00+10:00,2023-08-12,10:48,8,2,10
62,2023-08-12T10:50:00+10:00,2023-08-12,10:50,1,1,2
62,2023-08-12T10:54:00+10:00,2023-08-12,10:54,5,4,9
63,2023-08-12T09:56:00+10:00,2023-08-12,09:56,1,5,6
63,2023-08-12T09:59:00+10:00,2023-08-12,09:59,2,0,2
63,2023-08-12T10:01:00+10:00,2023-08-12,10:01,0,4,4
63,2023-08-12T10:02:00+10:00,2023-08-12,10:02,3,4,7
63,2023-08-12T10:04:00+10:00,2023-08-12,10:04,2,3,5
63,2023-08-12T10:17:00+10:00,2023-08-12,10:17,2,4,6
63,2023-08-12T10:18:00+10:00,2023-08-12,10:18,1,2,3
63,2023-08-12T10:22:00+10:00,2023-08-12,10:22,1,2,3
63,2023-08-12T10:24:00+10:00,2023-08-12,10:24,3,1,4
63,2023-08-12T10:29:00+10:00,2023-08-12,10:29,4,5,9
63,2023-08-12T10:32:00+10:00,2023-08-12,10:32,6,6,12
63,2023-08-12T10:36:00+10:00,2023-08-12,10:36,5,9,14
63,2023-08-12T10:39:00+10:00,2023-08-12,10:39,2,7,9
63,2023-08-12T10:43:00+10:00,2023-08-12,10:43,8,8,16
63,2023-08-12T10:52:00+10:00,2023-08-12,10:52,2,15,17
63,2023-08-12T10:53:00+10:00,2023-08-12,10:53,6,4,10
63,2023-08-12T10:55:00+10:00,2023-08-12,10:55,0,3,3
67,2023-08-12T09:57:00+10:00,2023-08-12,09:57,7,7,14
67,2023-08-12T10:02:00+10:00,2023-08-12,10:02,7,8,15
67,2023-08-12T10:06:00+10:00,2023-08-12,10:06,1,5,6
67,2023-08-12T10:10:00+10:00,2023-08-12,10:10,6,1,7
67,2023-08-12T10:12:00+10:00,2023-08-12,10:12,12,4,16
67,2023-08-12T10:13:00+10:00,2023-08-12,10:13,3,2,5
67,2023-08-12T10:14:00+10:00,2023-08-12,10:14,11,8,19
67,2023-08-12T10:15:00+10:00,2023-08-12,10:15,1,5,6
67,2023-08-12T10:18:00+10:00,2023-08-12,10:18,4,10,14
67,2023-08-12T10:26:00+10:00,2023-08-12,10:26,3,6,9
67,2023-08-12T10:32:00+10:00,2023-08-12,10:32,5,3,8
67,2023-08-12T10:34:00+10:00,2023-08-12,10:34,21,6,27
67,2023-08-12T10:36:00+10:00,2023-08-12,10:36,8,5,13
67,2023-08-12T10:39:00+10:00,2023-08-12,10:39,6,4,10
67,2023-08-12T10:41:00+10:00,2023-08-12,10:41,8,6,14
67,2023-08-12T10:45:00+10:00,2023-08-12,10:45,8,16,24
67,2023-08-12T10:47:00+10:00,2023-08-12,10:47,8,6,14
67,2023-08-12T10:48:00+10:00,2023-08-12,10:48,7,5,12
67,2023-08-12T10:49:00+10:00,2023-08-12,10:49,8,10,18
67,2023-08-12T10:50:00+10:00,2023-08-12,10:50,5,1,6
67,2023-08-12T10:53:00+10:00,2023-08-12,10:53,9,7,16
67,2023-08-12T10:54:00+10:00,2023-08-12,10:54,14,4,18
68,2023-08-12T09:57:00+10:00,2023-08-12,09:57,6,3,9
68,2023-08-12T10:11:00+10:00,2023-08-12,10:11,0,2,2
68,2023-08-12T10:18:00+10:00,2023-08-12,10:18,0,2,2
68,2023-08-12T10:21:00+10:00,2023-08-12,10:21,5,2,7
68,2023-08-12T10:22:00+10:00,2023-08-12,10:22,2,0,2
68,2023-08-12T10:27:00+10:00,2023-08-12,10:27,5,1,6
68,2023-08-12T10:32:00+10:00,2023-08-12,10:32,2,5,7
68,2023-08-12T10:42:00+10:00,2023-08-12,10:42,4,5,9
68,2023-08-12T10:43:00+10:00,2023-08-12,10:43,5,3,8
68,2023-08-12T10:48:00+10:00,2023-08-12,10:48,2,3,5
68,2023-08-12T10:50:00+10:00,2023-08-12,10:50,3,1,4
72,2023-08-12T09:56:00+10:00,2023-08-12,09:56,6,2,8
72,2023-08-12T09:58:00+10:00,2023-08-12,09:58,1,0,1
72,2023-08-12T10:00:00+10:00,2023-08-12,10:00,9,4,13
72,2023-08-12T10:01:00+10:00,2023-08-12,10:01,4,2,6
72,2023-08-12T10:02:00+10:00,2023-08-12,10:02,4,3,7
72,2023-08-12T10:04:00+10:00,2023-08-12,10:04,3,4,7
72,2023-08-12T10:05:00+10:00,2023-08-12,10:05,2,3,5
72,2023-08-12T10:07:00+10:00,2023-08-12,10:07,1,5,6
72,2023-08-12T10:09:00+10:00,2023-08-12,10:09,1,0,1
72,2023-08-12T10:10:00+10:00,2023-08-12,10:10,4,5,9
72,2023-08-12T10:11:00+10:00,2023-08-12,10:11,1,2,3
72,2023-08-12T10:12:00+10:00,2023-08-12,10:12,2,6,8
72,2023-08-12T10:16:00+10:00,2023-08-12,10:16,3,2,5
72,2023-08-12T10:18:00+10:00,2023-08-12,10:18,9,6,15
72,2023-08-12T10:23:00+10:00,2023-08-12,10:23,0,5,5
72,2023-08-12T10:27:00+10:00,2023-08-12,10:27,4,1,5
72,2023-08-12T10:31:00+10:00,2023-08-12,10:31,2,6,8
72,2023-08-12T10:32:00+10:00,2023-08-12,10:32,7,4,11
72,2023-08-12T10:34:00+10:00,2023-08-12,10:34,7,2,9
72,2023-08-12T10:37:00+10:00,2023-08-12,10:37,4,0,4
72,2023-08-12T10:38:00+10:00,2023-08-12,10:38,4,3,7
72,2023-08-12T10:40:00+10:00,2023-08-12,10:40,11,16,27
72,2023-08-12T10:42:00+10:00,2023-08-12,10:42,11,2,13
72,2023-08-12T10:45:00+10:00,2023-08-12,10:45,5,4,9
72,2023-08-12T10:47:00+10:00,2023-08-12,10:47,6,2,8
72,2023-08-12T10:50:00+10:00,2023-08-12,10:50,3,2,5
72,2023-08-12T10:51:00+10:00,2023-08-12,10:51,9,5,14
72,2023-08-12T10:52:00+10:00,2023-08-12,10:52,11,2,13
72,2023-08-12T10:53:00+10:00,2023-08-12,10:53,6,13,19
72,2023-08-12T10:55:00+10:00,2023-08-12,10:55,2,2,4
76,2023-08-12T09:57:00+10:00,2023-08-12,09:57,2,1,3
76,2023-08-12T10:02:00+10:00,2023-08-12,10:02,0,1,1
76,2023-08-12T10:13:00+10:00,2023-08-12,10:13,1,0,1
76,2023-08-12T10:14:00+10:00,2023-08-12,10:14,0,1,1
76,2023-08-12T10:16:00+10:00,2023-08-12,10:16,1,2,3
76,2023-08-12T10:20:00+10:00,2023-08-12,10:20,3,1,4
76,2023-08-12T10:21:00+10:00,2023-08-12,10:21,0,2,2
76,2023-08-12T10:22:00+10:00,2023-08-12,10:22,0,1,1
76,2023-08-12T10:28:00+10:00,2023-08-12,10:28,1,0,1
76,2023-08-12T10:30:00+10:00,2023-08-12,10:30,6,0,6
76,2023-08-12T10:33:00+10:00,2023-08-12,10:33,1,0,1
76,2023-08-12T10:34:00+10:00,2023-08-12,10:34,2,2,4
76,2023-08-12T10:35:00+10:00,2023-08-12,10:35,0,3,3
76,2023-08-12T10:41:00+10:00,2023-08-12,10:41,1,4,5
76,2023-08-12T10:45:00+10:00,2023-08-12,10:45,2,0,2
76,2023-08-12T10:50:00+10:00,2023-08-12,10:50,1,2,3
76,2023-08-12T10:51:00+10:00,2023-08-12,10:51,4,0,4
76,2023-08-12T10:52:00+10:00,2023-08-12,10:52,6,4,10
76,2023-08-12T10:53:00+10:00,2023-08-12,10:53,1,2,3
79,2023-08-12T09:59:00+10:00,2023-08-12,09:59,4,4,8
79,2023-08-12T10:00:00+10:00,2023-08-12,10:00,10,8,18
79,2023-08-12T10:01:00+10:00,2023-08-12,10:01,4,5,9
79,2023-08-12T10:07:00+10:00,2023-08-12,10:07,16,1,17
79,2023-08-12T10:08:00+10:00,2023-08-12,10:08,13,4,17
79,2023-08-12T10:13:00+10:00,2023-08-12,10:13,4,13,17
79,2023-08-12T10:15:00+10:00,2023-08-12,10:15,5,6,11
79,2023-08-12T10:16:00+10:00,2023-08-12,10:16,11,2,13
79,2023-08-12T10:22:00+10:00,2023-08-12,10:22,13,7,20
79,2023-08-12T10:23:00+10:00,2023-08-12,10:23,15,17,32
79,2023-08-12T10:24:00+10:00,2023-08-12,10:24,7,1,8
79,2023-08-12T10:29:00+10:00,2023-08-12,10:29,7,7,14
79,2023-08-12T10:42:00+10:00,2023-08-12,10:42,7,3,10
79,2023-08-12T10:45:00+10:00,2023-08-12,10:45,1,10,11
79,2023-08-12T10:48:00+10:00,2023-08-12,10:48,18,1,19
79,2023-08-12T10:50:00+10:00,2023-08-12,10:50,5,9,14
85,2023-08-12T09:55:00+10:00,2023-08-12,09:55,0,6,6
85,2023-08-12T09:58:00+10:00,2023-08-12,09:58,4,1,5
85,2023-08-12T09:59:00+10:00,2023-08-12,09:59,4,2,6
85,2023-08-12T10:01:00+10:00,2023-08-12,10:01,1,4,5
85,2023-08-12T10:02:00+10:00,2023-08-12,10:02,1,0,1
85,2023-08-12T10:07:00+10:00,2023-08-12,10:07,1,1,2
85,2023-08-12T10:08:00+10:00,2023-08-12,10:08,0,2,2
85,2023-08-12T10:11:00+10:00,2023-08-12,10:11,0,4,4
85,2023-08-12T10:13:00+10:00,2023-08-12,10:13,0,1,1
85,2023-08-12T10:15:00+10:00,2023-08-12,10:15,1,3,4
85,2023-08-12T10:16:00+10:00,2023-08-12,10:16,7,0,7
85,2023-08-12T10:17:00+10:00,2023-08-12,10:17,2,3,5
85,2023-08-12T10:25:00+10:00,2023-08-12,10:25,1,2,3
85,2023-08-12T10:26:00+10:00,2023-08-12,10:26,3,0,3
85,2023-08-12T10:27:00+10:00,2023-08-12,10:27,0,3,3
85,2023-08-12T10:28:00+10:00,2023-08-12,10:28,1,0,1
85,2023-08-12T10:33:00+10:00,2023-08-12,10:33,5,2,7
85,2023-08-12T10:37:00+10:00,2023-08-12,10:37,2,2,4
85,2023-08-12T10:39:00+10:00,2023-08-12,10:39,1,1,2
85,2023-08-12T10:42:00+10:00,2023-08-12,10:42,3,5,8
85,2023-08-12T10:43:00+10:00,2023-08-12,10:43,0,3,3
85,2023-08-12T10:44:00+10:00,2023-08-12,10:44,4,0,4
85,2023-08-12T10:52:00+10:00,2023-08-12,10:52,7,3,10
86,2023-08-12T09:56:00+10:00,2023-08-12,09:56,0,1,1
86,2023-08-12T10:00:00+10:00,2023-08-12,10:00,1,2,3
86,2023-08-12T10:01:00+10:00,2023-08-12,10:01,0,2,2
86,2023-08-12T10:03:00+10:00,2023-08-12,10:03,1,0,1
86,2023-08-12T10:07:00+10:00,2023-08-12,10:07,0,2,2
86,2023-08-12T10:17:00+10:00,2023-08-12,10:17,0,2,2
86,2023-08-12T10:19:00+10:00,2023-08-12,10:19,0,2,2
86,2023-08-12T10:22:00+10:00,2023-08-12,10:22,0,1,1
86,2023-08-12T10:26:00+10:00,2023-08-12,10:26,4,0,4
86,2023-08-12T10:29:00+10:00,2023-08-12,10:29,1,3,4
86,2023-08-12T10:34:00+10:00,2023-08-12,10:34,0,3,3
86,2023-08-12T10:35:00+10:00,2023-08-12,10:35,0,1,1
86,2023-08-12T10:39:00+10:00,2023-08-12,10:39,2,1,3
86,2023-08-12T10:47:00+10:00,2023-08-12,10:47,1,0,1
86,2023-08-12T10:48:00+10:00,2023-08-12,10:48,2,0,2
86,2023-08-12T10:51:00+10:00,2023-08-12,10:51,1,0,1
86,2023-08-12T10:55:00+10:00,2023-08-12,10:55,3,1,4
109,2023-08-12T09:55:00+10:00,2023-08-12,09:55,2,23,25
109,2023-08-12T10:05:00+10:00,2023-08-12,10:05,1,6,7
109,2023-08-12T10:10:00+10:00,2023-08-12,10:10,11,2,13
117,2023-08-12T10:05:00+10:00,2023-08-12,10:05,3,3,6
117,2023-08-12T10:15:00+10:00,2023-08-12,10:15,18,14,32
117,2023-08-12T10:25:00+10:00,2023-08-12,10:25,7,14,21
122,2023-08-12T09:57:00+10:00,2023-08-12,09:57,2,0,2
122,2023-08-12T10:01:00+10:00,2023-08-12,10:01,3,3,6
122,2023-08-12T10:04:00+10:00,2023-08-12,10:04,0,1,1
122,2023-08-12T10:09:00+10:00,2023-08-12,10:09,0,1,1
122,2023-08-12T10:10:00+10:00,2023-08-12,10:10,2,0,2
122,2023-08-12T10:19:00+10:00,2023-08-12,10:19,0,2,2
122,2023-08-12T10:20:00+10:00,2023-08-12,10:20,1,1,2
122,2023-08-12T10:23:00+10:00,2023-08-12,10:23,2,1,3
122,2023-08-12T10:25:00+10:00,2023-08-12,10:25,1,0,1
122,2023-08-12T10:31:00+10:00,2023-08-12,10:31,0,1,1
122,2023-08-12T10:32:00+10:00,2023-08-12,10:32,0,1,1
122,2023-08-12T10:33:00+10:00,2023-08-12,10:33,1,0,1
122,2023-08-12T10:36:00+10:00,2023-08-12,10:36,2,0,2
122,2023-08-12T10:38:00+10:00,2023-08-12,10:38,0,1,1
122,2023-08-12T10:39:00+10:00,2023-08-12,10:39,0,3,3
3,2023-08-12T09:56:00+10:00,2023-08-12,09:56,6,11,17
3,2023-08-12T09:57:00+10:00,2023-08-12,09:57,5,5,10
3,2023-08-12T10:01:00+10:00,2023-08-12,10:01,6,2,8
3,2023-08-12T10:03:00+10:00,2023-08-12,10:03,8,2,10
3,2023-08-12T10:04:00+10:00,2023-08-12,10:04,1,8,9
3,2023-08-12T10:12:00+10:00,2023-08-12,10:12,4,8,12
3,2023-08-12T10:13:00+10:00,2023-08-12,10:13,2,1,3
3,2023-08-12T10:16:00+10:00,2023-08-12,10:16,7,10,17
3,2023-08-12T10:17:00+10:00,2023-08-12,10:17,3,4,7
3,2023-08-12T10:19:00+10:00,2023-08-12,10:19,11,9,20
3,2023-08-12T10:23:00+10:00,2023-08-12,10:23,3,4,7
3,2023-08-12T10:26:00+10:00,2023-08-12,10:26,0,12,12
3,2023-08-12T10:29:00+10:00,2023-08-12,10:29,5,8,13
3,2023-08-12T10:31:00+10:00,2023-08-12,10:31,1,6,7
3,2023-08-12T10:35:00+10:00,2023-08-12,10:35,0,2,2
3,2023-08-12T10:37:00+10:00,2023-08-12,10:37,6,6,12
3,2023-08-12T10:42:00+10:00,2023-08-12,10:42,12,2,14
3,2023-08-12T10:44:00+10:00,2023-08-12,10:44,6,8,14
3,2023-08-12T10:47:00+10:00,2023-08-12,10:47,2,5,7
3,2023-08-12T10:49:00+10:00,2023-08-12,10:49,14,8,22
3,2023-08-12T10:53:00+10:00,2023-08-12,10:53,7,11,18
3,2023-08-12T10:55:00+10:00,2023-08-12,10:55,22,9,31
4,2023-08-12T09:59:00+10:00,2023-08-12,09:59,20,16,36
4,2023-08-12T10:05:00+10:00,2023-08-12,10:05,17,4,21
4,2023-08-12T10:06:00+10:00,2023-08-12,10:06,11,8,19
4,2023-08-12T10:10:00+10:00,2023-08-12,10:10,10,2,12
4,2023-08-12T10:12:00+10:00,2023-08-12,10:12,17,8,25
4,2023-08-12T10:13:00+10:00,2023-08-12,10:13,11,14,25
4,2023-08-12T10:15:00+10:00,2023-08-12,10:15,16,0,16
4,2023-08-12T10:16:00+10:00,2023-08-12,10:16,25,7,32
4,2023-08-12T10:18:00+10:00,2023-08-12,10:18,15,15,30
4,2023-08-12T10:20:00+10:00,2023-08-12,10:20,11,9,20
4,2023-08-12T10:21:00+10:00,2023-08-12,10:21,6,3,9
4,2023-08-12T10:26:00+10:00,2023-08-12,10:26,25,8,33
4,2023-08-12T10:29:00+10:00,2023-08-12,10:29,21,15,36
4,2023-08-12T10:30:00+10:00,2023-08-12,10:30,23,18,41
4,2023-08-12T10:33:00+10:00,2023-08-12,10:33,14,11,25
4,2023-08-12T10:34:00+10:00,2023-08-12,10:34,17,18,35
4,2023-08-12T10:39:00+10:00,2023-08-12,10:39,3,15,18
4,2023-08-12T10:40:00+10:00,2023-08-12,10:40,8,7,15
4,2023-08-12T10:43:00+10:00,2023-08-12,10:43,30,8,38
4,2023-08-12T10:45:00+10:00,2023-08-12,10:45,19,8,27
4,2023-08-12T10:46:00+10:00,2023-08-12,10:46,21,17,38
4,2023-08-12T10:51:00+10:00,2023-08-12,10:51,11,10,21
4,2023-08-12T10:52:00+10:00,2023-08-12,10:52,26,10,36
4,2023-08-12T10:55:00+10:00,2023-08-12,10:55,17,5,22
6,2023-08-12T09:55:00+10:00,2023-08-12,09:55,5,5,10
6,2023-08-12T09:56:00+10:00,2023-08-12,09:56,6,4,10
6,2023-08-12T09:59:00+10:00,2023-08-12,09:59,7,4,11
6,2023-08-12T10:02:00+10:00,2023-08-12,10:02,7,6,13
6,2023-08-12T10:12:00+10:00,2023-08-12,10:12,7,4,11
6,2023-08-12T10:13:00+10:00,2023-08-12,10:13,4,0,4
6,2023-08-12T10:18:00+10:00,2023-08-12,10:18,4,6,10
6,2023-08-12T10:24:00+10:00,2023-08-12,10:24,7,2,9
6,2023-08-12T10:27:00+10:00,2023-08-12,10:27,6,4,10
6,2023-08-12T10:29:00+10:00,2023-08-12,10:29,14,6,20
6,2023-08-12T10:31:00+10:00,2023-08-12,10:31,16,5,21
6,2023-08-12T10:32:00+10:00,2023-08-12,10:32,9,5,14
6,2023-08-12T10:33:00+10:00,2023-08-12,10:33,3,0,3
6,2023-08-12T10:42:00+10:00,2023-08-12,10:42,9,10,19
6,2023-08-12T10:43:00+10:00,2023-08-12,10:43,15,3,18
6,2023-08-12T10:44:00+10:00,2023-08-12,10:44,4,8,12
6,2023-08-12T10:54:00+10:00,2023-08-12,10:54,12,1,13
8,2023-08-12T10:00:00+10:00,2023-08-12,10:00,0,5,5
8,2023-08-12T10:05:00+10:00,2023-08-12,10:05,0,2,2
8,2023-08-12T10:07:00+10:00,2023-08-12,10:07,1,0,1
8,2023-08-12T10:11:00+10:00,2023-08-12,10:11,0,4,4
8,2023-08-12T10:17:00+10:00,2023-08-12,10:17,3,2,5
8,2023-08-12T10:18:00+10:00,2023-08-12,10:18,0,1,1
8,2023-08-12T10:20:00+10:00,2023-08-12,10:20,2,2,4
8,2023-08-12T10:21:00+10:00,2023-08-12,10:21,2,0,2
8,2023-08-12T10:25:00+10:00,2023-08-12,10:25,3,3,6
8,2023-08-12T10:28:00+10:00,2023-08-12,10:28,3,1,4
8,2023-08-12T10:30:00+10:00,2023-08-12,10:30,3,2,5
8,2023-08-12T10:37:00+10:00,2023-08-12,10:37,0,9,9
8,2023-08-12T10:38:00+10:00,2023-08-12,10:38,0,8,8
8,2023-08-12T10:39:00+10:00,2023-08-12,10:39,1,2,3
8,2023-08-12T10:40:00+10:00,2023-08-12,10:40,0,2,2
8,2023-08-12T10:45:00+10:00,2023-08-12,10:45,1,2,3
8,2023-08-12T10:46:00+10:00,2023-08-12,10:46,1,10,11
8,2023-08-12T10:47:00+10:00,2023-08-12,10:47,0,3,3
8,2023-08-12T10:48:00+10:00,2023-08-12,10:48,1,2,3
8,2023-08-12T10:49:00+10:00,2023-08-12,10:49,1,0,1
8,2023-08-12T10:50:00+10:00,2023-08-12,10:50,1,4,5
14,2023-08-12T09:55:00+10:00,2023-08-12,09:55,3,2,5
14,2023-08-12T09:57:00+10:00,2023-08-12,09:57,8,6,14
14,2023-08-12T09:58:00+10:00,2023-08-12,09:58,4,2,6
14,2023-08-12T09:59:00+10:00,2023-08-12,09:59,3,3,6
14,2023-08-12T10:04:00+10:00,2023-08-12,10:04,1,1,2
14,2023-08-12T10:06:00+10:00,2023-08-12,10:06,6,0,6
14,2023-08-12T10:07:00+10:00,2023-08-12,10:07,3,7,10
14,2023-08-12T10:08:00+10:00,2023-08-12,10:08,3,0,3
14,2023-08-12T10:09:00+10:00,2023-08-12,10:09,5,0,5
14,2023-08-12T10:16:00+10:00,2023-08-12,10:16,8,0,8
14,2023-08-12T10:20:00+10:00,2023-08-12,10:20,7,1,8
14,2023-08-12T10:25:00+10:00,2023-08-12,10:25,4,4,8
14,2023-08-12T10:30:00+10:00,2023-08-12,10:30,7,1,8
14,2023-08-12T10:40:00+10:00,2023-08-12,10:40,4,2,6
14,2023-08-12T10:41:00+10:00,2023-08-12,10:41,5,2,7
14,2023-08-12T10:45:00+10:00,2023-08-12,10:45,5,2,7
14,2023-08-12T10:46:00+10:00,2023-08-12,10:46,6,6,12
14,2023-08-12T10:47:00+10:00,2023-08-12,10:47,1,0,1
14,2023-08-12T10:48:00+10:00,2023-08-12,10:48,2,2,4
14,2023-08-12T10:51:00+10:00,2023-08-12,10:51,14,6,20
14,2023-08-12T10:52:00+10:00,2023-08-12,10:52,8,2,10
14,2023-08-12T10:55:00+10:00,2023-08-12,10:55,5,3,8
21,2023-08-12T10:02:00+10:00,2023-08-12,10:02,0,2,2
21,2023-08-12T10:03:00+10:00,2023-08-12,10:03,2,6,8
21,2023-08-12T10:05:00+10:00,2023-08-12,10:05,5,0,5
21,2023-08-12T10:08:00+10:00,2023-08-12,10:08,3,3,6
21,2023-08-12T10:09:00+10:00,2023-08-12,10:09,8,1,9
21,2023-08-12T10:12:00+10:00,2023-08-12,10:12,6,0,6
21,2023-08-12T10:15:00+10:00,2023-08-12,10:15,10,4,14
21,2023-08-12T10:21:00+10:00,2023-08-12,10:21,6,1,7
21,2023-08-12T10:24:00+10:00,2023-08-12,10:24,10,7,17
21,2023-08-12T10:27:00+10:00,2023-08-12,10:27,2,7,9
21,2023-08-12T10:28:00+10:00,2023-08-12,10:28,9,3,12
21,2023-08-12T10:29:00+10:00,2023-08-12,10:29,1,4,5
21,2023-08-12T10:30:00+10:00,2023-08-12,10:30,6,1,7
21,2023-08-12T10:33:00+10:00,2023-08-12,10:33,1,5,6
21,2023-08-12T10:37:00+10:00,2023-08-12,10:37,2,1,3
21,2023-08-12T10:39:00+10:00,2023-08-12,10:39,2,8,10
21,2023-08-12T10:45:00+10:00,2023-08-12,10:45,6,0,6
21,2023-08-12T10:46:00+10:00,2023-08-12,10:46,2,4,6
21,2023-08-12T10:48:00+10:00,2023-08-12,10:48,6,0,6
21,2023-08-12T10:51:00+10:00,2023-08-12,10:51,10,1,11
21,2023-08-12T10:52:00+10:00,2023-08-12,10:52,3,0,3
21,2023-08-12T10:54:00+10:00,2023-08-12,10:54,2,5,7
28,2023-08-12T09:57:00+10:00,2023-08-12,09:57,3,4,7
28,2023-08-12T09:58:00+10:00,2023-08-12,09:58,4,3,7
28,2023-08-12T10:00:00+10:00,2023-08-12,10:00,12,6,18
28,2023-08-12T10:05:00+10:00,2023-08-12,10:05,11,8,19
28,2023-08-12T10:06:00+10:00,2023-08-12,10:06,13,4,17
28,2023-08-12T10:08:00+10:00,2023-08-12,10:08,5,1,6
28,2023-08-12T10:13:00+10:00,2023-08-12,10:13,5,5,10
28,2023-08-12T10:17:00+10:00,2023-08-12,10:17,10,10,20
28,2023-08-12T10:18:00+10:00,2023-08-12,10:18,1,4,5
28,2023-08-12T10:19:00+10:00,2023-08-12,10:19,8,4,12
28,2023-08-12T10:20:00+10:00,2023-08-12,10:20,16,3,19
28,2023-08-12T10:23:00+10:00,2023-08-12,10:23,9,4,13
28,2023-08-12T10:24:00+10:00,2023-08-12,10:24,2,2,4
28,2023-08-12T10:25:00+10:00,2023-08-12,10:25,15,3,18
28,2023-08-12T10:30:00+10:00,2023-08-12,10:30,1,1,2
28,2023-08-12T10:35:00+10:00,2023-08-12,10:35,7,6,13
28,2023-08-12T10:42:00+10:00,2023-08-12,10:42,5,5,10
28,2023-08-12T10:44:00+10:00,2023-08-12,10:44,5,3,8
28,2023-08-12T10:45:00+10:00,2023-08-12,10:45,10,4,14
28,2023-08-12T10:47:00+10:00,2023-08-12,10:47,10,6,16
28,2023-08-12T10:48:00+10:00,2023-08-12,10:48,6,8,14
28,2023-08-12T10:49:00+10:00,2023-08-12,10:49,10,7,17
28,2023-08-12T10:52:00+10:00,2023-08-12,10:52,5,8,13
28,2023-08-12T10:53:00+10:00,2023-08-12,10:53,9,7,16
29,2023-08-12T09:55:00+10:00,2023-08-12,09:55,2,3,5
29,2023-08-12T09:58:00+10:00,2023-08-12,09:58,1,2,3
29,2023-08-12T09:59:00+10:00,2023-08-12,09:59,1,13,14
29,2023-08-12T10:00:00+10:00,2023-08-12,10:00,0,7,7
29,2023-08-12T10:02:00+10:00,2023-08-12,10:02,1,5,6
29,2023-08-12T10:03:00+10:00,2023-08-12,10:03,10,1,11
29,2023-08-12T10:04:00+10:00,2023-08-12,10:04,4,10,14
29,2023-08-12T10:05:00+10:00,2023-08-12,10:05,5,4,9
29,2023-08-12T10:08:00+10:00,2023-08-12,10:08,2,4,6
29,2023-08-12T10:23:00+10:00,2023-08-12,10:23,2,6,8
29,2023-08-12T10:25:00+10:00,2023-08-12,10:25,9,5,14
29,2023-08-12T10:31:00+10:00,2023-08-12,10:31,7,9,16
29,2023-08-12T10:36:00+10:00,2023-08-12,10:36,3,7,10
29,2023-08-12T10:37:00+10:00,2023-08-12,10:37,1,12,13
29,2023-08-12T10:46:00+10:00,2023-08-12,10:46,3,10,13
29,2023-08-12T10:50:00+10:00,2023-08-12,10:50,9,11,20
39,2023-08-12T09:57:00+10:00,2023-08-12,09:57,2,2,4
39,2023-08-12T10:02:00+10:00,2023-08-12,10:02,4,2,6
3,2023-08-11T23:40:00+10:00,2023-08-11,23:40,5,5,10
3,2023-08-11T23:41:00+10:00,2023-08-11,23:41,10,24,34
3,2023-08-11T23:46:00+10:00,2023-08-11,23:46,6,4,10
3,2023-08-11T23:47:00+10:00,2023-08-11,23:47,4,14,18
3,2023-08-11T23:51:00+10:00,2023-08-11,23:51,18,10,28
3,2023-08-11T23:52:00+10:00,2023-08-11,23:52,11,10,21
3,2023-08-11T23:53:00+10:00,2023-08-11,23:53,1,8,9
4,2023-08-11T23:42:00+10:00,2023-08-11,23:42,9,10,19
4,2023-08-11T23:45:00+10:00,2023-08-11,23:45,0,15,15
4,2023-08-11T23:47:00+10:00,2023-08-11,23:47,19,12,31
4,2023-08-11T23:49:00+10:00,2023-08-11,23:49,7,28,35
4,2023-08-11T23:50:00+10:00,2023-08-11,23:50,5,32,37
4,2023-08-11T23:51:00+10:00,2023-08-11,23:51,5,23,28
4,2023-08-11T23:52:00+10:00,2023-08-11,23:52,13,26,39
4,2023-08-11T23:53:00+10:00,2023-08-11,23:53,8,20,28
4,2023-08-11T23:54:00+10:00,2023-08-11,23:54,16,37,53
6,2023-08-11T23:40:00+10:00,2023-08-11,23:40,7,4,11
6,2023-08-11T23:41:00+10:00,2023-08-11,23:41,17,10,27
6,2023-08-11T23:44:00+10:00,2023-08-11,23:44,5,7,12
6,2023-08-11T23:49:00+10:00,2023-08-11,23:49,4,6,10
6,2023-08-11T23:51:00+10:00,2023-08-11,23:51,7,4,11
8,2023-08-11T23:40:00+10:00,2023-08-11,23:40,1,4,5
8,2023-08-11T23:45:00+10:00,2023-08-11,23:45,3,1,4
8,2023-08-11T23:51:00+10:00,2023-08-11,23:51,2,0,2
14,2023-08-11T23:40:00+10:00,2023-08-11,23:40,5,2,7
14,2023-08-11T23:47:00+10:00,2023-08-11,23:47,10,2,12
14,2023-08-11T23:50:00+10:00,2023-08-11,23:50,11,0,11
21,2023-08-11T23:44:00+10:00,2023-08-11,23:44,6,3,9
21,2023-08-11T23:45:00+10:00,2023-08-11,23:45,3,8,11
21,2023-08-11T23:48:00+10:00,2023-08-11,23:48,5,3,8
21,2023-08-11T23:49:00+10:00,2023-08-11,23:49,7,8,15
28,2023-08-11T23:40:00+10:00,2023-08-11,23:40,2,2,4
28,2023-08-11T23:44:00+10:00,2023-08-11,23:44,0,5,5
28,2023-08-11T23:45:00+10:00,2023-08-11,23:45,2,0,2
29,2023-08-11T23:41:00+10:00,2023-08-11,23:41,0,1,1
29,2023-08-11T23:45:00+10:00,2023-08-11,23:45,0,2,2
29,2023-08-11T23:47:00+10:00,2023-08-11,23:47,1,0,1
29,2023-08-11T23:54:00+10:00,2023-08-11,23:54,1,0,1
39,2023-08-11T23:43:00+10:00,2023-08-11,23:43,0,3,3
39,2023-08-11T23:48:00+10:00,2023-08-11,23:48,0,1,1
39,2023-08-11T23:52:00+10:00,2023-08-11,23:52,1,4,5
41,2023-08-11T23:40:00+10:00,2023-08-11,23:40,9,11,20
41,2023-08-11T23:42:00+10:00,2023-08-11,23:42,8,17,25
41,2023-08-11T23:44:00+10:00,2023-08-11,23:44,17,5,22
41,2023-08-11T23:46:00+10:00,2023-08-11,23:46,15,8,23
41,2023-08-11T23:48:00+10:00,2023-08-11,23:48,20,21,41
41,2023-08-11T23:50:00+10:00,2023-08-11,23:50,11,11,22
41,2023-08-11T23:52:00+10:00,2023-08-11,23:52,5,30,35
54,2023-08-11T23:52:00+10:00,2023-08-11,23:52,7,0,7
55,2023-08-11T23:43:00+10:00,2023-08-11,23:43,10,13,23
55,2023-08-11T23:47:00+10:00,2023-08-11,23:47,15,0,15
55,2023-08-11T23:50:00+10:00,2023-08-11,23:50,56,3,59
55,2023-08-11T23:53:00+10:00,2023-08-11,23:53,8,7,15
55,2023-08-11T23:54:00+10:00,2023-08-11,23:54,6,2,8
59,2023-08-11T23:40:00+10:00,2023-08-11,23:40,18,16,34
61,2023-08-11T23:43:00+10:00,2023-08-11,23:43,0,3,3
61,2023-08-11T23:44:00+10:00,2023-08-11,23:44,0,1,1
61,2023-08-11T23:47:00+10:00,2023-08-11,23:47,0,1,1
61,2023-08-11T23:49:00+10:00,2023-08-11,23:49,3,0,3
61,2023-08-11T23:51:00+10:00,2023-08-11,23:51,0,2,2
61,2023-08-11T23:53:00+10:00,2023-08-11,23:53,1,2,3
65,2023-08-11T23:43:00+10:00,2023-08-11,23:43,3,4,7
65,2023-08-11T23:44:00+10:00,2023-08-11,23:44,4,2,6
65,2023-08-11T23:46:00+10:00,2023-08-11,23:46,1,3,4
65,2023-08-11T23:48:00+10:00,2023-08-11,23:48,4,6,10
65,2023-08-11T23:51:00+10:00,2023-08-11,23:51,0,3,3
65,2023-08-11T23:54:00+10:00,2023-08-11,23:54,2,7,9
66,2023-08-11T23:42:00+10:00,2023-08-11,23:42,4,3,7
66,2023-08-11T23:45:00+10:00,2023-08-11,23:45,7,4,11
66,2023-08-11T23:46:00+10:00,2023-08-11,23:46,7,3,10
66,2023-08-11T23:47:00+10:00,2023-08-11,23:47,3,5,8
69,2023-08-11T23:44:00+10:00,2023-08-11,23:44,0,1,1
75,2023-08-11T23:44:00+10:00,2023-08-11,23:44,0,1,1
77,2023-08-11T23:45:00+10:00,2023-08-11,23:45,0,1,1
78,2023-08-11T23:41:00+10:00,2023-08-11,23:41,1,0,1
78,2023-08-11T23:44:00+10:00,2023-08-11,23:44,0,1,1
78,2023-08-11T23:47:00+10:00,2023-08-11,23:47,1,1,2
78,2023-08-11T23:49:00+10:00,2023-08-11,23:49,0,5,5
84,2023-08-11T23:45:00+10:00,2023-08-11,23:45,31,62,93
84,2023-08-11T23:50:00+10:00,2023-08-11,23:50,20,40,60
87,2023-08-11T23:46:00+10:00,2023-08-11,23:46,2,0,2
87,2023-08-11T23:52:00+10:00,2023-08-11,23:52,0,1,1
87,2023-08-11T23:54:00+10:00,2023-08-11,23:54,0,1,1
107,2023-08-11T23:45:00+10:00,2023-08-11,23:45,4,4,8
108,2023-08-11T23:46:00+10:00,2023-08-11,23:46,1,2,3
108,2023-08-11T23:50:00+10:00,2023-08-11,23:50,2,1,3
118,2023-08-11T23:50:00+10:00,2023-08-11,23:50,0,2,2
1,2023-08-11T23:40:00+10:00,2023-08-11,23:40,3,3,6
1,2023-08-11T23:41:00+10:00,2023-08-11,23:41,5,3,8
1,2023-08-11T23:43:00+10:00,2023-08-11,23:43,4,0,4
1,2023-08-11T23:44:00+10:00,2023-08-11,23:44,2,3,5
1,2023-08-11T23:45:00+10:00,2023-08-11,23:45,3,0,3
1,2023-08-11T23:46:00+10:00,2023-08-11,23:46,3,2,5
1,2023-08-11T23:49:00+10:00,2023-08-11,23:49,3,1,4
2,2023-08-11T23:45:00+10:00,2023-08-11,23:45,1,3,4
2,2023-08-11T23:46:00+10:00,2023-08-11,23:46,2,0,2
2,2023-08-11T23:47:00+10:00,2023-08-11,23:47,0,1,1
2,2023-08-11T23:49:00+10:00,2023-08-11,23:49,0,3,3
2,2023-08-11T23:50:00+10:00,2023-08-11,23:50,0,8,8
7,2023-08-11T23:41:00+10:00,2023-08-11,23:41,0,3,3
7,2023-08-11T23:42:00+10:00,2023-08-11,23:42,1,4,5
7,2023-08-11T23:43:00+10:00,2023-08-11,23:43,0,6,6
7,2023-08-11T23:44:00+10:00,2023-08-11,23:44,1,7,8
7,2023-08-11T23:46:00+10:00,2023-08-11,23:46,1,8,9
7,2023-08-11T23:48:00+10:00,2023-08-11,23:48,0,3,3
7,2023-08-11T23:53:00+10:00,2023-08-11,23:53,1,18,19
9,2023-08-11T23:48:00+10:00,2023-08-11,23:48,0,1,1
9,2023-08-11T23:52:00+10:00,2023-08-11,23:52,2,1,3
10,2023-08-11T23:41:00+10:00,2023-08-11,23:41,1,0,1
10,2023-08-11T23:43:00+10:00,2023-08-11,23:43,2,0,2
11,2023-08-11T23:46:00+10:00,2023-08-11,23:46,0,2,2
12,2023-08-11T23:46:00+10:00,2023-08-11,23:46,2,0,2
12,2023-08-11T23:48:00+10:00,2023-08-11,23:48,1,0,1
12,2023-08-11T23:50:00+10:00,2023-08-11,23:50,1,1,2
12,2023-08-11T23:53:00+10:00,2023-08-11,23:53,3,1,4
17,2023-08-11T23:40:00+10:00,2023-08-11,23:40,4,1,5
17,2023-08-11T23:50:00+10:00,2023-08-11,23:50,0,1,1
17,2023-08-11T23:52:00+10:00,2023-08-11,23:52,0,2,2
17,2023-08-11T23:54:00+10:00,2023-08-11,23:54,1,1,2
18,2023-08-11T23:49:00+10:00,2023-08-11,23:49,0,1,1
24,2023-08-11T23:43:00+10:00,2023-08-11,23:43,3,5,8
24,2023-08-11T23:44:00+10:00,2023-08-11,23:44,1,5,6
24,2023-08-11T23:46:00+10:00,2023-08-11,23:46,2,2,4
24,2023-08-11T23:47:00+10:00,2023-08-11,23:47,14,3,17
24,2023-08-11T23:50:00+10:00,2023-08-11,23:50,1,1,2
24,2023-08-11T23:52:00+10:00,2023-08-11,23:52,1,2,3
24,2023-08-11T23:54:00+10:00,2023-08-11,23:54,1,4,5
27,2023-08-11T23:41:00+10:00,2023-08-11,23:41,1,0,1
27,2023-08-11T23:42:00+10:00,2023-08-11,23:42,3,0,3
35,2023-08-11T23:42:00+10:00,2023-08-11,23:42,4,12,16
35,2023-08-11T23:46:00+10:00,2023-08-11,23:46,2,11,13
35,2023-08-11T23:49:00+10:00,2023-08-11,23:49,7,17,24
35,2023-08-11T23:50:00+10:00,2023-08-11,23:50,5,7,12
35,2023-08-11T23:51:00+10:00,2023-08-11,23:51,9,9,18
35,2023-08-11T23:54:00+10:00,2023-08-11,23:54,2,9,11
53,2023-08-11T23:42:00+10:00,2023-08-11,23:42,2,2,4
53,2023-08-11T23:48:00+10:00,2023-08-11,23:48,3,0,3
53,2023-08-11T23:49:00+10:00,2023-08-11,23:49,2,2,4
53,2023-08-11T23:50:00+10:00,2023-08-11,23:50,0,2,2
53,2023-08-11T23:51:00+10:00,2023-08-11,23:51,0,2,2
56,2023-08-11T23:43:00+10:00,2023-08-11,23:43,3,0,3
56,2023-08-11T23:47:00+10:00,2023-08-11,23:47,2,0,2
56,2023-08-11T23:48:00+10:00,2023-08-11,23:48,6,0,6
56,2023-08-11T23:49:00+10:00,2023-08-11,23:49,1,0,1
57,2023-08-11T23:49:00+10:00,2023-08-11,23:49,0,2,2
57,2023-08-11T23:50:00+10:00,2023-08-11,23:50,1,0,1
58,2023-08-11T23:51:00+10:00,2023-08-11,23:51,2,7,9
58,2023-08-11T23:52:00+10:00,2023-08-11,23:52,15,11,26
62,2023-08-11T23:43:00+10:00,2023-08-11,23:43,2,3,5
62,2023-08-11T23:47:00+10:00,2023-08-11,23:47,0,1,1
62,2023-08-11T23:49:00+10:00,2023-08-11,23:49,1,2,3
62,2023-08-11T23:51:00+10:00,2023-08-11,23:51,0,3,3
62,2023-08-11T23:52:00+10:00,2023-08-11,23:52,2,1,3
63,2023-08-11T23:41:00+10:00,2023-08-11,23:41,4,1,5
63,2023-08-11T23:43:00+10:00,2023-08-11,23:43,2,0,2
63,2023-08-11T23:44:00+10:00,2023-08-11,23:44,4,3,7
63,2023-08-11T23:48:00+10:00,2023-08-11,23:48,5,2,7
67,2023-08-11T23:40:00+10:00,2023-08-11,23:40,0,3,3
67,2023-08-11T23:42:00+10:00,2023-08-11,23:42,0,7,7
67,2023-08-11T23:44:00+10:00,2023-08-11,23:44,4,1,5
67,2023-08-11T23:49:00+10:00,2023-08-11,23:49,1,9,10
67,2023-08-11T23:50:00+10:00,2023-08-11,23:50,3,5,8
67,2023-08-11T23:52:00+10:00,2023-08-11,23:52,0,5,5
68,2023-08-11T23:46:00+10:00,2023-08-11,23:46,1,0,1
72,2023-08-11T23:40:00+10:00,2023-08-11,23:40,0,6,6
72,2023-08-11T23:45:00+10:00,2023-08-11,23:45,7,8,15
79,2023-08-11T23:42:00+10:00,2023-08-11,23:42,3,3,6
79,2023-08-11T23:43:00+10:00,2023-08-11,23:43,4,13,17
79,2023-08-11T23:46:00+10:00,2023-08-11,23:46,3,10,13
79,2023-08-11T23:49:00+10:00,2023-08-11,23:49,2,12,14
79,2023-08-11T23:50:00+10:00,2023-08-11,23:50,1,20,21
85,2023-08-11T23:47:00+10:00,2023-08-11,23:47,0,2,2
86,2023-08-11T23:41:00+10:00,2023-08-11,23:41,1,0,1
86,2023-08-11T23:47:00+10:00,2023-08-11,23:47,1,0,1
109,2023-08-11T23:40:00+10:00,2023-08-11,23:40,6,6,12
109,2023-08-11T23:45:00+10:00,2023-08-11,23:45,1,3,4
109,2023-08-11T23:50:00+10:00,2023-08-11,23:50,2,3,5
117,2023-08-11T23:50:00+10:00,2023-08-11,23:50,7,4,11
122,2023-08-11T23:40:00+10:00,2023-08-11,23:40,8,1,9
122,2023-08-11T23:53:00+10:00,2023-08-11,23:53,0,1,1
3,2023-08-11T23:10:00+10:00,2023-08-11,23:10,7,18,25
3,2023-08-11T23:15:00+10:00,2023-08-11,23:15,19,16,35
3,2023-08-11T23:20:00+10:00,2023-08-11,23:20,10,18,28
3,2023-08-11T23:23:00+10:00,2023-08-11,23:23,8,9,17
4,2023-08-11T23:10:00+10:00,2023-08-11,23:10,24,7,31
4,2023-08-11T23:11:00+10:00,2023-08-11,23:11,14,19,33
4,2023-08-11T23:13:00+10:00,2023-08-11,23:13,19,7,26
4,2023-08-11T23:14:00+10:00,2023-08-11,23:14,26,9,35
4,2023-08-11T23:18:00+10:00,2023-08-11,23:18,24,7,31
4,2023-08-11T23:21:00+10:00,2023-08-11,23:21,31,12,43
4,2023-08-11T23:22:00+10:00,2023-08-11,23:22,16,10,26
6,2023-08-11T23:11:00+10:00,2023-08-11,23:11,5,8,13
6,2023-08-11T23:13:00+10:00,2023-08-11,23:13,12,6,18
6,2023-08-11T23:16:00+10:00,2023-08-11,23:16,14,8,22
6,2023-08-11T23:19:00+10:00,2023-08-11,23:19,14,5,19
6,2023-08-11T23:22:00+10:00,2023-08-11,23:22,16,12,28
6,2023-08-11T23:24:00+10:00,2023-08-11,23:24,2,21,23
8,2023-08-11T23:10:00+10:00,2023-08-11,23:10,0,1,1
8,2023-08-11T23:15:00+10:00,2023-08-11,23:15,0,1,1
8,2023-08-11T23:18:00+10:00,2023-08-11,23:18,3,1,4
14,2023-08-11T23:10:00+10:00,2023-08-11,23:10,2,18,20
14,2023-08-11T23:11:00+10:00,2023-08-11,23:11,1,18,19
14,2023-08-11T23:12:00+10:00,2023-08-11,23:12,16,15,31
14,2023-08-11T23:14:00+10:00,2023-08-11,23:14,6,14,20
14,2023-08-11T23:16:00+10:00,2023-08-11,23:16,12,14,26
14,2023-08-11T23:17:00+10:00,2023-08-11,23:17,16,15,31
14,2023-08-11T23:19:00+10:00,2023-08-11,23:19,9,1,10
14,2023-08-11T23:21:00+10:00,2023-08-11,23:21,3,6,9
14,2023-08-11T23:23:00+10:00,2023-08-11,23:23,3,4,7
21,2023-08-11T23:13:00+10:00,2023-08-11,23:13,6,8,14
21,2023-08-11T23:16:00+10:00,2023-08-11,23:16,9,5,14
21,2023-08-11T23:19:00+10:00,2023-08-11,23:19,5,17,22
21,2023-08-11T23:20:00+10:00,2023-08-11,23:20,7,3,10
21,2023-08-11T23:23:00+10:00,2023-08-11,23:23,7,0,7
28,2023-08-11T23:13:00+10:00,2023-08-11,23:13,13,6,19
28,2023-08-11T23:19:00+10:00,2023-08-11,23:19,18,1,19
28,2023-08-11T23:20:00+10:00,2023-08-11,23:20,10,5,15
28,2023-08-11T23:22:00+10:00,2023-08-11,23:22,17,1,18
29,2023-08-11T23:12:00+10:00,2023-08-11,23:12,1,23,24
29,2023-08-11T23:19:00+10:00,2023-08-11,23:19,2,3,5
29,2023-08-11T23:21:00+10:00,2023-08-11,23:21,1,15,16
39,2023-08-11T23:13:00+10:00,2023-08-11,23:13,1,5,6
39,2023-08-11T23:14:00+10:00,2023-08-11,23:14,4,0,4
39,2023-08-11T23:20:00+10:00,2023-08-11,23:20,3,3,6
39,2023-08-11T23:22:00+10:00,2023-08-11,23:22,0,1,1
39,2023-08-11T23:24:00+10:00,2023-08-11,23:24,4,1,5
41,2023-08-11T23:10:00+10:00,2023-08-11,23:10,35,19,54
41,2023-08-11T23:21:00+10:00,2023-08-11,23:21,28,11,39
41,2023-08-11T23:24:00+10:00,2023-08-11,23:24,15,13,28
54,2023-08-11T23:13:00+10:00,2023-08-11,23:13,3,0,3
54,2023-08-11T23:16:00+10:00,2023-08-11,23:16,6,3,9
54,2023-08-11T23:22:00+10:00,2023-08-11,23:22,3,0,3
55,2023-08-11T23:11:00+10:00,2023-08-11,23:11,7,4,11
55,2023-08-11T23:13:00+10:00,2023-08-11,23:13,5,6,11
55,2023-08-11T23:16:00+10:00,2023-08-11,23:16,6,9,15
55,2023-08-11T23:18:00+10:00,2023-08-11,23:18,20,7,27
55,2023-08-11T23:19:00+10:00,2023-08-11,23:19,3,8,11
55,2023-08-11T23:20:00+10:00,2023-08-11,23:20,8,10,18
55,2023-08-11T23:23:00+10:00,2023-08-11,23:23,32,13,45
61,2023-08-11T23:12:00+10:00,2023-08-11,23:12,1,2,3
61,2023-08-11T23:14:00+10:00,2023-08-11,23:14,5,3,8
61,2023-08-11T23:16:00+10:00,2023-08-11,23:16,5,0,5
61,2023-08-11T23:17:00+10:00,2023-08-11,23:17,5,4,9
61,2023-08-11T23:21:00+10:00,2023-08-11,23:21,4,0,4
61,2023-08-11T23:22:00+10:00,2023-08-11,23:22,0,9,9
61,2023-08-11T23:23:00+10:00,2023-08-11,23:23,3,2,5
61,2023-08-11T23:24:00+10:00,2023-08-11,23:24,5,6,11
65,2023-08-11T23:10:00+10:00,2023-08-11,23:10,16,5,21
65,2023-08-11T23:21:00+10:00,2023-08-11,23:21,13,6,19
66,2023-08-11T23:11:00+10:00,2023-08-11,23:11,21,8,29
66,2023-08-11T23:15:00+10:00,2023-08-11,23:15,6,12,18
66,2023-08-11T23:16:00+10:00,2023-08-11,23:16,4,8,12
66,2023-08-11T23:18:00+10:00,2023-08-11,23:18,23,4,27
66,2023-08-11T23:20:00+10:00,2023-08-11,23:20,8,8,16
66,2023-08-11T23:24:00+10:00,2023-08-11,23:24,13,2,15
69,2023-08-11T23:17:00+10:00,2023-08-11,23:17,0,1,1
69,2023-08-11T23:24:00+10:00,2023-08-11,23:24,1,0,1
75,2023-08-11T23:18:00+10:00,2023-08-11,23:18,0,1,1
75,2023-08-11T23:23:00+10:00,2023-08-11,23:23,0,2,2
77,2023-08-11T23:10:00+10:00,2023-08-11,23:10,1,0,1
77,2023-08-11T23:12:00+10:00,2023-08-11,23:12,1,5,6
77,2023-08-11T23:19:00+10:00,2023-08-11,23:19,3,0,3
84,2023-08-11T23:15:00+10:00,2023-08-11,23:15,78,59,137
87,2023-08-11T23:10:00+10:00,2023-08-11,23:10,3,0,3
87,2023-08-11T23:20:00+10:00,2023-08-11,23:20,0,1,1
87,2023-08-11T23:21:00+10:00,2023-08-11,23:21,0,3,3
107,2023-08-11T23:20:00+10:00,2023-08-11,23:20,6,1,7
108,2023-08-11T23:10:00+10:00,2023-08-11,23:10,0,4,4
108,2023-08-11T23:14:00+10:00,2023-08-11,23:14,2,1,3
108,2023-08-11T23:18:00+10:00,2023-08-11,23:18,2,0,2
108,2023-08-11T23:19:00+10:00,2023-08-11,23:19,3,4,7
108,2023-08-11T23:22:00+10:00,2023-08-11,23:22,1,0,1
108,2023-08-11T23:24:00+10:00,2023-08-11,23:24,4,2,6
118,2023-08-11T23:10:00+10:00,2023-08-11,23:10,13,6,19
1,2023-08-11T23:10:00+10:00,2023-08-11,23:10,1,0,1
1,2023-08-11T23:14:00+10:00,2023-08-11,23:14,6,5,11
1,2023-08-11T23:16:00+10:00,2023-08-11,23:16,4,5,9
1,2023-08-11T23:17:00+10:00,2023-08-11,23:17,0,6,6
2,2023-08-11T23:11:00+10:00,2023-08-11,23:11,1,7,8
2,2023-08-11T23:15:00+10:00,2023-08-11,23:15,0,3,3
2,2023-08-11T23:20:00+10:00,2023-08-11,23:20,3,1,4
2,2023-08-11T23:21:00+10:00,2023-08-11,23:21,0,14,14
2,2023-08-11T23:24:00+10:00,2023-08-11,23:24,0,1,1
7,2023-08-11T23:11:00+10:00,2023-08-11,23:11,3,115,118
7,2023-08-11T23:13:00+10:00,2023-08-11,23:13,0,32,32
7,2023-08-11T23:16:00+10:00,2023-08-11,23:16,0,18,18
7,2023-08-11T23:21:00+10:00,2023-08-11,23:21,0,28,28
9,2023-08-11T23:10:00+10:00,2023-08-11,23:10,1,0,1
9,2023-08-11T23:13:00+10:00,2023-08-11,23:13,0,2,2
9,2023-08-11T23:16:00+10:00,2023-08-11,23:16,1,1,2
9,2023-08-11T23:19:00+10:00,2023-08-11,23:19,0,2,2
9,2023-08-11T23:21:00+10:00,2023-08-11,23:21,1,0,1
9,2023-08-11T23:22:00+10:00,2023-08-11,23:22,0,2,2
10,2023-08-11T23:13:00+10:00,2023-08-11,23:13,2,0,2
10,2023-08-11T23:14:00+10:00,2023-08-11,23:14,2,0,2
10,2023-08-11T23:22:00+10:00,2023-08-11,23:22,3,0,3
11,2023-08-11T23:20:00+10:00,2023-08-11,23:20,5,0,5
12,2023-08-11T23:10:00+10:00,2023-08-11,23:10,0,3,3
12,2023-08-11T23:17:00+10:00,2023-08-11,23:17,0,1,1
12,2023-08-11T23:21:00+10:00,2023-08-11,23:21,3,0,3
17,2023-08-11T23:10:00+10:00,2023-08-11,23:10,8,2,10
17,2023-08-11T23:13:00+10:00,2023-08-11,23:13,1,6,7
17,2023-08-11T23:18:00+10:00,2023-08-11,23:18,2,0,2
17,2023-08-11T23:19:00+10:00,2023-08-11,23:19,18,4,22
17,2023-08-11T23:20:00+10:00,2023-08-11,23:20,0,5,5
17,2023-08-11T23:21:00+10:00,2023-08-11,23:21,2,1,3
17,2023-08-11T23:22:00+10:00,2023-08-11,23:22,1,2,3
24,2023-08-11T23:22:00+10:00,2023-08-11,23:22,1,8,9
27,2023-08-11T23:11:00+10:00,2023-08-11,23:11,0,1,1
27,2023-08-11T23:12:00+10:00,2023-08-11,23:12,1,0,1
35,2023-08-11T23:17:00+10:00,2023-08-11,23:17,5,72,77
35,2023-08-11T23:20:00+10:00,2023-08-11,23:20,7,53,60
53,2023-08-11T23:16:00+10:00,2023-08-11,23:16,1,5,6
56,2023-08-11T23:10:00+10:00,2023-08-11,23:10,0,1,1
56,2023-08-11T23:16:00+10:00,2023-08-11,23:16,1,0,1
56,2023-08-11T23:17:00+10:00,2023-08-11,23:17,0,1,1
56,2023-08-11T23:18:00+10:00,2023-08-11,23:18,2,1,3
56,2023-08-11T23:20:00+10:00,2023-08-11,23:20,1,2,3
56,2023-08-11T23:21:00+10:00,2023-08-11,23:21,0,3,3
56,2023-08-11T23:23:00+10:00,2023-08-11,23:23,2,1,3
56,2023-08-11T23:24:00+10:00,2023-08-11,23:24,0,1,1
57,2023-08-11T23:14:00+10:00,2023-08-11,23:14,1,1,2
57,2023-08-11T23:16:00+10:00,2023-08-11,23:16,1,0,1
57,2023-08-11T23:21:00+10:00,2023-08-11,23:21,0,4,4
57,2023-08-11T23:23:00+10:00,2023-08-11,23:23,0,1,1
58,2023-08-11T23:13:00+10:00,2023-08-11,23:13,4,2,6
58,2023-08-11T23:14:00+10:00,2023-08-11,23:14,6,1,7
58,2023-08-11T23:15:00+10:00,2023-08-11,23:15,1,1,2
58,2023-08-11T23:17:00+10:00,2023-08-11,23:17,7,4,11
58,2023-08-11T23:18:00+10:00,2023-08-11,23:18,8,13,21
58,2023-08-11T23:23:00+10:00,2023-08-11,23:23,2,2,4
62,2023-08-11T23:12:00+10:00,2023-08-11,23:12,3,1,4
62,2023-08-11T23:13:00+10:00,2023-08-11,23:13,7,3,10
62,2023-08-11T23:15:00+10:00,2023-08-11,23:15,2,0,2
62,2023-08-11T23:16:00+10:00,2023-08-11,23:16,7,0,7
62,2023-08-11T23:23:00+10:00,2023-08-11,23:23,5,2,7
62,2023-08-11T23:24:00+10:00,2023-08-11,23:24,1,0,1
63,2023-08-11T23:12:00+10:00,2023-08-11,23:12,4,8,12
63,2023-08-11T23:15:00+10:00,2023-08-11,23:15,1,2,3
63,2023-08-11T23:18:00+10:00,2023-08-11,23:18,2,6,8
63,2023-08-11T23:21:00+10:00,2023-08-11,23:21,7,7,14
67,2023-08-11T23:14:00+10:00,2023-08-11,23:14,2,3,5
67,2023-08-11T23:15:00+10:00,2023-08-11,23:15,7,7,14
67,2023-08-11T23:17:00+10:00,2023-08-11,23:17,1,9,10
67,2023-08-11T23:19:00+10:00,2023-08-11,23:19,3,2,5
67,2023-08-11T23:22:00+10:00,2023-08-11,23:22,3,15,18
68,2023-08-11T23:18:00+10:00,2023-08-11,23:18,1,0,1
68,2023-08-11T23:22:00+10:00,2023-08-11,23:22,5,0,5
72,2023-08-11T23:11:00+10:00,2023-08-11,23:11,3,39,42
72,2023-08-11T23:12:00+10:00,2023-08-11,23:12,13,37,50
72,2023-08-11T23:13:00+10:00,2023-08-11,23:13,7,40,47
72,2023-08-11T23:14:00+10:00,2023-08-11,23:14,3,77,80
72,2023-08-11T23:19:00+10:00,2023-08-11,23:19,4,7,11
72,2023-08-11T23:21:00+10:00,2023-08-11,23:21,3,29,32
79,2023-08-11T23:10:00+10:00,2023-08-11,23:10,5,41,46
79,2023-08-11T23:14:00+10:00,2023-08-11,23:14,4,55,59
79,2023-08-11T23:16:00+10:00,2023-08-11,23:16,2,20,22
79,2023-08-11T23:17:00+10:00,2023-08-11,23:17,12,41,53
79,2023-08-11T23:19:00+10:00,2023-08-11,23:19,1,60,61
79,2023-08-11T23:21:00+10:00,2023-08-11,23:21,3,58,61
109,2023-08-11T23:20:00+10:00,2023-08-11,23:20,5,5,10
122,2023-08-11T23:11:00+10:00,2023-08-11,23:11,0,2,2
122,2023-08-11T23:13:00+10:00,2023-08-11,23:13,0,6,6
3,2023-08-11T23:25:00+10:00,2023-08-11,23:25,7,4,11
3,2023-08-11T23:26:00+10:00,2023-08-11,23:26,6,17,23
3,2023-08-11T23:27:00+10:00,2023-08-11,23:27,15,9,24
3,2023-08-11T23:30:00+10:00,2023-08-11,23:30,24,9,33
3,2023-08-11T23:32:00+10:00,2023-08-11,23:32,25,8,33
3,2023-08-11T23:38:00+10:00,2023-08-11,23:38,19,15,34
3,2023-08-11T23:39:00+10:00,2023-08-11,23:39,9,8,17
4,2023-08-11T23:36:00+10:00,2023-08-11,23:36,10,14,24
4,2023-08-11T23:38:00+10:00,2023-08-11,23:38,3,9,12
6,2023-08-11T23:27:00+10:00,2023-08-11,23:27,20,1,21
6,2023-08-11T23:28:00+10:00,2023-08-11,23:28,3,9,12
6,2023-08-11T23:34:00+10:00,2023-08-11,23:34,5,3,8
8,2023-08-11T23:34:00+10:00,2023-08-11,23:34,2,8,10
8,2023-08-11T23:39:00+10:00,2023-08-11,23:39,0,8,8
14,2023-08-11T23:25:00+10:00,2023-08-11,23:25,3,0,3
14,2023-08-11T23:27:00+10:00,2023-08-11,23:27,3,7,10
14,2023-08-11T23:31:00+10:00,2023-08-11,23:31,6,9,15
14,2023-08-11T23:32:00+10:00,2023-08-11,23:32,7,6,13
14,2023-08-11T23:34:00+10:00,2023-08-11,23:34,7,0,7
14,2023-08-11T23:35:00+10:00,2023-08-11,23:35,8,4,12
14,2023-08-11T23:36:00+10:00,2023-08-11,23:36,13,7,20
21,2023-08-11T23:26:00+10:00,2023-08-11,23:26,7,6,13
21,2023-08-11T23:27:00+10:00,2023-08-11,23:27,17,3,20
21,2023-08-11T23:28:00+10:00,2023-08-11,23:28,11,6,17
21,2023-08-11T23:29:00+10:00,2023-08-11,23:29,6,9,15
21,2023-08-11T23:32:00+10:00,2023-08-11,23:32,10,0,10
21,2023-08-11T23:33:00+10:00,2023-08-11,23:33,8,7,15
21,2023-08-11T23:34:00+10:00,2023-08-11,23:34,6,11,17
28,2023-08-11T23:29:00+10:00,2023-08-11,23:29,6,6,12
28,2023-08-11T23:30:00+10:00,2023-08-11,23:30,1,2,3
28,2023-08-11T23:32:00+10:00,2023-08-11,23:32,5,0,5
28,2023-08-11T23:37:00+10:00,2023-08-11,23:37,5,0,5
29,2023-08-11T23:26:00+10:00,2023-08-11,23:26,3,0,3
29,2023-08-11T23:28:00+10:00,2023-08-11,23:28,0,3,3
29,2023-08-11T23:30:00+10:00,2023-08-11,23:30,1,2,3
29,2023-08-11T23:31:00+10:00,2023-08-11,23:31,1,0,1
29,2023-08-11T23:33:00+10:00,2023-08-11,23:33,1,7,8
39,2023-08-11T23:28:00+10:00,2023-08-11,23:28,1,1,2
39,2023-08-11T23:31:00+10:00,2023-08-11,23:31,0,1,1
39,2023-08-11T23:36:00+10:00,2023-08-11,23:36,1,0,1
41,2023-08-11T23:27:00+10:00,2023-08-11,23:27,19,16,35
41,2023-08-11T23:28:00+10:00,2023-08-11,23:28,10,25,35
41,2023-08-11T23:30:00+10:00,2023-08-11,23:30,10,14,24
41,2023-08-11T23:32:00+10:00,2023-08-11,23:32,21,17,38
41,2023-08-11T23:33:00+10:00,2023-08-11,23:33,12,7,19
41,2023-08-11T23:34:00+10:00,2023-08-11,23:34,17,14,31
41,2023-08-11T23:36:00+10:00,2023-08-11,23:36,12,14,26
41,2023-08-11T23:38:00+10:00,2023-08-11,23:38,17,19,36
41,2023-08-11T23:39:00+10:00,2023-08-11,23:39,2,11,13
54,2023-08-11T23:25:00+10:00,2023-08-11,23:25,2,1,3
54,2023-08-11T23:28:00+10:00,2023-08-11,23:28,2,0,2
54,2023-08-11T23:33:00+10:00,2023-08-11,23:33,1,1,2
54,2023-08-11T23:34:00+10:00,2023-08-11,23:34,1,0,1
55,2023-08-11T23:26:00+10:00,2023-08-11,23:26,15,2,17
55,2023-08-11T23:27:00+10:00,2023-08-11,23:27,3,6,9
55,2023-08-11T23:28:00+10:00,2023-08-11,23:28,15,7,22
55,2023-08-11T23:31:00+10:00,2023-08-11,23:31,3,9,12
55,2023-08-11T23:32:00+10:00,2023-08-11,23:32,26,26,52
55,2023-08-11T23:37:00+10:00,2023-08-11,23:37,13,1,14
55,2023-08-11T23:38:00+10:00,2023-08-11,23:38,19,2,21
55,2023-08-11T23:39:00+10:00,2023-08-11,23:39,6,15,21
61,2023-08-11T23:25:00+10:00,2023-08-11,23:25,6,10,16
61,2023-08-11T23:28:00+10:00,2023-08-11,23:28,3,2,5
61,2023-08-11T23:34:00+10:00,2023-08-11,23:34,6,2,8
61,2023-08-11T23:36:00+10:00,2023-08-11,23:36,0,2,2
61,2023-08-11T23:37:00+10:00,2023-08-11,23:37,0,4,4
61,2023-08-11T23:38:00+10:00,2023-08-11,23:38,0,1,1
65,2023-08-11T23:26:00+10:00,2023-08-11,23:26,4,9,13
65,2023-08-11T23:27:00+10:00,2023-08-11,23:27,1,10,11
65,2023-08-11T23:30:00+10:00,2023-08-11,23:30,2,14,16
65,2023-08-11T23:31:00+10:00,2023-08-11,23:31,2,2,4
65,2023-08-11T23:33:00+10:00,2023-08-11,23:33,0,6,6
65,2023-08-11T23:36:00+10:00,2023-08-11,23:36,0,8,8
66,2023-08-11T23:27:00+10:00,2023-08-11,23:27,2,4,6
66,2023-08-11T23:28:00+10:00,2023-08-11,23:28,26,7,33
66,2023-08-11T23:37:00+10:00,2023-08-11,23:37,16,9,25
66,2023-08-11T23:39:00+10:00,2023-08-11,23:39,2,2,4
69,2023-08-11T23:26:00+10:00,2023-08-11,23:26,2,0,2
70,2023-08-11T23:26:00+10:00,2023-08-11,23:26,0,1,1
70,2023-08-11T23:33:00+10:00,2023-08-11,23:33,0,1,1
75,2023-08-11T23:27:00+10:00,2023-08-11,23:27,1,0,1
75,2023-08-11T23:29:00+10:00,2023-08-11,23:29,2,1,3
75,2023-08-11T23:34:00+10:00,2023-08-11,23:34,2,2,4
75,2023-08-11T23:38:00+10:00,2023-08-11,23:38,3,0,3
77,2023-08-11T23:35:00+10:00,2023-08-11,23:35,0,2,2
77,2023-08-11T23:39:00+10:00,2023-08-11,23:39,10,3,13
78,2023-08-11T23:39:00+10:00,2023-08-11,23:39,0,1,1
108,2023-08-11T23:25:00+10:00,2023-08-11,23:25,5,0,5
108,2023-08-11T23:27:00+10:00,2023-08-11,23:27,2,0,2
108,2023-08-11T23:29:00+10:00,2023-08-11,23:29,1,0,1
108,2023-08-11T23:33:00+10:00,2023-08-11,23:33,1,0,1
108,2023-08-11T23:35:00+10:00,2023-08-11,23:35,3,0,3
1,2023-08-11T23:25:00+10:00,2023-08-11,23:25,3,3,6
1,2023-08-11T23:31:00+10:00,2023-08-11,23:31,1,2,3
2,2023-08-11T23:26:00+10:00,2023-08-11,23:26,0,4,4
2,2023-08-11T23:27:00+10:00,2023-08-11,23:27,0,2,2
2,2023-08-11T23:32:00+10:00,2023-08-11,23:32,1,0,1
7,2023-08-11T23:25:00+10:00,2023-08-11,23:25,1,19,20
7,2023-08-11T23:26:00+10:00,2023-08-11,23:26,0,13,13
7,2023-08-11T23:28:00+10:00,2023-08-11,23:28,0,5,5
7,2023-08-11T23:29:00+10:00,2023-08-11,23:29,3,8,11
7,2023-08-11T23:31:00+10:00,2023-08-11,23:31,0,4,4
7,2023-08-11T23:32:00+10:00,2023-08-11,23:32,1,9,10
7,2023-08-11T23:33:00+10:00,2023-08-11,23:33,0,3,3
7,2023-08-11T23:35:00+10:00,2023-08-11,23:35,0,11,11
9,2023-08-11T23:32:00+10:00,2023-08-11,23:32,0,1,1
9,2023-08-11T23:35:00+10:00,2023-08-11,23:35,0,2,2
9,2023-08-11T23:36:00+10:00,2023-08-11,23:36,0,1,1
10,2023-08-11T23:31:00+10:00,2023-08-11,23:31,0,1,1
11,2023-08-11T23:30:00+10:00,2023-08-11,23:30,6,0,6
11,2023-08-11T23:32:00+10:00,2023-08-11,23:32,2,0,2
12,2023-08-11T23:28:00+10:00,2023-08-11,23:28,4,0,4
17,2023-08-11T23:33:00+10:00,2023-08-11,23:33,5,1,6
17,2023-08-11T23:34:00+10:00,2023-08-11,23:34,3,1,4
24,2023-08-11T23:29:00+10:00,2023-08-11,23:29,1,18,19
27,2023-08-11T23:28:00+10:00,2023-08-11,23:28,3,0,3
27,2023-08-11T23:29:00+10:00,2023-08-11,23:29,0,1,1
27,2023-08-11T23:34:00+10:00,2023-08-11,23:34,4,0,4
27,2023-08-11T23:38:00+10:00,2023-08-11,23:38,2,0,2
27,2023-08-11T23:39:00+10:00,2023-08-11,23:39,5,0,5
35,2023-08-11T23:25:00+10:00,2023-08-11,23:25,9,29,38
35,2023-08-11T23:31:00+10:00,2023-08-11,23:31,5,29,34
53,2023-08-11T23:26:00+10:00,2023-08-11,23:26,2,3,5
53,2023-08-11T23:27:00+10:00,2023-08-11,23:27,0,2,2
53,2023-08-11T23:28:00+10:00,2023-08-11,23:28,2,2,4
53,2023-08-11T23:29:00+10:00,2023-08-11,23:29,0,5,5
53,2023-08-11T23:34:00+10:00,2023-08-11,23:34,2,2,4
56,2023-08-11T23:25:00+10:00,2023-08-11,23:25,4,0,4
56,2023-08-11T23:32:00+10:00,2023-08-11,23:32,6,0,6
56,2023-08-11T23:39:00+10:00,2023-08-11,23:39,0,4,4
57,2023-08-11T23:28:00+10:00,2023-08-11,23:28,1,0,1
57,2023-08-11T23:36:00+10:00,2023-08-11,23:36,2,1,3
57,2023-08-11T23:39:00+10:00,2023-08-11,23:39,0,3,3
58,2023-08-11T23:28:00+10:00,2023-08-11,23:28,1,3,4
58,2023-08-11T23:29:00+10:00,2023-08-11,23:29,1,1,2
58,2023-08-11T23:35:00+10:00,2023-08-11,23:35,3,2,5
62,2023-08-11T23:25:00+10:00,2023-08-11,23:25,2,0,2
62,2023-08-11T23:26:00+10:00,2023-08-11,23:26,0,2,2
62,2023-08-11T23:29:00+10:00,2023-08-11,23:29,0,3,3
62,2023-08-11T23:31:00+10:00,2023-08-11,23:31,0,2,2
62,2023-08-11T23:34:00+10:00,2023-08-11,23:34,1,0,1
62,2023-08-11T23:35:00+10:00,2023-08-11,23:35,2,4,6
62,2023-08-11T23:36:00+10:00,2023-08-11,23:36,6,0,6
62,2023-08-11T23:39:00+10:00,2023-08-11,23:39,0,2,2
63,2023-08-11T23:26:00+10:00,2023-08-11,23:26,2,16,18
63,2023-08-11T23:29:00+10:00,2023-08-11,23:29,0,2,2
63,2023-08-11T23:31:00+10:00,2023-08-11,23:31,1,1,2
63,2023-08-11T23:33:00+10:00,2023-08-11,23:33,4,11,15
67,2023-08-11T23:25:00+10:00,2023-08-11,23:25,9,5,14
67,2023-08-11T23:27:00+10:00,2023-08-11,23:27,0,1,1
67,2023-08-11T23:29:00+10:00,2023-08-11,23:29,0,2,2
67,2023-08-11T23:32:00+10:00,2023-08-11,23:32,0,4,4
67,2023-08-11T23:34:00+10:00,2023-08-11,23:34,3,4,7
67,2023-08-11T23:35:00+10:00,2023-08-11,23:35,1,3,4
67,2023-08-11T23:37:00+10:00,2023-08-11,23:37,0,1,1
67,2023-08-11T23:39:00+10:00,2023-08-11,23:39,1,1,2
72,2023-08-11T23:25:00+10:00,2023-08-11,23:25,4,0,4
72,2023-08-11T23:31:00+10:00,2023-08-11,23:31,6,2,8
72,2023-08-11T23:32:00+10:00,2023-08-11,23:32,3,15,18
72,2023-08-11T23:35:00+10:00,2023-08-11,23:35,0,6,6
72,2023-08-11T23:38:00+10:00,2023-08-11,23:38,2,6,8
76,2023-08-11T23:31:00+10:00,2023-08-11,23:31,0,1,1
76,2023-08-11T23:36:00+10:00,2023-08-11,23:36,1,2,3
76,2023-08-11T23:38:00+10:00,2023-08-11,23:38,1,0,1
76,2023-08-11T23:39:00+10:00,2023-08-11,23:39,0,2,2
79,2023-08-11T23:27:00+10:00,2023-08-11,23:27,7,13,20
79,2023-08-11T23:29:00+10:00,2023-08-11,23:29,3,14,17
79,2023-08-11T23:34:00+10:00,2023-08-11,23:34,10,6,16
79,2023-08-11T23:37:00+10:00,2023-08-11,23:37,5,13,18
79,2023-08-11T23:38:00+10:00,2023-08-11,23:38,8,7,15
85,2023-08-11T23:33:00+10:00,2023-08-11,23:33,0,1,1
85,2023-08-11T23:37:00+10:00,2023-08-11,23:37,0,1,1
85,2023-08-11T23:39:00+10:00,2023-08-11,23:39,0,4,4
109,2023-08-11T23:35:00+10:00,2023-08-11,23:35,2,3,5
117,2023-08-11T23:25:00+10:00,2023-08-11,23:25,14,19,33
117,2023-08-11T23:35:00+10:00,2023-08-11,23:35,15,11,26
122,2023-08-11T23:32:00+10:00,2023-08-11,23:32,0,2,2
122,2023-08-11T23:34:00+10:00,2023-08-11,23:34,0,1,1
3,2023-08-12T05:15:00+10:00,2023-08-12,05:15,2,0,2
3,2023-08-12T05:19:00+10:00,2023-08-12,05:19,2,0,2
4,2023-08-12T05:12:00+10:00,2023-08-12,05:12,3,0,3
4,2023-08-12T05:13:00+10:00,2023-08-12,05:13,1,1,2
4,2023-08-12T05:14:00+10:00,2023-08-12,05:14,0,1,1
4,2023-08-12T05:15:00+10:00,2023-08-12,05:15,0,1,1
4,2023-08-12T05:16:00+10:00,2023-08-12,05:16,2,0,2
6,2023-08-12T05:10:00+10:00,2023-08-12,05:10,5,1,6
6,2023-08-12T05:11:00+10:00,2023-08-12,05:11,2,2,4
6,2023-08-12T05:17:00+10:00,2023-08-12,05:17,2,0,2
6,2023-08-12T05:22:00+10:00,2023-08-12,05:22,6,1,7
6,2023-08-12T05:23:00+10:00,2023-08-12,05:23,2,0,2
14,2023-08-12T05:11:00+10:00,2023-08-12,05:11,2,0,2
21,2023-08-12T05:12:00+10:00,2023-08-12,05:12,0,1,1
21,2023-08-12T05:22:00+10:00,2023-08-12,05:22,1,1,2
28,2023-08-12T05:12:00+10:00,2023-08-12,05:12,1,1,2
28,2023-08-12T05:18:00+10:00,2023-08-12,05:18,1,0,1
28,2023-08-12T05:21:00+10:00,2023-08-12,05:21,0,1,1
28,2023-08-12T05:24:00+10:00,2023-08-12,05:24,0,1,1
29,2023-08-12T05:14:00+10:00,2023-08-12,05:14,0,1,1
29,2023-08-12T05:17:00+10:00,2023-08-12,05:17,0,1,1
29,2023-08-12T05:19:00+10:00,2023-08-12,05:19,1,0,1
41,2023-08-12T05:12:00+10:00,2023-08-12,05:12,0,4,4
41,2023-08-12T05:13:00+10:00,2023-08-12,05:13,1,0,1
41,2023-08-12T05:16:00+10:00,2023-08-12,05:16,0,1,1
41,2023-08-12T05:24:00+10:00,2023-08-12,05:24,1,2,3
54,2023-08-12T05:12:00+10:00,2023-08-12,05:12,3,0,3
55,2023-08-12T05:11:00+10:00,2023-08-12,05:11,4,0,4
55,2023-08-12T05:12:00+10:00,2023-08-12,05:12,0,2,2
59,2023-08-12T05:10:00+10:00,2023-08-12,05:10,1,0,1
65,2023-08-12T05:23:00+10:00,2023-08-12,05:23,0,2,2
65,2023-08-12T05:24:00+10:00,2023-08-12,05:24,3,1,4
66,2023-08-12T05:11:00+10:00,2023-08-12,05:11,1,3,4
66,2023-08-12T05:16:00+10:00,2023-08-12,05:16,1,0,1
66,2023-08-12T05:20:00+10:00,2023-08-12,05:20,7,2,9
84,2023-08-12T05:10:00+10:00,2023-08-12,05:10,3,1,4
84,2023-08-12T05:15:00+10:00,2023-08-12,05:15,2,5,7
84,2023-08-12T05:20:00+10:00,2023-08-12,05:20,1,5,6
107,2023-08-12T05:10:00+10:00,2023-08-12,05:10,1,0,1
108,2023-08-12T05:19:00+10:00,2023-08-12,05:19,2,0,2
108,2023-08-12T05:20:00+10:00,2023-08-12,05:20,1,0,1
108,2023-08-12T05:22:00+10:00,2023-08-12,05:22,0,2,2
108,2023-08-12T05:23:00+10:00,2023-08-12,05:23,0,1,1
1,2023-08-12T05:13:00+10:00,2023-08-12,05:13,1,0,1
1,2023-08-12T05:16:00+10:00,2023-08-12,05:16,0,1,1
1,2023-08-12T05:21:00+10:00,2023-08-12,05:21,6,0,6
2,2023-08-12T05:11:00+10:00,2023-08-12,05:11,0,1,1
12,2023-08-12T05:17:00+10:00,2023-08-12,05:17,0,1,1
24,2023-08-12T05:16:00+10:00,2023-08-12,05:16,1,0,1
35,2023-08-12T05:15:00+10:00,2023-08-12,05:15,1,0,1
35,2023-08-12T05:16:00+10:00,2023-08-12,05:16,1,0,1
56,2023-08-12T05:11:00+10:00,2023-08-12,05:11,4,0,4
56,2023-08-12T05:12:00+10:00,2023-08-12,05:12,2,0,2
58,2023-08-12T05:13:00+10:00,2023-08-12,05:13,0,2,2
58,2023-08-12T05:20:00+10:00,2023-08-12,05:20,1,0,1
62,2023-08-12T05:10:00+10:00,2023-08-12,05:10,0,1,1
62,2023-08-12T05:12:00+10:00,2023-08-12,05:12,0,1,1
62,2023-08-12T05:14:00+10:00,2023-08-12,05:14,1,0,1
63,2023-08-12T05:16:00+10:00,2023-08-12,05:16,0,1,1
63,2023-08-12T05:19:00+10:00,2023-08-12,05:19,0,2,2
63,2023-08-12T05:22:00+10:00,2023-08-12,05:22,0,1,1
67,2023-08-12T05:19:00+10:00,2023-08-12,05:19,0,4,4
72,2023-08-12T05:15:00+10:00,2023-08-12,05:15,0,1,1
79,2023-08-12T05:10:00+10:00,2023-08-12,05:10,0,1,1
79,2023-08-12T05:11:00+10:00,2023-08-12,05:11,0,1,1
79,2023-08-12T05:19:00+10:00,2023-08-12,05:19,0,1,1
79,2023-08-12T05:20:00+10:00,2023-08-12,05:20,1,0,1
109,2023-08-12T05:10:00+10:00,2023-08-12,05:10,5,0,5
122,2023-08-12T05:19:00+10:00,2023-08-12,05:19,0,1,1
3,2023-08-12T04:57:00+10:00,2023-08-12,04:57,1,1,2
4,2023-08-12T04:56:00+10:00,2023-08-12,04:56,1,0,1
4,2023-08-12T04:57:00+10:00,2023-08-12,04:57,0,1,1
4,2023-08-12T04:58:00+10:00,2023-08-12,04:58,0,2,2
4,2023-08-12T05:04:00+10:00,2023-08-12,05:04,0,3,3
6,2023-08-12T04:55:00+10:00,2023-08-12,04:55,2,1,3
6,2023-08-12T04:57:00+10:00,2023-08-12,04:57,1,0,1
6,2023-08-12T05:02:00+10:00,2023-08-12,05:02,1,2,3
8,2023-08-12T04:59:00+10:00,2023-08-12,04:59,0,1,1
14,2023-08-12T04:57:00+10:00,2023-08-12,04:57,1,0,1
14,2023-08-12T05:01:00+10:00,2023-08-12,05:01,0,1,1
21,2023-08-12T04:57:00+10:00,2023-08-12,04:57,2,1,3
21,2023-08-12T05:01:00+10:00,2023-08-12,05:01,4,0,4
21,2023-08-12T05:03:00+10:00,2023-08-12,05:03,0,3,3
21,2023-08-12T05:04:00+10:00,2023-08-12,05:04,1,0,1
21,2023-08-12T05:07:00+10:00,2023-08-12,05:07,0,1,1
28,2023-08-12T05:03:00+10:00,2023-08-12,05:03,0,1,1
41,2023-08-12T04:55:00+10:00,2023-08-12,04:55,0,1,1
41,2023-08-12T04:57:00+10:00,2023-08-12,04:57,0,2,2
41,2023-08-12T04:59:00+10:00,2023-08-12,04:59,6,1,7
41,2023-08-12T05:00:00+10:00,2023-08-12,05:00,3,2,5
41,2023-08-12T05:09:00+10:00,2023-08-12,05:09,5,3,8
55,2023-08-12T04:58:00+10:00,2023-08-12,04:58,1,0,1
55,2023-08-12T05:03:00+10:00,2023-08-12,05:03,8,0,8
55,2023-08-12T05:07:00+10:00,2023-08-12,05:07,0,2,2
59,2023-08-12T05:05:00+10:00,2023-08-12,05:05,4,0,4
65,2023-08-12T05:04:00+10:00,2023-08-12,05:04,0,3,3
65,2023-08-12T05:06:00+10:00,2023-08-12,05:06,0,1,1
66,2023-08-12T05:01:00+10:00,2023-08-12,05:01,0,1,1
66,2023-08-12T05:03:00+10:00,2023-08-12,05:03,2,0,2
66,2023-08-12T05:07:00+10:00,2023-08-12,05:07,1,0,1
77,2023-08-12T04:57:00+10:00,2023-08-12,04:57,0,1,1
107,2023-08-12T05:00:00+10:00,2023-08-12,05:00,1,1,2
108,2023-08-12T05:09:00+10:00,2023-08-12,05:09,4,0,4
1,2023-08-12T05:02:00+10:00,2023-08-12,05:02,0,2,2
2,2023-08-12T05:01:00+10:00,2023-08-12,05:01,1,0,1
17,2023-08-12T05:06:00+10:00,2023-08-12,05:06,2,0,2
24,2023-08-12T04:56:00+10:00,2023-08-12,04:56,0,1,1
24,2023-08-12T05:06:00+10:00,2023-08-12,05:06,1,1,2
35,2023-08-12T05:05:00+10:00,2023-08-12,05:05,0,1,1
56,2023-08-12T04:55:00+10:00,2023-08-12,04:55,1,0,1
56,2023-08-12T05:00:00+10:00,2023-08-12,05:00,1,0,1
58,2023-08-12T05:08:00+10:00,2023-08-12,05:08,1,0,1
62,2023-08-12T04:57:00+10:00,2023-08-12,04:57,3,0,3
62,2023-08-12T05:06:00+10:00,2023-08-12,05:06,5,0,5
63,2023-08-12T05:00:00+10:00,2023-08-12,05:00,0,2,2
63,2023-08-12T05:02:00+10:00,2023-08-12,05:02,0,1,1
67,2023-08-12T05:04:00+10:00,2023-08-12,05:04,1,2,3
79,2023-08-12T04:57:00+10:00,2023-08-12,04:57,1,0,1
79,2023-08-12T05:06:00+10:00,2023-08-12,05:06,1,0,1
117,2023-08-12T05:00:00+10:00,2023-08-12,05:00,1,1,2
122,2023-08-12T04:59:00+10:00,2023-08-12,04:59,0,4,4
3,2023-08-12T05:26:00+10:00,2023-08-12,05:26,1,0,1
3,2023-08-12T05:27:00+10:00,2023-08-12,05:27,0,1,1
3,2023-08-12T05:32:00+10:00,2023-08-12,05:32,1,0,1
3,2023-08-12T05:37:00+10:00,2023-08-12,05:37,1,0,1
3,2023-08-12T05:38:00+10:00,2023-08-12,05:38,0,3,3
4,2023-08-12T05:27:00+10:00,2023-08-12,05:27,1,0,1
4,2023-08-12T05:29:00+10:00,2023-08-12,05:29,0,1,1
4,2023-08-12T05:33:00+10:00,2023-08-12,05:33,1,0,1
4,2023-08-12T05:36:00+10:00,2023-08-12,05:36,2,2,4
6,2023-08-12T05:27:00+10:00,2023-08-12,05:27,0,4,4
6,2023-08-12T05:28:00+10:00,2023-08-12,05:28,5,1,6
6,2023-08-12T05:33:00+10:00,2023-08-12,05:33,1,1,2
6,2023-08-12T05:36:00+10:00,2023-08-12,05:36,1,2,3
6,2023-08-12T05:38:00+10:00,2023-08-12,05:38,1,2,3
8,2023-08-12T05:37:00+10:00,2023-08-12,05:37,1,0,1
21,2023-08-12T05:29:00+10:00,2023-08-12,05:29,0,2,2
29,2023-08-12T05:32:00+10:00,2023-08-12,05:32,0,1,1
29,2023-08-12T05:34:00+10:00,2023-08-12,05:34,1,0,1
41,2023-08-12T05:27:00+10:00,2023-08-12,05:27,4,0,4
41,2023-08-12T05:30:00+10:00,2023-08-12,05:30,2,0,2
41,2023-08-12T05:31:00+10:00,2023-08-12,05:31,0,2,2
54,2023-08-12T05:37:00+10:00,2023-08-12,05:37,1,0,1
55,2023-08-12T05:30:00+10:00,2023-08-12,05:30,1,0,1
55,2023-08-12T05:33:00+10:00,2023-08-12,05:33,5,0,5
55,2023-08-12T05:36:00+10:00,2023-08-12,05:36,1,1,2
59,2023-08-12T05:35:00+10:00,2023-08-12,05:35,1,1,2
61,2023-08-12T05:32:00+10:00,2023-08-12,05:32,0,1,1
70,2023-08-12T05:30:00+10:00,2023-08-12,05:30,1,0,1
84,2023-08-12T05:30:00+10:00,2023-08-12,05:30,2,4,6
84,2023-08-12T05:35:00+10:00,2023-08-12,05:35,6,4,10
87,2023-08-12T05:37:00+10:00,2023-08-12,05:37,1,1,2
87,2023-08-12T05:38:00+10:00,2023-08-12,05:38,2,0,2
108,2023-08-12T05:32:00+10:00,2023-08-12,05:32,0,1,1
108,2023-08-12T05:39:00+10:00,2023-08-12,05:39,1,0,1
2,2023-08-12T05:31:00+10:00,2023-08-12,05:31,0,1,1
2,2023-08-12T05:32:00+10:00,2023-08-12,05:32,1,0,1
12,2023-08-12T05:32:00+10:00,2023-08-12,05:32,0,1,1
17,2023-08-12T05:25:00+10:00,2023-08-12,05:25,0,1,1
24,2023-08-12T05:31:00+10:00,2023-08-12,05:31,0,2,2
24,2023-08-12T05:33:00+10:00,2023-08-12,05:33,0,2,2
27,2023-08-12T05:39:00+10:00,2023-08-12,05:39,0,1,1
35,2023-08-12T05:27:00+10:00,2023-08-12,05:27,1,0,1
35,2023-08-12T05:32:00+10:00,2023-08-12,05:32,3,1,4
35,2023-08-12T05:35:00+10:00,2023-08-12,05:35,1,0,1
35,2023-08-12T05:38:00+10:00,2023-08-12,05:38,0,3,3
58,2023-08-12T05:34:00+10:00,2023-08-12,05:34,0,1,1
58,2023-08-12T05:39:00+10:00,2023-08-12,05:39,0,1,1
62,2023-08-12T05:25:00+10:00,2023-08-12,05:25,1,0,1
62,2023-08-12T05:39:00+10:00,2023-08-12,05:39,0,1,1
67,2023-08-12T05:28:00+10:00,2023-08-12,05:28,0,1,1
72,2023-08-12T05:30:00+10:00,2023-08-12,05:30,1,0,1
72,2023-08-12T05:34:00+10:00,2023-08-12,05:34,0,1,1
72,2023-08-12T05:36:00+10:00,2023-08-12,05:36,0,1,1
117,2023-08-12T05:30:00+10:00,2023-08-12,05:30,0,1,1
122,2023-08-12T05:31:00+10:00,2023-08-12,05:31,2,0,2
122,2023-08-12T05:36:00+10:00,2023-08-12,05:36,1,0,1
3,2023-08-12T05:41:00+10:00,2023-08-12,05:41,2,0,2
3,2023-08-12T05:50:00+10:00,2023-08-12,05:50,2,2,4
3,2023-08-12T05:53:00+10:00,2023-08-12,05:53,1,0,1
3,2023-08-12T05:54:00+10:00,2023-08-12,05:54,0,1,1
4,2023-08-12T05:44:00+10:00,2023-08-12,05:44,0,2,2
4,2023-08-12T05:46:00+10:00,2023-08-12,05:46,1,0,1
4,2023-08-12T05:49:00+10:00,2023-08-12,05:49,1,0,1
6,2023-08-12T05:42:00+10:00,2023-08-12,05:42,1,0,1
6,2023-08-12T05:48:00+10:00,2023-08-12,05:48,1,0,1
14,2023-08-12T05:40:00+10:00,2023-08-12,05:40,1,0,1
14,2023-08-12T05:47:00+10:00,2023-08-12,05:47,0,4,4
14,2023-08-12T05:53:00+10:00,2023-08-12,05:53,1,0,1
21,2023-08-12T05:52:00+10:00,2023-08-12,05:52,0,1,1
21,2023-08-12T05:54:00+10:00,2023-08-12,05:54,2,0,2
28,2023-08-12T05:52:00+10:00,2023-08-12,05:52,1,1,2
28,2023-08-12T05:53:00+10:00,2023-08-12,05:53,0,1,1
29,2023-08-12T05:43:00+10:00,2023-08-12,05:43,1,0,1
29,2023-08-12T05:45:00+10:00,2023-08-12,05:45,1,0,1
29,2023-08-12T05:46:00+10:00,2023-08-12,05:46,1,1,2
29,2023-08-12T05:47:00+10:00,2023-08-12,05:47,1,0,1
29,2023-08-12T05:48:00+10:00,2023-08-12,05:48,0,1,1
29,2023-08-12T05:52:00+10:00,2023-08-12,05:52,0,1,1
41,2023-08-12T05:44:00+10:00,2023-08-12,05:44,2,2,4
41,2023-08-12T05:45:00+10:00,2023-08-12,05:45,4,0,4
41,2023-08-12T05:49:00+10:00,2023-08-12,05:49,0,2,2
41,2023-08-12T05:51:00+10:00,2023-08-12,05:51,0,7,7
41,2023-08-12T05:52:00+10:00,2023-08-12,05:52,1,2,3
55,2023-08-12T05:46:00+10:00,2023-08-12,05:46,2,1,3
55,2023-08-12T05:47:00+10:00,2023-08-12,05:47,0,1,1
55,2023-08-12T05:54:00+10:00,2023-08-12,05:54,1,1,2
65,2023-08-12T05:48:00+10:00,2023-08-12,05:48,0,1,1
66,2023-08-12T05:40:00+10:00,2023-08-12,05:40,2,0,2
66,2023-08-12T05:47:00+10:00,2023-08-12,05:47,0,1,1
66,2023-08-12T05:51:00+10:00,2023-08-12,05:51,0,1,1
66,2023-08-12T05:54:00+10:00,2023-08-12,05:54,0,1,1
77,2023-08-12T05:44:00+10:00,2023-08-12,05:44,2,0,2
77,2023-08-12T05:49:00+10:00,2023-08-12,05:49,2,0,2
107,2023-08-12T05:40:00+10:00,2023-08-12,05:40,1,0,1
108,2023-08-12T05:41:00+10:00,2023-08-12,05:41,0,2,2
108,2023-08-12T05:51:00+10:00,2023-08-12,05:51,0,2,2
108,2023-08-12T05:52:00+10:00,2023-08-12,05:52,0,1,1
118,2023-08-12T05:45:00+10:00,2023-08-12,05:45,0,1,1
1,2023-08-12T05:50:00+10:00,2023-08-12,05:50,1,0,1
9,2023-08-12T05:52:00+10:00,2023-08-12,05:52,0,1,1
17,2023-08-12T05:43:00+10:00,2023-08-12,05:43,0,2,2
17,2023-08-12T05:50:00+10:00,2023-08-12,05:50,1,0,1
17,2023-08-12T05:51:00+10:00,2023-08-12,05:51,1,0,1
17,2023-08-12T05:52:00+10:00,2023-08-12,05:52,1,1,2
24,2023-08-12T05:41:00+10:00,2023-08-12,05:41,3,0,3
35,2023-08-12T05:43:00+10:00,2023-08-12,05:43,1,0,1
35,2023-08-12T05:46:00+10:00,2023-08-12,05:46,0,2,2
35,2023-08-12T05:51:00+10:00,2023-08-12,05:51,0,1,1
56,2023-08-12T05:52:00+10:00,2023-08-12,05:52,2,0,2
58,2023-08-12T05:47:00+10:00,2023-08-12,05:47,1,1,2
58,2023-08-12T05:48:00+10:00,2023-08-12,05:48,1,0,1
58,2023-08-12T05:54:00+10:00,2023-08-12,05:54,2,0,2
62,2023-08-12T05:40:00+10:00,2023-08-12,05:40,1,1,2
62,2023-08-12T05:41:00+10:00,2023-08-12,05:41,0,1,1
62,2023-08-12T05:47:00+10:00,2023-08-12,05:47,0,6,6
62,2023-08-12T05:48:00+10:00,2023-08-12,05:48,1,0,1
62,2023-08-12T05:51:00+10:00,2023-08-12,05:51,1,0,1
62,2023-08-12T05:53:00+10:00,2023-08-12,05:53,2,7,9
62,2023-08-12T05:54:00+10:00,2023-08-12,05:54,0,1,1
63,2023-08-12T05:40:00+10:00,2023-08-12,05:40,0,1,1
63,2023-08-12T05:48:00+10:00,2023-08-12,05:48,0,1,1
67,2023-08-12T05:45:00+10:00,2023-08-12,05:45,1,1,2
67,2023-08-12T05:46:00+10:00,2023-08-12,05:46,0,2,2
72,2023-08-12T05:44:00+10:00,2023-08-12,05:44,1,2,3
72,2023-08-12T05:46:00+10:00,2023-08-12,05:46,0,1,1
72,2023-08-12T05:47:00+10:00,2023-08-12,05:47,0,2,2
79,2023-08-12T05:41:00+10:00,2023-08-12,05:41,3,0,3
79,2023-08-12T05:43:00+10:00,2023-08-12,05:43,1,0,1
85,2023-08-12T05:48:00+10:00,2023-08-12,05:48,1,0,1
109,2023-08-12T05:45:00+10:00,2023-08-12,05:45,2,0,2
122,2023-08-12T05:53:00+10:00,2023-08-12,05:53,0,1,1
3,2023-08-12T05:55:00+10:00,2023-08-12,05:55,0,2,2
3,2023-08-12T06:04:00+10:00,2023-08-12,06:04,1,0,1
3,2023-08-12T06:08:00+10:00,2023-08-12,06:08,1,0,1
4,2023-08-12T06:03:00+10:00,2023-08-12,06:03,1,0,1
4,2023-08-12T06:04:00+10:00,2023-08-12,06:04,1,0,1
4,2023-08-12T06:09:00+10:00,2023-08-12,06:09,0,1,1
6,2023-08-12T05:57:00+10:00,2023-08-12,05:57,2,2,4
6,2023-08-12T06:09:00+10:00,2023-08-12,06:09,1,2,3
14,2023-08-12T06:00:00+10:00,2023-08-12,06:00,0,1,1
28,2023-08-12T06:01:00+10:00,2023-08-12,06:01,1,0,1
28,2023-08-12T06:09:00+10:00,2023-08-12,06:09,0,1,1
29,2023-08-12T05:56:00+10:00,2023-08-12,05:56,1,0,1
29,2023-08-12T06:04:00+10:00,2023-08-12,06:04,1,0,1
29,2023-08-12T06:05:00+10:00,2023-08-12,06:05,1,0,1
41,2023-08-12T05:55:00+10:00,2023-08-12,05:55,0,1,1
41,2023-08-12T05:57:00+10:00,2023-08-12,05:57,2,2,4
41,2023-08-12T05:58:00+10:00,2023-08-12,05:58,1,1,2
41,2023-08-12T06:04:00+10:00,2023-08-12,06:04,1,3,4
41,2023-08-12T06:08:00+10:00,2023-08-12,06:08,7,1,8
41,2023-08-12T06:09:00+10:00,2023-08-12,06:09,3,0,3
55,2023-08-12T05:55:00+10:00,2023-08-12,05:55,0,1,1
55,2023-08-12T06:07:00+10:00,2023-08-12,06:07,0,1,1
59,2023-08-12T06:00:00+10:00,2023-08-12,06:00,0,2,2
61,2023-08-12T06:01:00+10:00,2023-08-12,06:01,1,0,1
65,2023-08-12T05:57:00+10:00,2023-08-12,05:57,0,1,1
66,2023-08-12T06:01:00+10:00,2023-08-12,06:01,0,1,1
75,2023-08-12T06:04:00+10:00,2023-08-12,06:04,0,1,1
75,2023-08-12T06:05:00+10:00,2023-08-12,06:05,1,0,1
84,2023-08-12T05:55:00+10:00,2023-08-12,05:55,2,5,7
84,2023-08-12T06:00:00+10:00,2023-08-12,06:00,1,0,1
108,2023-08-12T06:00:00+10:00,2023-08-12,06:00,1,0,1
1,2023-08-12T05:58:00+10:00,2023-08-12,05:58,3,0,3
2,2023-08-12T05:57:00+10:00,2023-08-12,05:57,0,1,1
2,2023-08-12T06:02:00+10:00,2023-08-12,06:02,0,1,1
7,2023-08-12T06:05:00+10:00,2023-08-12,06:05,1,0,1
9,2023-08-12T06:05:00+10:00,2023-08-12,06:05,1,2,3
10,2023-08-12T06:03:00+10:00,2023-08-12,06:03,1,1,2
12,2023-08-12T06:09:00+10:00,2023-08-12,06:09,1,1,2
17,2023-08-12T05:59:00+10:00,2023-08-12,05:59,0,2,2
17,2023-08-12T06:02:00+10:00,2023-08-12,06:02,1,0,1
24,2023-08-12T05:55:00+10:00,2023-08-12,05:55,2,1,3
24,2023-08-12T06:01:00+10:00,2023-08-12,06:01,3,2,5
35,2023-08-12T05:55:00+10:00,2023-08-12,05:55,1,0,1
35,2023-08-12T06:07:00+10:00,2023-08-12,06:07,2,0,2
53,2023-08-12T06:02:00+10:00,2023-08-12,06:02,1,0,1
56,2023-08-12T06:03:00+10:00,2023-08-12,06:03,1,0,1
58,2023-08-12T05:55:00+10:00,2023-08-12,05:55,1,0,1
58,2023-08-12T05:57:00+10:00,2023-08-12,05:57,1,0,1
62,2023-08-12T05:59:00+10:00,2023-08-12,05:59,0,1,1
62,2023-08-12T06:00:00+10:00,2023-08-12,06:00,0,3,3
62,2023-08-12T06:02:00+10:00,2023-08-12,06:02,0,2,2
62,2023-08-12T06:09:00+10:00,2023-08-12,06:09,0,3,3
63,2023-08-12T06:04:00+10:00,2023-08-12,06:04,0,1,1
67,2023-08-12T06:09:00+10:00,2023-08-12,06:09,1,1,2
68,2023-08-12T06:06:00+10:00,2023-08-12,06:06,1,1,2
72,2023-08-12T05:55:00+10:00,2023-08-12,05:55,0,1,1
72,2023-08-12T05:58:00+10:00,2023-08-12,05:58,2,0,2
72,2023-08-12T06:00:00+10:00,2023-08-12,06:00,1,0,1
72,2023-08-12T06:01:00+10:00,2023-08-12,06:01,0,1,1
79,2023-08-12T05:56:00+10:00,2023-08-12,05:56,0,2,2
109,2023-08-12T06:05:00+10:00,2023-08-12,06:05,0,1,1
122,2023-08-12T05:57:00+10:00,2023-08-12,05:57,1,0,1
122,2023-08-12T06:00:00+10:00,2023-08-12,06:00,0,1,1
3,2023-08-12T04:10:00+10:00,2023-08-12,04:10,1,0,1
3,2023-08-12T04:13:00+10:00,2023-08-12,04:13,1,2,3
3,2023-08-12T04:14:00+10:00,2023-08-12,04:14,0,4,4
3,2023-08-12T04:16:00+10:00,2023-08-12,04:16,1,0,1
3,2023-08-12T04:21:00+10:00,2023-08-12,04:21,1,0,1
3,2023-08-12T04:23:00+10:00,2023-08-12,04:23,1,0,1
4,2023-08-12T04:10:00+10:00,2023-08-12,04:10,1,3,4
4,2023-08-12T04:12:00+10:00,2023-08-12,04:12,0,1,1
4,2023-08-12T04:15:00+10:00,2023-08-12,04:15,0,1,1
4,2023-08-12T04:21:00+10:00,2023-08-12,04:21,2,0,2
6,2023-08-12T04:11:00+10:00,2023-08-12,04:11,0,1,1
6,2023-08-12T04:15:00+10:00,2023-08-12,04:15,0,3,3
6,2023-08-12T04:17:00+10:00,2023-08-12,04:17,2,1,3
6,2023-08-12T04:22:00+10:00,2023-08-12,04:22,1,2,3
6,2023-08-12T04:23:00+10:00,2023-08-12,04:23,1,0,1
14,2023-08-12T04:11:00+10:00,2023-08-12,04:11,1,0,1
14,2023-08-12T04:14:00+10:00,2023-08-12,04:14,4,0,4
14,2023-08-12T04:20:00+10:00,2023-08-12,04:20,1,0,1
14,2023-08-12T04:21:00+10:00,2023-08-12,04:21,1,0,1
14,2023-08-12T04:24:00+10:00,2023-08-12,04:24,1,0,1
21,2023-08-12T04:18:00+10:00,2023-08-12,04:18,0,2,2
29,2023-08-12T04:12:00+10:00,2023-08-12,04:12,0,1,1
41,2023-08-12T04:11:00+10:00,2023-08-12,04:11,0,1,1
41,2023-08-12T04:12:00+10:00,2023-08-12,04:12,4,0,4
41,2023-08-12T04:14:00+10:00,2023-08-12,04:14,1,2,3
41,2023-08-12T04:16:00+10:00,2023-08-12,04:16,0,1,1
41,2023-08-12T04:18:00+10:00,2023-08-12,04:18,4,0,4
41,2023-08-12T04:19:00+10:00,2023-08-12,04:19,0,2,2
54,2023-08-12T04:19:00+10:00,2023-08-12,04:19,1,0,1
54,2023-08-12T04:22:00+10:00,2023-08-12,04:22,1,0,1
55,2023-08-12T04:10:00+10:00,2023-08-12,04:10,0,1,1
55,2023-08-12T04:11:00+10:00,2023-08-12,04:11,0,1,1
55,2023-08-12T04:12:00+10:00,2023-08-12,04:12,3,0,3
55,2023-08-12T04:13:00+10:00,2023-08-12,04:13,1,0,1
55,2023-08-12T04:23:00+10:00,2023-08-12,04:23,5,6,11
59,2023-08-12T04:10:00+10:00,2023-08-12,04:10,0,1,1
59,2023-08-12T04:20:00+10:00,2023-08-12,04:20,3,1,4
61,2023-08-12T04:12:00+10:00,2023-08-12,04:12,2,0,2
61,2023-08-12T04:13:00+10:00,2023-08-12,04:13,1,0,1
61,2023-08-12T04:21:00+10:00,2023-08-12,04:21,1,0,1
66,2023-08-12T04:22:00+10:00,2023-08-12,04:22,0,1,1
75,2023-08-12T04:20:00+10:00,2023-08-12,04:20,1,0,1
1,2023-08-12T04:11:00+10:00,2023-08-12,04:11,0,1,1
1,2023-08-12T04:13:00+10:00,2023-08-12,04:13,1,0,1
1,2023-08-12T04:21:00+10:00,2023-08-12,04:21,3,0,3
9,2023-08-12T04:14:00+10:00,2023-08-12,04:14,1,0,1
24,2023-08-12T04:14:00+10:00,2023-08-12,04:14,0,3,3
24,2023-08-12T04:16:00+10:00,2023-08-12,04:16,1,1,2
27,2023-08-12T04:13:00+10:00,2023-08-12,04:13,0,1,1
35,2023-08-12T04:12:00+10:00,2023-08-12,04:12,0,1,1
35,2023-08-12T04:13:00+10:00,2023-08-12,04:13,0,1,1
35,2023-08-12T04:14:00+10:00,2023-08-12,04:14,0,1,1
35,2023-08-12T04:21:00+10:00,2023-08-12,04:21,0,3,3
56,2023-08-12T04:10:00+10:00,2023-08-12,04:10,2,0,2
56,2023-08-12T04:13:00+10:00,2023-08-12,04:13,0,1,1
56,2023-08-12T04:15:00+10:00,2023-08-12,04:15,1,0,1
56,2023-08-12T04:16:00+10:00,2023-08-12,04:16,1,0,1
57,2023-08-12T04:14:00+10:00,2023-08-12,04:14,0,1,1
58,2023-08-12T04:15:00+10:00,2023-08-12,04:15,1,1,2
58,2023-08-12T04:24:00+10:00,2023-08-12,04:24,0,1,1
62,2023-08-12T04:10:00+10:00,2023-08-12,04:10,3,0,3
62,2023-08-12T04:18:00+10:00,2023-08-12,04:18,2,0,2
62,2023-08-12T04:24:00+10:00,2023-08-12,04:24,1,1,2
63,2023-08-12T04:10:00+10:00,2023-08-12,04:10,1,0,1
63,2023-08-12T04:23:00+10:00,2023-08-12,04:23,0,1,1
67,2023-08-12T04:16:00+10:00,2023-08-12,04:16,0,1,1
67,2023-08-12T04:18:00+10:00,2023-08-12,04:18,0,2,2
72,2023-08-12T04:22:00+10:00,2023-08-12,04:22,0,1,1
79,2023-08-12T04:11:00+10:00,2023-08-12,04:11,0,2,2
79,2023-08-12T04:12:00+10:00,2023-08-12,04:12,1,3,4
79,2023-08-12T04:14:00+10:00,2023-08-12,04:14,0,1,1
79,2023-08-12T04:15:00+10:00,2023-08-12,04:15,1,2,3
3,2023-08-12T04:42:00+10:00,2023-08-12,04:42,0,1,1
3,2023-08-12T04:48:00+10:00,2023-08-12,04:48,1,0,1
3,2023-08-12T04:50:00+10:00,2023-08-12,04:50,0,1,1
4,2023-08-12T04:40:00+10:00,2023-08-12,04:40,4,0,4
4,2023-08-12T04:41:00+10:00,2023-08-12,04:41,1,0,1
4,2023-08-12T04:52:00+10:00,2023-08-12,04:52,0,1,1
6,2023-08-12T04:42:00+10:00,2023-08-12,04:42,2,0,2
6,2023-08-12T04:43:00+10:00,2023-08-12,04:43,1,6,7
6,2023-08-12T04:48:00+10:00,2023-08-12,04:48,1,0,1
6,2023-08-12T04:49:00+10:00,2023-08-12,04:49,2,1,3
6,2023-08-12T04:53:00+10:00,2023-08-12,04:53,1,0,1
14,2023-08-12T04:43:00+10:00,2023-08-12,04:43,3,4,7
21,2023-08-12T04:42:00+10:00,2023-08-12,04:42,2,0,2
21,2023-08-12T04:46:00+10:00,2023-08-12,04:46,0,1,1
21,2023-08-12T04:54:00+10:00,2023-08-12,04:54,0,1,1
28,2023-08-12T04:45:00+10:00,2023-08-12,04:45,4,0,4
29,2023-08-12T04:48:00+10:00,2023-08-12,04:48,0,1,1
41,2023-08-12T04:48:00+10:00,2023-08-12,04:48,0,2,2
41,2023-08-12T04:49:00+10:00,2023-08-12,04:49,1,1,2
41,2023-08-12T04:54:00+10:00,2023-08-12,04:54,1,0,1
54,2023-08-12T04:47:00+10:00,2023-08-12,04:47,1,0,1
55,2023-08-12T04:40:00+10:00,2023-08-12,04:40,1,1,2
55,2023-08-12T04:45:00+10:00,2023-08-12,04:45,1,1,2
55,2023-08-12T04:46:00+10:00,2023-08-12,04:46,1,1,2
55,2023-08-12T04:47:00+10:00,2023-08-12,04:47,0,1,1
55,2023-08-12T04:49:00+10:00,2023-08-12,04:49,1,0,1
55,2023-08-12T04:52:00+10:00,2023-08-12,04:52,1,0,1
61,2023-08-12T04:44:00+10:00,2023-08-12,04:44,1,0,1
61,2023-08-12T04:53:00+10:00,2023-08-12,04:53,1,0,1
65,2023-08-12T04:47:00+10:00,2023-08-12,04:47,1,2,3
1,2023-08-12T04:49:00+10:00,2023-08-12,04:49,0,1,1
1,2023-08-12T04:53:00+10:00,2023-08-12,04:53,1,2,3
1,2023-08-12T04:54:00+10:00,2023-08-12,04:54,0,1,1
24,2023-08-12T04:54:00+10:00,2023-08-12,04:54,1,4,5
35,2023-08-12T04:40:00+10:00,2023-08-12,04:40,0,1,1
35,2023-08-12T04:41:00+10:00,2023-08-12,04:41,1,0,1
35,2023-08-12T04:51:00+10:00,2023-08-12,04:51,0,1,1
53,2023-08-12T04:53:00+10:00,2023-08-12,04:53,0,1,1
56,2023-08-12T04:42:00+10:00,2023-08-12,04:42,0,1,1
56,2023-08-12T04:47:00+10:00,2023-08-12,04:47,1,0,1
58,2023-08-12T04:43:00+10:00,2023-08-12,04:43,1,0,1
58,2023-08-12T04:45:00+10:00,2023-08-12,04:45,1,0,1
58,2023-08-12T04:46:00+10:00,2023-08-12,04:46,2,2,4
62,2023-08-12T04:43:00+10:00,2023-08-12,04:43,1,0,1
62,2023-08-12T04:46:00+10:00,2023-08-12,04:46,3,0,3
62,2023-08-12T04:48:00+10:00,2023-08-12,04:48,0,2,2
62,2023-08-12T04:50:00+10:00,2023-08-12,04:50,0,1,1
63,2023-08-12T04:43:00+10:00,2023-08-12,04:43,0,2,2
72,2023-08-12T04:40:00+10:00,2023-08-12,04:40,0,2,2
79,2023-08-12T04:42:00+10:00,2023-08-12,04:42,2,0,2
79,2023-08-12T04:47:00+10:00,2023-08-12,04:47,0,1,1
79,2023-08-12T04:49:00+10:00,2023-08-12,04:49,0,1,1
79,2023-08-12T04:51:00+10:00,2023-08-12,04:51,0,1,1
79,2023-08-12T04:53:00+10:00,2023-08-12,04:53,0,2,2
117,2023-08-12T04:40:00+10:00,2023-08-12,04:40,0,2,2
3,2023-08-12T04:27:00+10:00,2023-08-12,04:27,0,2,2
3,2023-08-12T04:29:00+10:00,2023-08-12,04:29,0,4,4
3,2023-08-12T04:30:00+10:00,2023-08-12,04:30,1,0,1
3,2023-08-12T04:31:00+10:00,2023-08-12,04:31,3,2,5
3,2023-08-12T04:36:00+10:00,2023-08-12,04:36,3,1,4
4,2023-08-12T04:30:00+10:00,2023-08-12,04:30,0,2,2
4,2023-08-12T04:33:00+10:00,2023-08-12,04:33,1,2,3
4,2023-08-12T04:34:00+10:00,2023-08-12,04:34,0,1,1
6,2023-08-12T04:31:00+10:00,2023-08-12,04:31,1,0,1
6,2023-08-12T04:32:00+10:00,2023-08-12,04:32,0,1,1
6,2023-08-12T04:35:00+10:00,2023-08-12,04:35,1,0,1
6,2023-08-12T04:38:00+10:00,2023-08-12,04:38,2,2,4
14,2023-08-12T04:26:00+10:00,2023-08-12,04:26,1,0,1
14,2023-08-12T04:27:00+10:00,2023-08-12,04:27,1,0,1
14,2023-08-12T04:32:00+10:00,2023-08-12,04:32,1,0,1
14,2023-08-12T04:37:00+10:00,2023-08-12,04:37,2,0,2
21,2023-08-12T04:25:00+10:00,2023-08-12,04:25,2,0,2
41,2023-08-12T04:25:00+10:00,2023-08-12,04:25,0,1,1
41,2023-08-12T04:26:00+10:00,2023-08-12,04:26,2,0,2
41,2023-08-12T04:30:00+10:00,2023-08-12,04:30,1,0,1
41,2023-08-12T04:31:00+10:00,2023-08-12,04:31,2,2,4
41,2023-08-12T04:33:00+10:00,2023-08-12,04:33,1,1,2
41,2023-08-12T04:37:00+10:00,2023-08-12,04:37,0,2,2
41,2023-08-12T04:39:00+10:00,2023-08-12,04:39,1,0,1
54,2023-08-12T04:38:00+10:00,2023-08-12,04:38,1,0,1
55,2023-08-12T04:27:00+10:00,2023-08-12,04:27,1,0,1
59,2023-08-12T04:25:00+10:00,2023-08-12,04:25,2,0,2
61,2023-08-12T04:25:00+10:00,2023-08-12,04:25,0,1,1
65,2023-08-12T04:25:00+10:00,2023-08-12,04:25,0,2,2
65,2023-08-12T04:27:00+10:00,2023-08-12,04:27,0,2,2
65,2023-08-12T04:35:00+10:00,2023-08-12,04:35,1,0,1
66,2023-08-12T04:32:00+10:00,2023-08-12,04:32,2,0,2
84,2023-08-12T04:25:00+10:00,2023-08-12,04:25,12,12,24
84,2023-08-12T04:30:00+10:00,2023-08-12,04:30,3,3,6
107,2023-08-12T04:30:00+10:00,2023-08-12,04:30,2,0,2
1,2023-08-12T04:33:00+10:00,2023-08-12,04:33,1,3,4
2,2023-08-12T04:30:00+10:00,2023-08-12,04:30,0,2,2
9,2023-08-12T04:36:00+10:00,2023-08-12,04:36,1,0,1
17,2023-08-12T04:34:00+10:00,2023-08-12,04:34,1,0,1
24,2023-08-12T04:34:00+10:00,2023-08-12,04:34,1,0,1
24,2023-08-12T04:39:00+10:00,2023-08-12,04:39,0,1,1
27,2023-08-12T04:28:00+10:00,2023-08-12,04:28,0,1,1
35,2023-08-12T04:31:00+10:00,2023-08-12,04:31,0,1,1
35,2023-08-12T04:34:00+10:00,2023-08-12,04:34,2,0,2
56,2023-08-12T04:35:00+10:00,2023-08-12,04:35,1,0,1
57,2023-08-12T04:26:00+10:00,2023-08-12,04:26,0,1,1
62,2023-08-12T04:30:00+10:00,2023-08-12,04:30,0,4,4
63,2023-08-12T04:27:00+10:00,2023-08-12,04:27,0,2,2
67,2023-08-12T04:29:00+10:00,2023-08-12,04:29,1,0,1
67,2023-08-12T04:35:00+10:00,2023-08-12,04:35,1,0,1
76,2023-08-12T04:37:00+10:00,2023-08-12,04:37,0,1,1
79,2023-08-12T04:27:00+10:00,2023-08-12,04:27,1,0,1
117,2023-08-12T04:25:00+10:00,2023-08-12,04:25,0,1,1
3,2023-08-12T06:11:00+10:00,2023-08-12,06:11,0,2,2
3,2023-08-12T06:16:00+10:00,2023-08-12,06:16,4,2,6
3,2023-08-12T06:21:00+10:00,2023-08-12,06:21,1,0,1
4,2023-08-12T06:10:00+10:00,2023-08-12,06:10,3,0,3
4,2023-08-12T06:14:00+10:00,2023-08-12,06:14,3,1,4
4,2023-08-12T06:23:00+10:00,2023-08-12,06:23,0,2,2
6,2023-08-12T06:13:00+10:00,2023-08-12,06:13,0,2,2
6,2023-08-12T06:15:00+10:00,2023-08-12,06:15,1,1,2
6,2023-08-12T06:16:00+10:00,2023-08-12,06:16,1,0,1
6,2023-08-12T06:19:00+10:00,2023-08-12,06:19,1,1,2
6,2023-08-12T06:20:00+10:00,2023-08-12,06:20,0,1,1
6,2023-08-12T06:22:00+10:00,2023-08-12,06:22,1,2,3
6,2023-08-12T06:23:00+10:00,2023-08-12,06:23,2,1,3
8,2023-08-12T06:19:00+10:00,2023-08-12,06:19,1,0,1
14,2023-08-12T06:12:00+10:00,2023-08-12,06:12,0,1,1
14,2023-08-12T06:20:00+10:00,2023-08-12,06:20,2,0,2
21,2023-08-12T06:11:00+10:00,2023-08-12,06:11,0,1,1
21,2023-08-12T06:17:00+10:00,2023-08-12,06:17,0,1,1
28,2023-08-12T06:12:00+10:00,2023-08-12,06:12,0,1,1
28,2023-08-12T06:13:00+10:00,2023-08-12,06:13,1,0,1
28,2023-08-12T06:22:00+10:00,2023-08-12,06:22,2,0,2
29,2023-08-12T06:10:00+10:00,2023-08-12,06:10,2,1,3
29,2023-08-12T06:12:00+10:00,2023-08-12,06:12,1,0,1
29,2023-08-12T06:14:00+10:00,2023-08-12,06:14,1,0,1
41,2023-08-12T06:12:00+10:00,2023-08-12,06:12,3,2,5
41,2023-08-12T06:16:00+10:00,2023-08-12,06:16,1,4,5
41,2023-08-12T06:23:00+10:00,2023-08-12,06:23,2,0,2
55,2023-08-12T06:12:00+10:00,2023-08-12,06:12,1,1,2
55,2023-08-12T06:15:00+10:00,2023-08-12,06:15,1,2,3
55,2023-08-12T06:18:00+10:00,2023-08-12,06:18,2,3,5
55,2023-08-12T06:20:00+10:00,2023-08-12,06:20,1,1,2
61,2023-08-12T06:16:00+10:00,2023-08-12,06:16,1,0,1
65,2023-08-12T06:12:00+10:00,2023-08-12,06:12,0,1,1
65,2023-08-12T06:13:00+10:00,2023-08-12,06:13,1,0,1
65,2023-08-12T06:15:00+10:00,2023-08-12,06:15,0,1,1
65,2023-08-12T06:20:00+10:00,2023-08-12,06:20,0,1,1
66,2023-08-12T06:11:00+10:00,2023-08-12,06:11,1,0,1
66,2023-08-12T06:21:00+10:00,2023-08-12,06:21,3,0,3
69,2023-08-12T06:24:00+10:00,2023-08-12,06:24,1,0,1
75,2023-08-12T06:24:00+10:00,2023-08-12,06:24,1,0,1
77,2023-08-12T06:15:00+10:00,2023-08-12,06:15,0,1,1
77,2023-08-12T06:16:00+10:00,2023-08-12,06:16,1,0,1
77,2023-08-12T06:17:00+10:00,2023-08-12,06:17,0,1,1
84,2023-08-12T06:15:00+10:00,2023-08-12,06:15,7,5,12
87,2023-08-12T06:23:00+10:00,2023-08-12,06:23,1,0,1
107,2023-08-12T06:15:00+10:00,2023-08-12,06:15,0,1,1
108,2023-08-12T06:12:00+10:00,2023-08-12,06:12,0,1,1
108,2023-08-12T06:22:00+10:00,2023-08-12,06:22,0,2,2
108,2023-08-12T06:23:00+10:00,2023-08-12,06:23,0,1,1
1,2023-08-12T06:12:00+10:00,2023-08-12,06:12,0,1,1
17,2023-08-12T06:14:00+10:00,2023-08-12,06:14,1,1,2
18,2023-08-12T06:11:00+10:00,2023-08-12,06:11,0,1,1
24,2023-08-12T06:10:00+10:00,2023-08-12,06:10,0,3,3
24,2023-08-12T06:15:00+10:00,2023-08-12,06:15,6,1,7
24,2023-08-12T06:17:00+10:00,2023-08-12,06:17,1,1,2
24,2023-08-12T06:18:00+10:00,2023-08-12,06:18,3,0,3
24,2023-08-12T06:22:00+10:00,2023-08-12,06:22,0,2,2
27,2023-08-12T06:10:00+10:00,2023-08-12,06:10,0,3,3
27,2023-08-12T06:12:00+10:00,2023-08-12,06:12,3,0,3
27,2023-08-12T06:22:00+10:00,2023-08-12,06:22,0,1,1
35,2023-08-12T06:10:00+10:00,2023-08-12,06:10,1,0,1
35,2023-08-12T06:11:00+10:00,2023-08-12,06:11,0,1,1
35,2023-08-12T06:13:00+10:00,2023-08-12,06:13,1,0,1
35,2023-08-12T06:21:00+10:00,2023-08-12,06:21,2,1,3
53,2023-08-12T06:10:00+10:00,2023-08-12,06:10,1,0,1
56,2023-08-12T06:19:00+10:00,2023-08-12,06:19,0,1,1
56,2023-08-12T06:22:00+10:00,2023-08-12,06:22,0,1,1
56,2023-08-12T06:24:00+10:00,2023-08-12,06:24,1,0,1
57,2023-08-12T06:10:00+10:00,2023-08-12,06:10,0,1,1
58,2023-08-12T06:12:00+10:00,2023-08-12,06:12,0,1,1
62,2023-08-12T06:16:00+10:00,2023-08-12,06:16,0,1,1
62,2023-08-12T06:17:00+10:00,2023-08-12,06:17,0,1,1
62,2023-08-12T06:19:00+10:00,2023-08-12,06:19,3,0,3
62,2023-08-12T06:20:00+10:00,2023-08-12,06:20,4,0,4
62,2023-08-12T06:24:00+10:00,2023-08-12,06:24,2,1,3
63,2023-08-12T06:18:00+10:00,2023-08-12,06:18,0,1,1
63,2023-08-12T06:23:00+10:00,2023-08-12,06:23,1,0,1
67,2023-08-12T06:10:00+10:00,2023-08-12,06:10,1,0,1
67,2023-08-12T06:20:00+10:00,2023-08-12,06:20,1,0,1
67,2023-08-12T06:21:00+10:00,2023-08-12,06:21,1,0,1
68,2023-08-12T06:18:00+10:00,2023-08-12,06:18,1,0,1
72,2023-08-12T06:12:00+10:00,2023-08-12,06:12,0,1,1
72,2023-08-12T06:13:00+10:00,2023-08-12,06:13,0,2,2
72,2023-08-12T06:14:00+10:00,2023-08-12,06:14,1,0,1
72,2023-08-12T06:16:00+10:00,2023-08-12,06:16,0,2,2
72,2023-08-12T06:24:00+10:00,2023-08-12,06:24,1,0,1
79,2023-08-12T06:15:00+10:00,2023-08-12,06:15,0,1,1
79,2023-08-12T06:16:00+10:00,2023-08-12,06:16,0,2,2
109,2023-08-12T06:10:00+10:00,2023-08-12,06:10,1,0,1
117,2023-08-12T06:15:00+10:00,2023-08-12,06:15,0,2,2
117,2023-08-12T06:20:00+10:00,2023-08-12,06:20,2,0,2
122,2023-08-12T06:12:00+10:00,2023-08-12,06:12,0,1,1
122,2023-08-12T06:18:00+10:00,2023-08-12,06:18,1,0,1
3,2023-08-12T06:27:00+10:00,2023-08-12,06:27,0,1,1
3,2023-08-12T06:30:00+10:00,2023-08-12,06:30,1,0,1
3,2023-08-12T06:32:00+10:00,2023-08-12,06:32,1,0,1
3,2023-08-12T06:36:00+10:00,2023-08-12,06:36,3,2,5
3,2023-08-12T06:37:00+10:00,2023-08-12,06:37,1,0,1
4,2023-08-12T06:32:00+10:00,2023-08-12,06:32,1,0,1
4,2023-08-12T06:34:00+10:00,2023-08-12,06:34,0,1,1
4,2023-08-12T06:38:00+10:00,2023-08-12,06:38,0,2,2
6,2023-08-12T06:27:00+10:00,2023-08-12,06:27,1,1,2
6,2023-08-12T06:29:00+10:00,2023-08-12,06:29,1,1,2
6,2023-08-12T06:30:00+10:00,2023-08-12,06:30,2,1,3
6,2023-08-12T06:39:00+10:00,2023-08-12,06:39,0,1,1
14,2023-08-12T06:25:00+10:00,2023-08-12,06:25,0,1,1
14,2023-08-12T06:30:00+10:00,2023-08-12,06:30,1,0,1
14,2023-08-12T06:38:00+10:00,2023-08-12,06:38,2,1,3
28,2023-08-12T06:34:00+10:00,2023-08-12,06:34,1,0,1
39,2023-08-12T06:27:00+10:00,2023-08-12,06:27,1,0,1
41,2023-08-12T06:33:00+10:00,2023-08-12,06:33,2,2,4
55,2023-08-12T06:34:00+10:00,2023-08-12,06:34,0,7,7
61,2023-08-12T06:29:00+10:00,2023-08-12,06:29,1,0,1
61,2023-08-12T06:35:00+10:00,2023-08-12,06:35,0,2,2
61,2023-08-12T06:39:00+10:00,2023-08-12,06:39,0,1,1
65,2023-08-12T06:28:00+10:00,2023-08-12,06:28,0,3,3
65,2023-08-12T06:36:00+10:00,2023-08-12,06:36,0,2,2
65,2023-08-12T06:37:00+10:00,2023-08-12,06:37,2,0,2
65,2023-08-12T06:39:00+10:00,2023-08-12,06:39,0,1,1
66,2023-08-12T06:30:00+10:00,2023-08-12,06:30,0,1,1
66,2023-08-12T06:33:00+10:00,2023-08-12,06:33,0,3,3
75,2023-08-12T06:28:00+10:00,2023-08-12,06:28,1,0,1
87,2023-08-12T06:37:00+10:00,2023-08-12,06:37,2,0,2
107,2023-08-12T06:25:00+10:00,2023-08-12,06:25,4,0,4
107,2023-08-12T06:30:00+10:00,2023-08-12,06:30,4,5,9
107,2023-08-12T06:35:00+10:00,2023-08-12,06:35,4,7,11
108,2023-08-12T06:25:00+10:00,2023-08-12,06:25,0,1,1
108,2023-08-12T06:27:00+10:00,2023-08-12,06:27,0,1,1
108,2023-08-12T06:31:00+10:00,2023-08-12,06:31,2,1,3
108,2023-08-12T06:32:00+10:00,2023-08-12,06:32,0,2,2
108,2023-08-12T06:39:00+10:00,2023-08-12,06:39,0,1,1
1,2023-08-12T06:25:00+10:00,2023-08-12,06:25,1,0,1
2,2023-08-12T06:39:00+10:00,2023-08-12,06:39,0,1,1
9,2023-08-12T06:27:00+10:00,2023-08-12,06:27,1,0,1
9,2023-08-12T06:38:00+10:00,2023-08-12,06:38,1,0,1
11,2023-08-12T06:35:00+10:00,2023-08-12,06:35,2,0,2
12,2023-08-12T06:27:00+10:00,2023-08-12,06:27,1,0,1
12,2023-08-12T06:34:00+10:00,2023-08-12,06:34,2,0,2
12,2023-08-12T06:39:00+10:00,2023-08-12,06:39,1,0,1
17,2023-08-12T06:37:00+10:00,2023-08-12,06:37,1,0,1
17,2023-08-12T06:39:00+10:00,2023-08-12,06:39,2,0,2
24,2023-08-12T06:26:00+10:00,2023-08-12,06:26,1,1,2
24,2023-08-12T06:27:00+10:00,2023-08-12,06:27,1,3,4
24,2023-08-12T06:36:00+10:00,2023-08-12,06:36,2,2,4
24,2023-08-12T06:39:00+10:00,2023-08-12,06:39,3,1,4
27,2023-08-12T06:27:00+10:00,2023-08-12,06:27,0,2,2
35,2023-08-12T06:29:00+10:00,2023-08-12,06:29,1,1,2
35,2023-08-12T06:36:00+10:00,2023-08-12,06:36,1,0,1
53,2023-08-12T06:34:00+10:00,2023-08-12,06:34,1,0,1
56,2023-08-12T06:30:00+10:00,2023-08-12,06:30,0,1,1
56,2023-08-12T06:32:00+10:00,2023-08-12,06:32,1,0,1
57,2023-08-12T06:29:00+10:00,2023-08-12,06:29,0,1,1
57,2023-08-12T06:37:00+10:00,2023-08-12,06:37,1,0,1
58,2023-08-12T06:25:00+10:00,2023-08-12,06:25,1,2,3
58,2023-08-12T06:29:00+10:00,2023-08-12,06:29,0,1,1
58,2023-08-12T06:30:00+10:00,2023-08-12,06:30,1,1,2
58,2023-08-12T06:35:00+10:00,2023-08-12,06:35,3,0,3
62,2023-08-12T06:25:00+10:00,2023-08-12,06:25,2,0,2
62,2023-08-12T06:27:00+10:00,2023-08-12,06:27,1,1,2
62,2023-08-12T06:32:00+10:00,2023-08-12,06:32,0,2,2
62,2023-08-12T06:37:00+10:00,2023-08-12,06:37,1,0,1
62,2023-08-12T06:38:00+10:00,2023-08-12,06:38,4,0,4
67,2023-08-12T06:26:00+10:00,2023-08-12,06:26,0,1,1
67,2023-08-12T06:28:00+10:00,2023-08-12,06:28,1,0,1
67,2023-08-12T06:30:00+10:00,2023-08-12,06:30,0,1,1
67,2023-08-12T06:34:00+10:00,2023-08-12,06:34,2,0,2
68,2023-08-12T06:28:00+10:00,2023-08-12,06:28,1,0,1
68,2023-08-12T06:32:00+10:00,2023-08-12,06:32,1,0,1
72,2023-08-12T06:32:00+10:00,2023-08-12,06:32,0,2,2
72,2023-08-12T06:33:00+10:00,2023-08-12,06:33,0,2,2
72,2023-08-12T06:38:00+10:00,2023-08-12,06:38,0,1,1
79,2023-08-12T06:25:00+10:00,2023-08-12,06:25,1,2,3
79,2023-08-12T06:26:00+10:00,2023-08-12,06:26,1,0,1
79,2023-08-12T06:30:00+10:00,2023-08-12,06:30,1,0,1
79,2023-08-12T06:33:00+10:00,2023-08-12,06:33,0,1,1
79,2023-08-12T06:34:00+10:00,2023-08-12,06:34,3,1,4
85,2023-08-12T06:30:00+10:00,2023-08-12,06:30,0,1,1
109,2023-08-12T06:30:00+10:00,2023-08-12,06:30,2,1,3
122,2023-08-12T06:33:00+10:00,2023-08-12,06:33,0,1,1
3,2023-08-12T06:42:00+10:00,2023-08-12,06:42,2,0,2
3,2023-08-12T06:45:00+10:00,2023-08-12,06:45,0,3,3
3,2023-08-12T06:46:00+10:00,2023-08-12,06:46,2,0,2
3,2023-08-12T06:47:00+10:00,2023-08-12,06:47,0,1,1
3,2023-08-12T06:50:00+10:00,2023-08-12,06:50,1,0,1
3,2023-08-12T06:52:00+10:00,2023-08-12,06:52,1,2,3
3,2023-08-12T06:53:00+10:00,2023-08-12,06:53,1,1,2
4,2023-08-12T06:41:00+10:00,2023-08-12,06:41,0,1,1
4,2023-08-12T06:47:00+10:00,2023-08-12,06:47,2,0,2
4,2023-08-12T06:50:00+10:00,2023-08-12,06:50,1,0,1
6,2023-08-12T06:40:00+10:00,2023-08-12,06:40,0,1,1
6,2023-08-12T06:47:00+10:00,2023-08-12,06:47,0,1,1
6,2023-08-12T06:49:00+10:00,2023-08-12,06:49,3,0,3
8,2023-08-12T06:42:00+10:00,2023-08-12,06:42,0,1,1
8,2023-08-12T06:47:00+10:00,2023-08-12,06:47,1,0,1
14,2023-08-12T06:50:00+10:00,2023-08-12,06:50,1,3,4
14,2023-08-12T06:54:00+10:00,2023-08-12,06:54,1,0,1
21,2023-08-12T06:45:00+10:00,2023-08-12,06:45,0,1,1
21,2023-08-12T06:48:00+10:00,2023-08-12,06:48,0,1,1
21,2023-08-12T06:49:00+10:00,2023-08-12,06:49,1,5,6
28,2023-08-12T06:41:00+10:00,2023-08-12,06:41,1,0,1
28,2023-08-12T06:45:00+10:00,2023-08-12,06:45,2,0,2
29,2023-08-12T06:46:00+10:00,2023-08-12,06:46,0,4,4
29,2023-08-12T06:47:00+10:00,2023-08-12,06:47,0,1,1
39,2023-08-12T06:47:00+10:00,2023-08-12,06:47,1,0,1
41,2023-08-12T06:40:00+10:00,2023-08-12,06:40,1,2,3
41,2023-08-12T06:41:00+10:00,2023-08-12,06:41,8,3,11
41,2023-08-12T06:45:00+10:00,2023-08-12,06:45,1,2,3
41,2023-08-12T06:46:00+10:00,2023-08-12,06:46,6,1,7
41,2023-08-12T06:51:00+10:00,2023-08-12,06:51,0,2,2
41,2023-08-12T06:53:00+10:00,2023-08-12,06:53,3,4,7
54,2023-08-12T06:51:00+10:00,2023-08-12,06:51,0,1,1
55,2023-08-12T06:41:00+10:00,2023-08-12,06:41,4,2,6
55,2023-08-12T06:45:00+10:00,2023-08-12,06:45,1,2,3
55,2023-08-12T06:46:00+10:00,2023-08-12,06:46,1,2,3
55,2023-08-12T06:47:00+10:00,2023-08-12,06:47,2,3,5
55,2023-08-12T06:48:00+10:00,2023-08-12,06:48,3,1,4
61,2023-08-12T06:40:00+10:00,2023-08-12,06:40,0,2,2
61,2023-08-12T06:47:00+10:00,2023-08-12,06:47,0,1,1
65,2023-08-12T06:46:00+10:00,2023-08-12,06:46,1,1,2
65,2023-08-12T06:47:00+10:00,2023-08-12,06:47,1,1,2
65,2023-08-12T06:49:00+10:00,2023-08-12,06:49,1,2,3
65,2023-08-12T06:54:00+10:00,2023-08-12,06:54,0,1,1
66,2023-08-12T06:41:00+10:00,2023-08-12,06:41,0,1,1
66,2023-08-12T06:43:00+10:00,2023-08-12,06:43,2,0,2
70,2023-08-12T06:52:00+10:00,2023-08-12,06:52,0,1,1
77,2023-08-12T06:41:00+10:00,2023-08-12,06:41,0,1,1
84,2023-08-12T06:50:00+10:00,2023-08-12,06:50,8,6,14
107,2023-08-12T06:40:00+10:00,2023-08-12,06:40,0,4,4
107,2023-08-12T06:45:00+10:00,2023-08-12,06:45,1,3,4
1,2023-08-12T06:51:00+10:00,2023-08-12,06:51,1,0,1
2,2023-08-12T06:41:00+10:00,2023-08-12,06:41,2,1,3
2,2023-08-12T06:43:00+10:00,2023-08-12,06:43,0,2,2
2,2023-08-12T06:46:00+10:00,2023-08-12,06:46,1,0,1
7,2023-08-12T06:41:00+10:00,2023-08-12,06:41,0,1,1
7,2023-08-12T06:49:00+10:00,2023-08-12,06:49,0,2,2
9,2023-08-12T06:43:00+10:00,2023-08-12,06:43,0,1,1
10,2023-08-12T06:54:00+10:00,2023-08-12,06:54,1,0,1
11,2023-08-12T06:40:00+10:00,2023-08-12,06:40,0,2,2
12,2023-08-12T06:41:00+10:00,2023-08-12,06:41,2,0,2
12,2023-08-12T06:44:00+10:00,2023-08-12,06:44,0,1,1
12,2023-08-12T06:53:00+10:00,2023-08-12,06:53,1,0,1
17,2023-08-12T06:40:00+10:00,2023-08-12,06:40,1,0,1
17,2023-08-12T06:41:00+10:00,2023-08-12,06:41,1,0,1
18,2023-08-12T06:41:00+10:00,2023-08-12,06:41,0,1,1
24,2023-08-12T06:43:00+10:00,2023-08-12,06:43,1,0,1
24,2023-08-12T06:46:00+10:00,2023-08-12,06:46,1,1,2
24,2023-08-12T06:49:00+10:00,2023-08-12,06:49,0,2,2
24,2023-08-12T06:50:00+10:00,2023-08-12,06:50,1,0,1
27,2023-08-12T06:47:00+10:00,2023-08-12,06:47,1,1,2
27,2023-08-12T06:49:00+10:00,2023-08-12,06:49,0,1,1
27,2023-08-12T06:54:00+10:00,2023-08-12,06:54,1,0,1
35,2023-08-12T06:40:00+10:00,2023-08-12,06:40,0,1,1
35,2023-08-12T06:53:00+10:00,2023-08-12,06:53,1,1,2
35,2023-08-12T06:54:00+10:00,2023-08-12,06:54,4,3,7
53,2023-08-12T06:46:00+10:00,2023-08-12,06:46,0,2,2
56,2023-08-12T06:44:00+10:00,2023-08-12,06:44,0,1,1
57,2023-08-12T06:42:00+10:00,2023-08-12,06:42,1,0,1
58,2023-08-12T06:46:00+10:00,2023-08-12,06:46,1,1,2
58,2023-08-12T06:48:00+10:00,2023-08-12,06:48,1,0,1
58,2023-08-12T06:49:00+10:00,2023-08-12,06:49,2,2,4
58,2023-08-12T06:52:00+10:00,2023-08-12,06:52,1,1,2
62,2023-08-12T06:40:00+10:00,2023-08-12,06:40,1,0,1
62,2023-08-12T06:43:00+10:00,2023-08-12,06:43,2,5,7
62,2023-08-12T06:50:00+10:00,2023-08-12,06:50,1,0,1
62,2023-08-12T06:54:00+10:00,2023-08-12,06:54,3,0,3
63,2023-08-12T06:42:00+10:00,2023-08-12,06:42,0,1,1
63,2023-08-12T06:47:00+10:00,2023-08-12,06:47,0,1,1
63,2023-08-12T06:51:00+10:00,2023-08-12,06:51,0,2,2
76,2023-08-12T06:50:00+10:00,2023-08-12,06:50,1,0,1
79,2023-08-12T06:49:00+10:00,2023-08-12,06:49,2,1,3
86,2023-08-12T06:41:00+10:00,2023-08-12,06:41,1,0,1
109,2023-08-12T06:50:00+10:00,2023-08-12,06:50,3,2,5
117,2023-08-12T06:40:00+10:00,2023-08-12,06:40,3,3,6
117,2023-08-12T06:45:00+10:00,2023-08-12,06:45,1,2,3
122,2023-08-12T06:41:00+10:00,2023-08-12,06:41,1,0,1
122,2023-08-12T06:54:00+10:00,2023-08-12,06:54,1,0,1
3,2023-08-12T06:56:00+10:00,2023-08-12,06:56,1,0,1
3,2023-08-12T06:57:00+10:00,2023-08-12,06:57,0,2,2
3,2023-08-12T06:59:00+10:00,2023-08-12,06:59,2,0,2
3,2023-08-12T07:00:00+10:00,2023-08-12,07:00,3,3,6
3,2023-08-12T07:01:00+10:00,2023-08-12,07:01,1,4,5
3,2023-08-12T07:03:00+10:00,2023-08-12,07:03,1,4,5
3,2023-08-12T07:04:00+10:00,2023-08-12,07:04,1,1,2
3,2023-08-12T07:06:00+10:00,2023-08-12,07:06,1,1,2
4,2023-08-12T06:59:00+10:00,2023-08-12,06:59,0,2,2
4,2023-08-12T07:02:00+10:00,2023-08-12,07:02,1,0,1
4,2023-08-12T07:03:00+10:00,2023-08-12,07:03,2,0,2
6,2023-08-12T06:58:00+10:00,2023-08-12,06:58,2,1,3
6,2023-08-12T07:00:00+10:00,2023-08-12,07:00,4,1,5
6,2023-08-12T07:06:00+10:00,2023-08-12,07:06,1,1,2
6,2023-08-12T07:07:00+10:00,2023-08-12,07:07,2,2,4
6,2023-08-12T07:08:00+10:00,2023-08-12,07:08,1,0,1
8,2023-08-12T06:57:00+10:00,2023-08-12,06:57,0,1,1
8,2023-08-12T06:59:00+10:00,2023-08-12,06:59,1,1,2
8,2023-08-12T07:06:00+10:00,2023-08-12,07:06,0,1,1
14,2023-08-12T06:57:00+10:00,2023-08-12,06:57,0,1,1
14,2023-08-12T07:00:00+10:00,2023-08-12,07:00,1,3,4
14,2023-08-12T07:04:00+10:00,2023-08-12,07:04,0,1,1
21,2023-08-12T06:57:00+10:00,2023-08-12,06:57,1,3,4
21,2023-08-12T06:59:00+10:00,2023-08-12,06:59,2,0,2
21,2023-08-12T07:04:00+10:00,2023-08-12,07:04,0,1,1
28,2023-08-12T07:09:00+10:00,2023-08-12,07:09,0,1,1
29,2023-08-12T07:00:00+10:00,2023-08-12,07:00,1,0,1
29,2023-08-12T07:01:00+10:00,2023-08-12,07:01,0,2,2
29,2023-08-12T07:04:00+10:00,2023-08-12,07:04,1,1,2
41,2023-08-12T06:56:00+10:00,2023-08-12,06:56,0,5,5
41,2023-08-12T06:59:00+10:00,2023-08-12,06:59,8,0,8
41,2023-08-12T07:02:00+10:00,2023-08-12,07:02,2,0,2
41,2023-08-12T07:08:00+10:00,2023-08-12,07:08,5,3,8
54,2023-08-12T07:09:00+10:00,2023-08-12,07:09,0,1,1
55,2023-08-12T07:00:00+10:00,2023-08-12,07:00,1,0,1
59,2023-08-12T07:00:00+10:00,2023-08-12,07:00,0,1,1
61,2023-08-12T07:06:00+10:00,2023-08-12,07:06,0,1,1
61,2023-08-12T07:07:00+10:00,2023-08-12,07:07,1,1,2
61,2023-08-12T07:09:00+10:00,2023-08-12,07:09,0,1,1
65,2023-08-12T06:55:00+10:00,2023-08-12,06:55,1,0,1
66,2023-08-12T06:56:00+10:00,2023-08-12,06:56,1,0,1
66,2023-08-12T07:07:00+10:00,2023-08-12,07:07,0,1,1
66,2023-08-12T07:08:00+10:00,2023-08-12,07:08,0,2,2
66,2023-08-12T07:09:00+10:00,2023-08-12,07:09,0,2,2
69,2023-08-12T07:00:00+10:00,2023-08-12,07:00,0,2,2
69,2023-08-12T07:08:00+10:00,2023-08-12,07:08,1,0,1
69,2023-08-12T07:09:00+10:00,2023-08-12,07:09,1,1,2
75,2023-08-12T07:01:00+10:00,2023-08-12,07:01,0,1,1
84,2023-08-12T07:05:00+10:00,2023-08-12,07:05,8,13,21
87,2023-08-12T07:01:00+10:00,2023-08-12,07:01,0,1,1
87,2023-08-12T07:02:00+10:00,2023-08-12,07:02,0,1,1
107,2023-08-12T07:05:00+10:00,2023-08-12,07:05,0,1,1
108,2023-08-12T07:01:00+10:00,2023-08-12,07:01,1,0,1
108,2023-08-12T07:02:00+10:00,2023-08-12,07:02,0,3,3
108,2023-08-12T07:04:00+10:00,2023-08-12,07:04,0,1,1
108,2023-08-12T07:06:00+10:00,2023-08-12,07:06,0,1,1
108,2023-08-12T07:08:00+10:00,2023-08-12,07:08,0,1,1
108,2023-08-12T07:09:00+10:00,2023-08-12,07:09,0,1,1
1,2023-08-12T07:01:00+10:00,2023-08-12,07:01,1,1,2
1,2023-08-12T07:05:00+10:00,2023-08-12,07:05,1,0,1
2,2023-08-12T07:07:00+10:00,2023-08-12,07:07,0,1,1
2,2023-08-12T07:08:00+10:00,2023-08-12,07:08,1,0,1
7,2023-08-12T07:02:00+10:00,2023-08-12,07:02,1,0,1
7,2023-08-12T07:05:00+10:00,2023-08-12,07:05,0,1,1
7,2023-08-12T07:09:00+10:00,2023-08-12,07:09,0,1,1
9,2023-08-12T07:03:00+10:00,2023-08-12,07:03,0,1,1
11,2023-08-12T06:55:00+10:00,2023-08-12,06:55,1,1,2
11,2023-08-12T07:05:00+10:00,2023-08-12,07:05,5,0,5
17,2023-08-12T06:56:00+10:00,2023-08-12,06:56,1,1,2
17,2023-08-12T06:59:00+10:00,2023-08-12,06:59,2,1,3
24,2023-08-12T06:57:00+10:00,2023-08-12,06:57,2,0,2
24,2023-08-12T07:03:00+10:00,2023-08-12,07:03,2,0,2
24,2023-08-12T07:06:00+10:00,2023-08-12,07:06,0,5,5
24,2023-08-12T07:09:00+10:00,2023-08-12,07:09,2,14,16
27,2023-08-12T07:02:00+10:00,2023-08-12,07:02,0,2,2
35,2023-08-12T07:08:00+10:00,2023-08-12,07:08,0,1,1
53,2023-08-12T07:09:00+10:00,2023-08-12,07:09,0,1,1
56,2023-08-12T07:01:00+10:00,2023-08-12,07:01,1,0,1
58,2023-08-12T06:56:00+10:00,2023-08-12,06:56,1,0,1
58,2023-08-12T06:57:00+10:00,2023-08-12,06:57,0,2,2
58,2023-08-12T07:02:00+10:00,2023-08-12,07:02,0,2,2
58,2023-08-12T07:06:00+10:00,2023-08-12,07:06,3,2,5
58,2023-08-12T07:09:00+10:00,2023-08-12,07:09,1,0,1
62,2023-08-12T06:57:00+10:00,2023-08-12,06:57,1,2,3
62,2023-08-12T07:01:00+10:00,2023-08-12,07:01,1,1,2
62,2023-08-12T07:04:00+10:00,2023-08-12,07:04,0,2,2
62,2023-08-12T07:05:00+10:00,2023-08-12,07:05,1,1,2
62,2023-08-12T07:08:00+10:00,2023-08-12,07:08,3,0,3
62,2023-08-12T07:09:00+10:00,2023-08-12,07:09,1,2,3
63,2023-08-12T06:55:00+10:00,2023-08-12,06:55,0,1,1
63,2023-08-12T06:59:00+10:00,2023-08-12,06:59,0,1,1
63,2023-08-12T07:01:00+10:00,2023-08-12,07:01,0,1,1
63,2023-08-12T07:02:00+10:00,2023-08-12,07:02,0,1,1
63,2023-08-12T07:04:00+10:00,2023-08-12,07:04,0,3,3
67,2023-08-12T06:59:00+10:00,2023-08-12,06:59,1,1,2
67,2023-08-12T07:06:00+10:00,2023-08-12,07:06,2,0,2
67,2023-08-12T07:09:00+10:00,2023-08-12,07:09,0,1,1
68,2023-08-12T07:06:00+10:00,2023-08-12,07:06,1,0,1
72,2023-08-12T06:57:00+10:00,2023-08-12,06:57,0,2,2
72,2023-08-12T06:59:00+10:00,2023-08-12,06:59,0,2,2
76,2023-08-12T06:59:00+10:00,2023-08-12,06:59,2,0,2
79,2023-08-12T07:02:00+10:00,2023-08-12,07:02,0,1,1
79,2023-08-12T07:03:00+10:00,2023-08-12,07:03,0,1,1
79,2023-08-12T07:05:00+10:00,2023-08-12,07:05,0,1,1
79,2023-08-12T07:08:00+10:00,2023-08-12,07:08,2,0,2
79,2023-08-12T07:09:00+10:00,2023-08-12,07:09,0,2,2
86,2023-08-12T07:08:00+10:00,2023-08-12,07:08,1,0,1
109,2023-08-12T06:55:00+10:00,2023-08-12,06:55,3,3,6
117,2023-08-12T06:55:00+10:00,2023-08-12,06:55,1,0,1
3,2023-08-12T07:10:00+10:00,2023-08-12,07:10,0,2,2
3,2023-08-12T07:17:00+10:00,2023-08-12,07:17,1,1,2
3,2023-08-12T07:19:00+10:00,2023-08-12,07:19,1,1,2
3,2023-08-12T07:20:00+10:00,2023-08-12,07:20,0,2,2
3,2023-08-12T07:21:00+10:00,2023-08-12,07:21,0,2,2
3,2023-08-12T07:23:00+10:00,2023-08-12,07:23,0,1,1
4,2023-08-12T07:10:00+10:00,2023-08-12,07:10,3,2,5
4,2023-08-12T07:11:00+10:00,2023-08-12,07:11,1,2,3
4,2023-08-12T07:12:00+10:00,2023-08-12,07:12,3,0,3
4,2023-08-12T07:21:00+10:00,2023-08-12,07:21,1,0,1
4,2023-08-12T07:23:00+10:00,2023-08-12,07:23,2,0,2
6,2023-08-12T07:14:00+10:00,2023-08-12,07:14,1,0,1
6,2023-08-12T07:16:00+10:00,2023-08-12,07:16,2,0,2
8,2023-08-12T07:18:00+10:00,2023-08-12,07:18,2,0,2
14,2023-08-12T07:11:00+10:00,2023-08-12,07:11,0,2,2
14,2023-08-12T07:13:00+10:00,2023-08-12,07:13,2,0,2
14,2023-08-12T07:18:00+10:00,2023-08-12,07:18,2,2,4
14,2023-08-12T07:23:00+10:00,2023-08-12,07:23,2,1,3
14,2023-08-12T07:24:00+10:00,2023-08-12,07:24,1,0,1
21,2023-08-12T07:16:00+10:00,2023-08-12,07:16,2,0,2
21,2023-08-12T07:20:00+10:00,2023-08-12,07:20,1,0,1
21,2023-08-12T07:23:00+10:00,2023-08-12,07:23,0,1,1
28,2023-08-12T07:17:00+10:00,2023-08-12,07:17,2,0,2
29,2023-08-12T07:11:00+10:00,2023-08-12,07:11,1,0,1
29,2023-08-12T07:12:00+10:00,2023-08-12,07:12,0,1,1
29,2023-08-12T07:22:00+10:00,2023-08-12,07:22,0,1,1
39,2023-08-12T07:19:00+10:00,2023-08-12,07:19,0,1,1
41,2023-08-12T07:10:00+10:00,2023-08-12,07:10,0,2,2
41,2023-08-12T07:12:00+10:00,2023-08-12,07:12,4,2,6
41,2023-08-12T07:16:00+10:00,2023-08-12,07:16,4,0,4
41,2023-08-12T07:19:00+10:00,2023-08-12,07:19,6,0,6
41,2023-08-12T07:21:00+10:00,2023-08-12,07:21,0,5,5
55,2023-08-12T07:13:00+10:00,2023-08-12,07:13,0,5,5
55,2023-08-12T07:16:00+10:00,2023-08-12,07:16,2,2,4
55,2023-08-12T07:18:00+10:00,2023-08-12,07:18,1,1,2
55,2023-08-12T07:19:00+10:00,2023-08-12,07:19,1,8,9
55,2023-08-12T07:23:00+10:00,2023-08-12,07:23,0,2,2
55,2023-08-12T07:24:00+10:00,2023-08-12,07:24,1,1,2
61,2023-08-12T07:16:00+10:00,2023-08-12,07:16,0,1,1
61,2023-08-12T07:19:00+10:00,2023-08-12,07:19,0,1,1
65,2023-08-12T07:13:00+10:00,2023-08-12,07:13,1,0,1
65,2023-08-12T07:22:00+10:00,2023-08-12,07:22,1,0,1
65,2023-08-12T07:23:00+10:00,2023-08-12,07:23,1,0,1
65,2023-08-12T07:24:00+10:00,2023-08-12,07:24,1,0,1
66,2023-08-12T07:15:00+10:00,2023-08-12,07:15,0,1,1
66,2023-08-12T07:18:00+10:00,2023-08-12,07:18,2,1,3
66,2023-08-12T07:19:00+10:00,2023-08-12,07:19,0,1,1
66,2023-08-12T07:24:00+10:00,2023-08-12,07:24,0,1,1
69,2023-08-12T07:10:00+10:00,2023-08-12,07:10,1,0,1
69,2023-08-12T07:12:00+10:00,2023-08-12,07:12,1,0,1
69,2023-08-12T07:24:00+10:00,2023-08-12,07:24,1,0,1
77,2023-08-12T07:18:00+10:00,2023-08-12,07:18,0,1,1
77,2023-08-12T07:23:00+10:00,2023-08-12,07:23,0,2,2
78,2023-08-12T07:16:00+10:00,2023-08-12,07:16,0,1,1
87,2023-08-12T07:11:00+10:00,2023-08-12,07:11,3,0,3
87,2023-08-12T07:16:00+10:00,2023-08-12,07:16,0,3,3
107,2023-08-12T07:10:00+10:00,2023-08-12,07:10,2,2,4
107,2023-08-12T07:15:00+10:00,2023-08-12,07:15,2,4,6
108,2023-08-12T07:11:00+10:00,2023-08-12,07:11,0,1,1
108,2023-08-12T07:23:00+10:00,2023-08-12,07:23,1,2,3
118,2023-08-12T07:15:00+10:00,2023-08-12,07:15,0,1,1
1,2023-08-12T07:11:00+10:00,2023-08-12,07:11,3,0,3
1,2023-08-12T07:18:00+10:00,2023-08-12,07:18,0,2,2
7,2023-08-12T07:10:00+10:00,2023-08-12,07:10,0,1,1
11,2023-08-12T07:15:00+10:00,2023-08-12,07:15,2,1,3
11,2023-08-12T07:24:00+10:00,2023-08-12,07:24,1,0,1
12,2023-08-12T07:10:00+10:00,2023-08-12,07:10,1,0,1
12,2023-08-12T07:11:00+10:00,2023-08-12,07:11,1,0,1
12,2023-08-12T07:24:00+10:00,2023-08-12,07:24,2,0,2
17,2023-08-12T07:16:00+10:00,2023-08-12,07:16,0,1,1
17,2023-08-12T07:22:00+10:00,2023-08-12,07:22,0,1,1
18,2023-08-12T07:11:00+10:00,2023-08-12,07:11,2,0,2
18,2023-08-12T07:12:00+10:00,2023-08-12,07:12,0,2,2
24,2023-08-12T07:11:00+10:00,2023-08-12,07:11,0,5,5
24,2023-08-12T07:16:00+10:00,2023-08-12,07:16,1,1,2
27,2023-08-12T07:14:00+10:00,2023-08-12,07:14,0,1,1
27,2023-08-12T07:19:00+10:00,2023-08-12,07:19,0,1,1
35,2023-08-12T07:18:00+10:00,2023-08-12,07:18,2,0,2
35,2023-08-12T07:19:00+10:00,2023-08-12,07:19,5,2,7
35,2023-08-12T07:23:00+10:00,2023-08-12,07:23,4,0,4
53,2023-08-12T07:22:00+10:00,2023-08-12,07:22,0,1,1
53,2023-08-12T07:24:00+10:00,2023-08-12,07:24,0,1,1
56,2023-08-12T07:12:00+10:00,2023-08-12,07:12,1,0,1
56,2023-08-12T07:13:00+10:00,2023-08-12,07:13,7,0,7
56,2023-08-12T07:15:00+10:00,2023-08-12,07:15,1,1,2
57,2023-08-12T07:14:00+10:00,2023-08-12,07:14,1,0,1
58,2023-08-12T07:13:00+10:00,2023-08-12,07:13,0,2,2
58,2023-08-12T07:20:00+10:00,2023-08-12,07:20,0,1,1
58,2023-08-12T07:22:00+10:00,2023-08-12,07:22,0,5,5
62,2023-08-12T07:13:00+10:00,2023-08-12,07:13,1,0,1
62,2023-08-12T07:20:00+10:00,2023-08-12,07:20,0,2,2
62,2023-08-12T07:22:00+10:00,2023-08-12,07:22,4,1,5
62,2023-08-12T07:23:00+10:00,2023-08-12,07:23,8,2,10
63,2023-08-12T07:19:00+10:00,2023-08-12,07:19,0,1,1
67,2023-08-12T07:10:00+10:00,2023-08-12,07:10,1,2,3
67,2023-08-12T07:12:00+10:00,2023-08-12,07:12,2,0,2
67,2023-08-12T07:13:00+10:00,2023-08-12,07:13,2,0,2
67,2023-08-12T07:18:00+10:00,2023-08-12,07:18,0,1,1
67,2023-08-12T07:20:00+10:00,2023-08-12,07:20,0,2,2
68,2023-08-12T07:14:00+10:00,2023-08-12,07:14,1,0,1
68,2023-08-12T07:23:00+10:00,2023-08-12,07:23,2,0,2
72,2023-08-12T07:19:00+10:00,2023-08-12,07:19,1,0,1
76,2023-08-12T07:20:00+10:00,2023-08-12,07:20,0,1,1
79,2023-08-12T07:10:00+10:00,2023-08-12,07:10,2,2,4
79,2023-08-12T07:11:00+10:00,2023-08-12,07:11,0,2,2
79,2023-08-12T07:12:00+10:00,2023-08-12,07:12,1,0,1
79,2023-08-12T07:22:00+10:00,2023-08-12,07:22,1,0,1
79,2023-08-12T07:23:00+10:00,2023-08-12,07:23,0,1,1
79,2023-08-12T07:24:00+10:00,2023-08-12,07:24,1,1,2
85,2023-08-12T07:18:00+10:00,2023-08-12,07:18,0,1,1
122,2023-08-12T07:15:00+10:00,2023-08-12,07:15,0,1,1
122,2023-08-12T07:19:00+10:00,2023-08-12,07:19,4,1,5
122,2023-08-12T07:21:00+10:00,2023-08-12,07:21,2,0,2
3,2023-08-12T07:26:00+10:00,2023-08-12,07:26,0,2,2
3,2023-08-12T07:35:00+10:00,2023-08-12,07:35,0,2,2
3,2023-08-12T07:38:00+10:00,2023-08-12,07:38,0,1,1
4,2023-08-12T07:26:00+10:00,2023-08-12,07:26,5,1,6
4,2023-08-12T07:32:00+10:00,2023-08-12,07:32,0,1,1
4,2023-08-12T07:36:00+10:00,2023-08-12,07:36,0,1,1
4,2023-08-12T07:37:00+10:00,2023-08-12,07:37,0,2,2
6,2023-08-12T07:26:00+10:00,2023-08-12,07:26,4,1,5
6,2023-08-12T07:28:00+10:00,2023-08-12,07:28,1,3,4
6,2023-08-12T07:34:00+10:00,2023-08-12,07:34,0,1,1
6,2023-08-12T07:37:00+10:00,2023-08-12,07:37,1,1,2
6,2023-08-12T07:38:00+10:00,2023-08-12,07:38,0,3,3
6,2023-08-12T07:39:00+10:00,2023-08-12,07:39,0,2,2
8,2023-08-12T07:26:00+10:00,2023-08-12,07:26,0,2,2
8,2023-08-12T07:34:00+10:00,2023-08-12,07:34,0,1,1
8,2023-08-12T07:36:00+10:00,2023-08-12,07:36,0,1,1
8,2023-08-12T07:37:00+10:00,2023-08-12,07:37,0,1,1
21,2023-08-12T07:25:00+10:00,2023-08-12,07:25,2,0,2
21,2023-08-12T07:27:00+10:00,2023-08-12,07:27,2,4,6
21,2023-08-12T07:29:00+10:00,2023-08-12,07:29,0,3,3
21,2023-08-12T07:32:00+10:00,2023-08-12,07:32,0,1,1
28,2023-08-12T07:25:00+10:00,2023-08-12,07:25,1,0,1
28,2023-08-12T07:35:00+10:00,2023-08-12,07:35,1,0,1
29,2023-08-12T07:32:00+10:00,2023-08-12,07:32,0,1,1
29,2023-08-12T07:34:00+10:00,2023-08-12,07:34,1,0,1
39,2023-08-12T07:26:00+10:00,2023-08-12,07:26,1,0,1
39,2023-08-12T07:27:00+10:00,2023-08-12,07:27,0,1,1
41,2023-08-12T07:26:00+10:00,2023-08-12,07:26,0,2,2
41,2023-08-12T07:28:00+10:00,2023-08-12,07:28,9,2,11
41,2023-08-12T07:29:00+10:00,2023-08-12,07:29,2,2,4
41,2023-08-12T07:31:00+10:00,2023-08-12,07:31,8,2,10
54,2023-08-12T07:36:00+10:00,2023-08-12,07:36,0,1,1
55,2023-08-12T07:25:00+10:00,2023-08-12,07:25,2,4,6
55,2023-08-12T07:26:00+10:00,2023-08-12,07:26,4,0,4
55,2023-08-12T07:29:00+10:00,2023-08-12,07:29,0,1,1
55,2023-08-12T07:32:00+10:00,2023-08-12,07:32,1,2,3
59,2023-08-12T07:30:00+10:00,2023-08-12,07:30,2,6,8
61,2023-08-12T07:29:00+10:00,2023-08-12,07:29,0,1,1
65,2023-08-12T07:25:00+10:00,2023-08-12,07:25,1,0,1
65,2023-08-12T07:27:00+10:00,2023-08-12,07:27,1,0,1
65,2023-08-12T07:28:00+10:00,2023-08-12,07:28,1,1,2
65,2023-08-12T07:39:00+10:00,2023-08-12,07:39,1,0,1
66,2023-08-12T07:30:00+10:00,2023-08-12,07:30,0,1,1
69,2023-08-12T07:30:00+10:00,2023-08-12,07:30,1,0,1
69,2023-08-12T07:32:00+10:00,2023-08-12,07:32,1,0,1
69,2023-08-12T07:34:00+10:00,2023-08-12,07:34,0,1,1
69,2023-08-12T07:36:00+10:00,2023-08-12,07:36,0,1,1
70,2023-08-12T07:35:00+10:00,2023-08-12,07:35,0,2,2
75,2023-08-12T07:37:00+10:00,2023-08-12,07:37,1,0,1
77,2023-08-12T07:36:00+10:00,2023-08-12,07:36,2,0,2
84,2023-08-12T07:30:00+10:00,2023-08-12,07:30,9,13,22
87,2023-08-12T07:25:00+10:00,2023-08-12,07:25,0,1,1
87,2023-08-12T07:30:00+10:00,2023-08-12,07:30,1,1,2
87,2023-08-12T07:34:00+10:00,2023-08-12,07:34,0,1,1
107,2023-08-12T07:30:00+10:00,2023-08-12,07:30,6,1,7
108,2023-08-12T07:25:00+10:00,2023-08-12,07:25,0,1,1
108,2023-08-12T07:32:00+10:00,2023-08-12,07:32,1,0,1
108,2023-08-12T07:34:00+10:00,2023-08-12,07:34,2,2,4
108,2023-08-12T07:36:00+10:00,2023-08-12,07:36,0,2,2
108,2023-08-12T07:37:00+10:00,2023-08-12,07:37,0,3,3
1,2023-08-12T07:27:00+10:00,2023-08-12,07:27,0,1,1
1,2023-08-12T07:35:00+10:00,2023-08-12,07:35,0,3,3
2,2023-08-12T07:26:00+10:00,2023-08-12,07:26,1,0,1
2,2023-08-12T07:27:00+10:00,2023-08-12,07:27,1,1,2
2,2023-08-12T07:28:00+10:00,2023-08-12,07:28,0,1,1
2,2023-08-12T07:31:00+10:00,2023-08-12,07:31,0,1,1
2,2023-08-12T07:34:00+10:00,2023-08-12,07:34,0,1,1
7,2023-08-12T07:28:00+10:00,2023-08-12,07:28,0,1,1
7,2023-08-12T07:36:00+10:00,2023-08-12,07:36,1,0,1
7,2023-08-12T07:37:00+10:00,2023-08-12,07:37,1,0,1
7,2023-08-12T07:38:00+10:00,2023-08-12,07:38,0,1,1
9,2023-08-12T07:26:00+10:00,2023-08-12,07:26,0,1,1
9,2023-08-12T07:37:00+10:00,2023-08-12,07:37,1,3,4
11,2023-08-12T07:30:00+10:00,2023-08-12,07:30,0,2,2
11,2023-08-12T07:35:00+10:00,2023-08-12,07:35,5,1,6
12,2023-08-12T07:25:00+10:00,2023-08-12,07:25,1,0,1
12,2023-08-12T07:30:00+10:00,2023-08-12,07:30,0,1,1
12,2023-08-12T07:32:00+10:00,2023-08-12,07:32,0,1,1
12,2023-08-12T07:36:00+10:00,2023-08-12,07:36,1,1,2
17,2023-08-12T07:28:00+10:00,2023-08-12,07:28,1,0,1
17,2023-08-12T07:30:00+10:00,2023-08-12,07:30,1,0,1
17,2023-08-12T07:32:00+10:00,2023-08-12,07:32,2,0,2
17,2023-08-12T07:37:00+10:00,2023-08-12,07:37,1,0,1
18,2023-08-12T07:35:00+10:00,2023-08-12,07:35,0,1,1
24,2023-08-12T07:30:00+10:00,2023-08-12,07:30,2,2,4
24,2023-08-12T07:33:00+10:00,2023-08-12,07:33,1,1,2
27,2023-08-12T07:28:00+10:00,2023-08-12,07:28,0,1,1
27,2023-08-12T07:31:00+10:00,2023-08-12,07:31,0,1,1
27,2023-08-12T07:32:00+10:00,2023-08-12,07:32,0,5,5
27,2023-08-12T07:34:00+10:00,2023-08-12,07:34,1,1,2
27,2023-08-12T07:36:00+10:00,2023-08-12,07:36,0,1,1
35,2023-08-12T07:26:00+10:00,2023-08-12,07:26,1,3,4
35,2023-08-12T07:28:00+10:00,2023-08-12,07:28,5,2,7
35,2023-08-12T07:31:00+10:00,2023-08-12,07:31,6,2,8
35,2023-08-12T07:35:00+10:00,2023-08-12,07:35,2,2,4
35,2023-08-12T07:37:00+10:00,2023-08-12,07:37,4,1,5
53,2023-08-12T07:28:00+10:00,2023-08-12,07:28,1,1,2
53,2023-08-12T07:35:00+10:00,2023-08-12,07:35,0,3,3
53,2023-08-12T07:39:00+10:00,2023-08-12,07:39,1,0,1
56,2023-08-12T07:26:00+10:00,2023-08-12,07:26,4,0,4
56,2023-08-12T07:32:00+10:00,2023-08-12,07:32,4,0,4
56,2023-08-12T07:34:00+10:00,2023-08-12,07:34,0,1,1
56,2023-08-12T07:37:00+10:00,2023-08-12,07:37,2,1,3
56,2023-08-12T07:38:00+10:00,2023-08-12,07:38,1,0,1
57,2023-08-12T07:34:00+10:00,2023-08-12,07:34,0,1,1
57,2023-08-12T07:38:00+10:00,2023-08-12,07:38,1,0,1
57,2023-08-12T07:39:00+10:00,2023-08-12,07:39,1,1,2
58,2023-08-12T07:28:00+10:00,2023-08-12,07:28,1,0,1
58,2023-08-12T07:29:00+10:00,2023-08-12,07:29,1,0,1
58,2023-08-12T07:32:00+10:00,2023-08-12,07:32,1,0,1
58,2023-08-12T07:34:00+10:00,2023-08-12,07:34,1,0,1
58,2023-08-12T07:35:00+10:00,2023-08-12,07:35,2,1,3
58,2023-08-12T07:38:00+10:00,2023-08-12,07:38,3,1,4
62,2023-08-12T07:27:00+10:00,2023-08-12,07:27,6,0,6
62,2023-08-12T07:28:00+10:00,2023-08-12,07:28,3,0,3
62,2023-08-12T07:30:00+10:00,2023-08-12,07:30,4,0,4
62,2023-08-12T07:32:00+10:00,2023-08-12,07:32,4,0,4
62,2023-08-12T07:37:00+10:00,2023-08-12,07:37,0,1,1
62,2023-08-12T07:39:00+10:00,2023-08-12,07:39,0,1,1
63,2023-08-12T07:33:00+10:00,2023-08-12,07:33,0,2,2
67,2023-08-12T07:25:00+10:00,2023-08-12,07:25,1,0,1
67,2023-08-12T07:28:00+10:00,2023-08-12,07:28,2,1,3
67,2023-08-12T07:33:00+10:00,2023-08-12,07:33,1,1,2
67,2023-08-12T07:34:00+10:00,2023-08-12,07:34,1,4,5
67,2023-08-12T07:35:00+10:00,2023-08-12,07:35,2,0,2
67,2023-08-12T07:37:00+10:00,2023-08-12,07:37,1,1,2
68,2023-08-12T07:28:00+10:00,2023-08-12,07:28,3,0,3
68,2023-08-12T07:30:00+10:00,2023-08-12,07:30,1,0,1
68,2023-08-12T07:37:00+10:00,2023-08-12,07:37,2,0,2
68,2023-08-12T07:38:00+10:00,2023-08-12,07:38,1,0,1
72,2023-08-12T07:26:00+10:00,2023-08-12,07:26,1,0,1
72,2023-08-12T07:31:00+10:00,2023-08-12,07:31,2,0,2
72,2023-08-12T07:35:00+10:00,2023-08-12,07:35,1,0,1
72,2023-08-12T07:37:00+10:00,2023-08-12,07:37,2,0,2
72,2023-08-12T07:39:00+10:00,2023-08-12,07:39,3,0,3
76,2023-08-12T07:31:00+10:00,2023-08-12,07:31,1,0,1
79,2023-08-12T07:31:00+10:00,2023-08-12,07:31,0,1,1
79,2023-08-12T07:32:00+10:00,2023-08-12,07:32,4,0,4
79,2023-08-12T07:33:00+10:00,2023-08-12,07:33,2,2,4
79,2023-08-12T07:38:00+10:00,2023-08-12,07:38,4,1,5
79,2023-08-12T07:39:00+10:00,2023-08-12,07:39,0,1,1
117,2023-08-12T07:25:00+10:00,2023-08-12,07:25,3,2,5
117,2023-08-12T07:35:00+10:00,2023-08-12,07:35,2,1,3
122,2023-08-12T07:35:00+10:00,2023-08-12,07:35,0,3,3
3,2023-08-12T07:42:00+10:00,2023-08-12,07:42,1,1,2
3,2023-08-12T07:44:00+10:00,2023-08-12,07:44,1,1,2
3,2023-08-12T07:45:00+10:00,2023-08-12,07:45,0,2,2
3,2023-08-12T07:46:00+10:00,2023-08-12,07:46,2,3,5
3,2023-08-12T07:48:00+10:00,2023-08-12,07:48,2,0,2
3,2023-08-12T07:54:00+10:00,2023-08-12,07:54,0,1,1
4,2023-08-12T07:49:00+10:00,2023-08-12,07:49,1,0,1
4,2023-08-12T07:50:00+10:00,2023-08-12,07:50,2,1,3
4,2023-08-12T07:54:00+10:00,2023-08-12,07:54,1,2,3
6,2023-08-12T07:40:00+10:00,2023-08-12,07:40,4,1,5
6,2023-08-12T07:43:00+10:00,2023-08-12,07:43,1,1,2
6,2023-08-12T07:44:00+10:00,2023-08-12,07:44,2,4,6
6,2023-08-12T07:45:00+10:00,2023-08-12,07:45,1,2,3
8,2023-08-12T07:44:00+10:00,2023-08-12,07:44,0,2,2
8,2023-08-12T07:49:00+10:00,2023-08-12,07:49,0,1,1
8,2023-08-12T07:51:00+10:00,2023-08-12,07:51,0,1,1
8,2023-08-12T07:54:00+10:00,2023-08-12,07:54,1,0,1
14,2023-08-12T07:42:00+10:00,2023-08-12,07:42,0,1,1
14,2023-08-12T07:45:00+10:00,2023-08-12,07:45,0,1,1
14,2023-08-12T07:50:00+10:00,2023-08-12,07:50,2,3,5
14,2023-08-12T07:54:00+10:00,2023-08-12,07:54,0,1,1
21,2023-08-12T07:51:00+10:00,2023-08-12,07:51,0,1,1
21,2023-08-12T07:53:00+10:00,2023-08-12,07:53,2,0,2
28,2023-08-12T07:40:00+10:00,2023-08-12,07:40,0,1,1
28,2023-08-12T07:41:00+10:00,2023-08-12,07:41,1,1,2
28,2023-08-12T07:44:00+10:00,2023-08-12,07:44,1,0,1
28,2023-08-12T07:49:00+10:00,2023-08-12,07:49,0,1,1
29,2023-08-12T07:46:00+10:00,2023-08-12,07:46,1,0,1
29,2023-08-12T07:52:00+10:00,2023-08-12,07:52,1,0,1
39,2023-08-12T07:49:00+10:00,2023-08-12,07:49,1,1,2
39,2023-08-12T07:51:00+10:00,2023-08-12,07:51,0,1,1
41,2023-08-12T07:40:00+10:00,2023-08-12,07:40,5,1,6
41,2023-08-12T07:41:00+10:00,2023-08-12,07:41,4,1,5
41,2023-08-12T07:42:00+10:00,2023-08-12,07:42,6,5,11
41,2023-08-12T07:47:00+10:00,2023-08-12,07:47,6,5,11
41,2023-08-12T07:49:00+10:00,2023-08-12,07:49,2,0,2
41,2023-08-12T07:50:00+10:00,2023-08-12,07:50,7,3,10
54,2023-08-12T07:44:00+10:00,2023-08-12,07:44,2,1,3
55,2023-08-12T07:40:00+10:00,2023-08-12,07:40,1,0,1
55,2023-08-12T07:41:00+10:00,2023-08-12,07:41,0,2,2
55,2023-08-12T07:48:00+10:00,2023-08-12,07:48,0,1,1
55,2023-08-12T07:52:00+10:00,2023-08-12,07:52,5,9,14
59,2023-08-12T07:50:00+10:00,2023-08-12,07:50,6,3,9
61,2023-08-12T07:52:00+10:00,2023-08-12,07:52,0,1,1
65,2023-08-12T07:41:00+10:00,2023-08-12,07:41,0,2,2
65,2023-08-12T07:45:00+10:00,2023-08-12,07:45,0,1,1
65,2023-08-12T07:46:00+10:00,2023-08-12,07:46,1,0,1
66,2023-08-12T07:51:00+10:00,2023-08-12,07:51,6,1,7
66,2023-08-12T07:52:00+10:00,2023-08-12,07:52,2,0,2
69,2023-08-12T07:49:00+10:00,2023-08-12,07:49,1,0,1
70,2023-08-12T07:40:00+10:00,2023-08-12,07:40,0,1,1
70,2023-08-12T07:48:00+10:00,2023-08-12,07:48,0,2,2
75,2023-08-12T07:43:00+10:00,2023-08-12,07:43,1,0,1
75,2023-08-12T07:44:00+10:00,2023-08-12,07:44,1,1,2
75,2023-08-12T07:52:00+10:00,2023-08-12,07:52,2,1,3
77,2023-08-12T07:42:00+10:00,2023-08-12,07:42,0,1,1
77,2023-08-12T07:46:00+10:00,2023-08-12,07:46,1,2,3
77,2023-08-12T07:47:00+10:00,2023-08-12,07:47,1,0,1
77,2023-08-12T07:48:00+10:00,2023-08-12,07:48,0,1,1
77,2023-08-12T07:51:00+10:00,2023-08-12,07:51,0,1,1
77,2023-08-12T07:53:00+10:00,2023-08-12,07:53,2,1,3
78,2023-08-12T07:40:00+10:00,2023-08-12,07:40,4,0,4
78,2023-08-12T07:42:00+10:00,2023-08-12,07:42,0,3,3
78,2023-08-12T07:43:00+10:00,2023-08-12,07:43,1,1,2
84,2023-08-12T07:40:00+10:00,2023-08-12,07:40,10,20,30
87,2023-08-12T07:54:00+10:00,2023-08-12,07:54,2,0,2
107,2023-08-12T07:40:00+10:00,2023-08-12,07:40,3,3,6
107,2023-08-12T07:45:00+10:00,2023-08-12,07:45,2,3,5
108,2023-08-12T07:47:00+10:00,2023-08-12,07:47,1,3,4
108,2023-08-12T07:48:00+10:00,2023-08-12,07:48,0,2,2
108,2023-08-12T07:54:00+10:00,2023-08-12,07:54,1,1,2
118,2023-08-12T07:45:00+10:00,2023-08-12,07:45,0,2,2
1,2023-08-12T07:40:00+10:00,2023-08-12,07:40,1,0,1
1,2023-08-12T07:41:00+10:00,2023-08-12,07:41,0,2,2
1,2023-08-12T07:45:00+10:00,2023-08-12,07:45,0,1,1
1,2023-08-12T07:46:00+10:00,2023-08-12,07:46,2,1,3
1,2023-08-12T07:48:00+10:00,2023-08-12,07:48,1,1,2
1,2023-08-12T07:50:00+10:00,2023-08-12,07:50,0,1,1
1,2023-08-12T07:51:00+10:00,2023-08-12,07:51,2,1,3
1,2023-08-12T07:53:00+10:00,2023-08-12,07:53,2,0,2
2,2023-08-12T07:46:00+10:00,2023-08-12,07:46,0,2,2
2,2023-08-12T07:51:00+10:00,2023-08-12,07:51,2,0,2
2,2023-08-12T07:53:00+10:00,2023-08-12,07:53,0,1,1
7,2023-08-12T07:40:00+10:00,2023-08-12,07:40,2,0,2
7,2023-08-12T07:41:00+10:00,2023-08-12,07:41,1,0,1
9,2023-08-12T07:41:00+10:00,2023-08-12,07:41,0,1,1
9,2023-08-12T07:54:00+10:00,2023-08-12,07:54,1,0,1
10,2023-08-12T07:53:00+10:00,2023-08-12,07:53,0,1,1
12,2023-08-12T07:45:00+10:00,2023-08-12,07:45,0,1,1
12,2023-08-12T07:46:00+10:00,2023-08-12,07:46,1,1,2
12,2023-08-12T07:53:00+10:00,2023-08-12,07:53,1,1,2
17,2023-08-12T07:51:00+10:00,2023-08-12,07:51,3,0,3
18,2023-08-12T07:40:00+10:00,2023-08-12,07:40,1,0,1
18,2023-08-12T07:47:00+10:00,2023-08-12,07:47,0,2,2
24,2023-08-12T07:42:00+10:00,2023-08-12,07:42,4,12,16
24,2023-08-12T07:44:00+10:00,2023-08-12,07:44,2,2,4
24,2023-08-12T07:47:00+10:00,2023-08-12,07:47,2,1,3
24,2023-08-12T07:49:00+10:00,2023-08-12,07:49,0,1,1
24,2023-08-12T07:50:00+10:00,2023-08-12,07:50,1,0,1
27,2023-08-12T07:42:00+10:00,2023-08-12,07:42,3,0,3
27,2023-08-12T07:45:00+10:00,2023-08-12,07:45,1,0,1
27,2023-08-12T07:48:00+10:00,2023-08-12,07:48,0,1,1
27,2023-08-12T07:49:00+10:00,2023-08-12,07:49,0,2,2
27,2023-08-12T07:51:00+10:00,2023-08-12,07:51,0,1,1
27,2023-08-12T07:54:00+10:00,2023-08-12,07:54,2,2,4
35,2023-08-12T07:41:00+10:00,2023-08-12,07:41,1,2,3
35,2023-08-12T07:46:00+10:00,2023-08-12,07:46,3,5,8
35,2023-08-12T07:47:00+10:00,2023-08-12,07:47,7,1,8
35,2023-08-12T07:48:00+10:00,2023-08-12,07:48,3,5,8
35,2023-08-12T07:51:00+10:00,2023-08-12,07:51,3,6,9
35,2023-08-12T07:54:00+10:00,2023-08-12,07:54,2,3,5
53,2023-08-12T07:43:00+10:00,2023-08-12,07:43,0,2,2
53,2023-08-12T07:45:00+10:00,2023-08-12,07:45,1,0,1
53,2023-08-12T07:53:00+10:00,2023-08-12,07:53,3,2,5
56,2023-08-12T07:45:00+10:00,2023-08-12,07:45,3,1,4
56,2023-08-12T07:46:00+10:00,2023-08-12,07:46,1,0,1
56,2023-08-12T07:47:00+10:00,2023-08-12,07:47,0,2,2
56,2023-08-12T07:51:00+10:00,2023-08-12,07:51,1,0,1
56,2023-08-12T07:53:00+10:00,2023-08-12,07:53,1,1,2
57,2023-08-12T07:43:00+10:00,2023-08-12,07:43,0,1,1
58,2023-08-12T07:41:00+10:00,2023-08-12,07:41,7,2,9
58,2023-08-12T07:43:00+10:00,2023-08-12,07:43,1,1,2
58,2023-08-12T07:44:00+10:00,2023-08-12,07:44,6,1,7
58,2023-08-12T07:48:00+10:00,2023-08-12,07:48,5,3,8
58,2023-08-12T07:50:00+10:00,2023-08-12,07:50,1,3,4
58,2023-08-12T07:51:00+10:00,2023-08-12,07:51,2,0,2
58,2023-08-12T07:52:00+10:00,2023-08-12,07:52,7,0,7
62,2023-08-12T07:48:00+10:00,2023-08-12,07:48,2,3,5
62,2023-08-12T07:52:00+10:00,2023-08-12,07:52,0,2,2
63,2023-08-12T07:45:00+10:00,2023-08-12,07:45,1,0,1
63,2023-08-12T07:49:00+10:00,2023-08-12,07:49,1,0,1
67,2023-08-12T07:41:00+10:00,2023-08-12,07:41,0,4,4
67,2023-08-12T07:42:00+10:00,2023-08-12,07:42,1,4,5
67,2023-08-12T07:45:00+10:00,2023-08-12,07:45,2,0,2
67,2023-08-12T07:46:00+10:00,2023-08-12,07:46,5,1,6
67,2023-08-12T07:47:00+10:00,2023-08-12,07:47,2,2,4
68,2023-08-12T07:41:00+10:00,2023-08-12,07:41,0,1,1
68,2023-08-12T07:43:00+10:00,2023-08-12,07:43,1,0,1
68,2023-08-12T07:46:00+10:00,2023-08-12,07:46,1,0,1
72,2023-08-12T07:41:00+10:00,2023-08-12,07:41,1,1,2
72,2023-08-12T07:43:00+10:00,2023-08-12,07:43,0,1,1
72,2023-08-12T07:54:00+10:00,2023-08-12,07:54,1,1,2
76,2023-08-12T07:40:00+10:00,2023-08-12,07:40,1,0,1
76,2023-08-12T07:43:00+10:00,2023-08-12,07:43,1,1,2
76,2023-08-12T07:52:00+10:00,2023-08-12,07:52,0,2,2
79,2023-08-12T07:40:00+10:00,2023-08-12,07:40,1,0,1
79,2023-08-12T07:41:00+10:00,2023-08-12,07:41,0,1,1
79,2023-08-12T07:45:00+10:00,2023-08-12,07:45,0,1,1
79,2023-08-12T07:47:00+10:00,2023-08-12,07:47,8,0,8
79,2023-08-12T07:48:00+10:00,2023-08-12,07:48,1,2,3
79,2023-08-12T07:54:00+10:00,2023-08-12,07:54,1,2,3
85,2023-08-12T07:43:00+10:00,2023-08-12,07:43,1,0,1
85,2023-08-12T07:44:00+10:00,2023-08-12,07:44,0,2,2
85,2023-08-12T07:52:00+10:00,2023-08-12,07:52,0,1,1
86,2023-08-12T07:40:00+10:00,2023-08-12,07:40,1,0,1
86,2023-08-12T07:47:00+10:00,2023-08-12,07:47,1,0,1
109,2023-08-12T07:40:00+10:00,2023-08-12,07:40,0,4,4
117,2023-08-12T07:50:00+10:00,2023-08-12,07:50,3,4,7
3,2023-08-12T08:00:00+10:00,2023-08-12,08:00,0,1,1
3,2023-08-12T08:02:00+10:00,2023-08-12,08:02,4,4,8
3,2023-08-12T08:03:00+10:00,2023-08-12,08:03,1,3,4
3,2023-08-12T08:07:00+10:00,2023-08-12,08:07,2,1,3
4,2023-08-12T07:56:00+10:00,2023-08-12,07:56,1,0,1
4,2023-08-12T07:57:00+10:00,2023-08-12,07:57,3,0,3
4,2023-08-12T07:59:00+10:00,2023-08-12,07:59,1,0,1
4,2023-08-12T08:05:00+10:00,2023-08-12,08:05,2,0,2
4,2023-08-12T08:08:00+10:00,2023-08-12,08:08,1,0,1
4,2023-08-12T08:09:00+10:00,2023-08-12,08:09,2,3,5
6,2023-08-12T07:55:00+10:00,2023-08-12,07:55,2,0,2
6,2023-08-12T08:08:00+10:00,2023-08-12,08:08,2,3,5
8,2023-08-12T08:06:00+10:00,2023-08-12,08:06,1,3,4
8,2023-08-12T08:08:00+10:00,2023-08-12,08:08,0,1,1
8,2023-08-12T08:09:00+10:00,2023-08-12,08:09,1,0,1
14,2023-08-12T07:57:00+10:00,2023-08-12,07:57,1,1,2
14,2023-08-12T07:59:00+10:00,2023-08-12,07:59,1,0,1
14,2023-08-12T08:00:00+10:00,2023-08-12,08:00,1,2,3
14,2023-08-12T08:08:00+10:00,2023-08-12,08:08,2,0,2
21,2023-08-12T07:55:00+10:00,2023-08-12,07:55,1,0,1
21,2023-08-12T08:00:00+10:00,2023-08-12,08:00,0,1,1
21,2023-08-12T08:06:00+10:00,2023-08-12,08:06,2,0,2
21,2023-08-12T08:07:00+10:00,2023-08-12,08:07,0,1,1
21,2023-08-12T08:08:00+10:00,2023-08-12,08:08,1,0,1
28,2023-08-12T08:00:00+10:00,2023-08-12,08:00,0,1,1
28,2023-08-12T08:01:00+10:00,2023-08-12,08:01,0,1,1
28,2023-08-12T08:03:00+10:00,2023-08-12,08:03,1,0,1
28,2023-08-12T08:05:00+10:00,2023-08-12,08:05,1,0,1
28,2023-08-12T08:08:00+10:00,2023-08-12,08:08,0,3,3
29,2023-08-12T07:58:00+10:00,2023-08-12,07:58,2,3,5
29,2023-08-12T07:59:00+10:00,2023-08-12,07:59,1,1,2
29,2023-08-12T08:00:00+10:00,2023-08-12,08:00,0,1,1
29,2023-08-12T08:03:00+10:00,2023-08-12,08:03,1,6,7
29,2023-08-12T08:04:00+10:00,2023-08-12,08:04,1,2,3
39,2023-08-12T08:04:00+10:00,2023-08-12,08:04,1,1,2
39,2023-08-12T08:08:00+10:00,2023-08-12,08:08,0,2,2
41,2023-08-12T07:57:00+10:00,2023-08-12,07:57,5,5,10
41,2023-08-12T08:03:00+10:00,2023-08-12,08:03,4,1,5
41,2023-08-12T08:08:00+10:00,2023-08-12,08:08,2,4,6
54,2023-08-12T08:03:00+10:00,2023-08-12,08:03,1,0,1
54,2023-08-12T08:06:00+10:00,2023-08-12,08:06,2,3,5
55,2023-08-12T07:55:00+10:00,2023-08-12,07:55,0,2,2
55,2023-08-12T07:59:00+10:00,2023-08-12,07:59,1,8,9
55,2023-08-12T08:02:00+10:00,2023-08-12,08:02,2,3,5
55,2023-08-12T08:06:00+10:00,2023-08-12,08:06,0,3,3
59,2023-08-12T08:00:00+10:00,2023-08-12,08:00,12,4,16
59,2023-08-12T08:05:00+10:00,2023-08-12,08:05,2,8,10
61,2023-08-12T08:04:00+10:00,2023-08-12,08:04,0,2,2
61,2023-08-12T08:08:00+10:00,2023-08-12,08:08,1,0,1
65,2023-08-12T08:01:00+10:00,2023-08-12,08:01,4,2,6
66,2023-08-12T08:02:00+10:00,2023-08-12,08:02,0,1,1
66,2023-08-12T08:04:00+10:00,2023-08-12,08:04,1,2,3
66,2023-08-12T08:06:00+10:00,2023-08-12,08:06,1,0,1
66,2023-08-12T08:07:00+10:00,2023-08-12,08:07,1,2,3
70,2023-08-12T08:06:00+10:00,2023-08-12,08:06,1,0,1
70,2023-08-12T08:09:00+10:00,2023-08-12,08:09,0,1,1
77,2023-08-12T08:00:00+10:00,2023-08-12,08:00,2,1,3
77,2023-08-12T08:02:00+10:00,2023-08-12,08:02,3,0,3
77,2023-08-12T08:08:00+10:00,2023-08-12,08:08,2,0,2
78,2023-08-12T08:00:00+10:00,2023-08-12,08:00,0,2,2
78,2023-08-12T08:07:00+10:00,2023-08-12,08:07,0,1,1
84,2023-08-12T07:55:00+10:00,2023-08-12,07:55,19,15,34
87,2023-08-12T07:55:00+10:00,2023-08-12,07:55,3,1,4
87,2023-08-12T07:58:00+10:00,2023-08-12,07:58,1,0,1
87,2023-08-12T08:00:00+10:00,2023-08-12,08:00,1,0,1
87,2023-08-12T08:01:00+10:00,2023-08-12,08:01,0,2,2
87,2023-08-12T08:02:00+10:00,2023-08-12,08:02,2,0,2
87,2023-08-12T08:04:00+10:00,2023-08-12,08:04,1,0,1
107,2023-08-12T07:55:00+10:00,2023-08-12,07:55,3,2,5
107,2023-08-12T08:00:00+10:00,2023-08-12,08:00,1,1,2
108,2023-08-12T07:55:00+10:00,2023-08-12,07:55,0,1,1
108,2023-08-12T08:02:00+10:00,2023-08-12,08:02,0,2,2
108,2023-08-12T08:04:00+10:00,2023-08-12,08:04,0,1,1
108,2023-08-12T08:06:00+10:00,2023-08-12,08:06,2,1,3
108,2023-08-12T08:07:00+10:00,2023-08-12,08:07,0,4,4
108,2023-08-12T08:08:00+10:00,2023-08-12,08:08,0,1,1
1,2023-08-12T08:02:00+10:00,2023-08-12,08:02,1,1,2
1,2023-08-12T08:03:00+10:00,2023-08-12,08:03,3,3,6
1,2023-08-12T08:07:00+10:00,2023-08-12,08:07,1,0,1
2,2023-08-12T07:58:00+10:00,2023-08-12,07:58,0,2,2
2,2023-08-12T08:00:00+10:00,2023-08-12,08:00,1,1,2
2,2023-08-12T08:01:00+10:00,2023-08-12,08:01,1,1,2
2,2023-08-12T08:05:00+10:00,2023-08-12,08:05,1,1,2
2,2023-08-12T08:07:00+10:00,2023-08-12,08:07,1,2,3
7,2023-08-12T07:55:00+10:00,2023-08-12,07:55,1,2,3
7,2023-08-12T08:00:00+10:00,2023-08-12,08:00,2,0,2
7,2023-08-12T08:07:00+10:00,2023-08-12,08:07,1,2,3
9,2023-08-12T08:05:00+10:00,2023-08-12,08:05,0,3,3
9,2023-08-12T08:08:00+10:00,2023-08-12,08:08,0,1,1
10,2023-08-12T08:02:00+10:00,2023-08-12,08:02,1,1,2
11,2023-08-12T07:55:00+10:00,2023-08-12,07:55,1,2,3
11,2023-08-12T08:04:00+10:00,2023-08-12,08:04,0,1,1
12,2023-08-12T08:07:00+10:00,2023-08-12,08:07,1,1,2
17,2023-08-12T07:57:00+10:00,2023-08-12,07:57,1,0,1
17,2023-08-12T08:04:00+10:00,2023-08-12,08:04,2,0,2
18,2023-08-12T07:58:00+10:00,2023-08-12,07:58,0,1,1
24,2023-08-12T07:55:00+10:00,2023-08-12,07:55,4,2,6
24,2023-08-12T07:57:00+10:00,2023-08-12,07:57,4,6,10
24,2023-08-12T07:58:00+10:00,2023-08-12,07:58,1,13,14
24,2023-08-12T08:02:00+10:00,2023-08-12,08:02,3,3,6
24,2023-08-12T08:03:00+10:00,2023-08-12,08:03,0,1,1
24,2023-08-12T08:04:00+10:00,2023-08-12,08:04,0,5,5
24,2023-08-12T08:08:00+10:00,2023-08-12,08:08,5,3,8
24,2023-08-12T08:09:00+10:00,2023-08-12,08:09,3,3,6
27,2023-08-12T07:56:00+10:00,2023-08-12,07:56,1,2,3
27,2023-08-12T08:00:00+10:00,2023-08-12,08:00,0,1,1
35,2023-08-12T07:55:00+10:00,2023-08-12,07:55,3,0,3
35,2023-08-12T08:04:00+10:00,2023-08-12,08:04,0,3,3
35,2023-08-12T08:06:00+10:00,2023-08-12,08:06,4,3,7
53,2023-08-12T07:58:00+10:00,2023-08-12,07:58,1,2,3
53,2023-08-12T07:59:00+10:00,2023-08-12,07:59,1,1,2
53,2023-08-12T08:05:00+10:00,2023-08-12,08:05,4,1,5
53,2023-08-12T08:08:00+10:00,2023-08-12,08:08,5,0,5
56,2023-08-12T07:56:00+10:00,2023-08-12,07:56,0,1,1
56,2023-08-12T07:58:00+10:00,2023-08-12,07:58,3,2,5
56,2023-08-12T08:00:00+10:00,2023-08-12,08:00,0,1,1
56,2023-08-12T08:02:00+10:00,2023-08-12,08:02,2,0,2
56,2023-08-12T08:08:00+10:00,2023-08-12,08:08,0,1,1
57,2023-08-12T07:56:00+10:00,2023-08-12,07:56,0,1,1
58,2023-08-12T07:56:00+10:00,2023-08-12,07:56,3,4,7
58,2023-08-12T07:57:00+10:00,2023-08-12,07:57,7,1,8
58,2023-08-12T07:58:00+10:00,2023-08-12,07:58,0,1,1
58,2023-08-12T08:02:00+10:00,2023-08-12,08:02,2,1,3
62,2023-08-12T07:57:00+10:00,2023-08-12,07:57,1,2,3
62,2023-08-12T08:00:00+10:00,2023-08-12,08:00,1,0,1
62,2023-08-12T08:02:00+10:00,2023-08-12,08:02,0,2,2
62,2023-08-12T08:03:00+10:00,2023-08-12,08:03,1,3,4
62,2023-08-12T08:04:00+10:00,2023-08-12,08:04,1,0,1
67,2023-08-12T08:01:00+10:00,2023-08-12,08:01,2,1,3
67,2023-08-12T08:03:00+10:00,2023-08-12,08:03,2,0,2
67,2023-08-12T08:09:00+10:00,2023-08-12,08:09,1,2,3
68,2023-08-12T08:01:00+10:00,2023-08-12,08:01,2,1,3
68,2023-08-12T08:08:00+10:00,2023-08-12,08:08,2,1,3
72,2023-08-12T08:04:00+10:00,2023-08-12,08:04,0,1,1
72,2023-08-12T08:05:00+10:00,2023-08-12,08:05,1,0,1
72,2023-08-12T08:09:00+10:00,2023-08-12,08:09,0,1,1
76,2023-08-12T07:57:00+10:00,2023-08-12,07:57,0,1,1
76,2023-08-12T07:59:00+10:00,2023-08-12,07:59,1,0,1
76,2023-08-12T08:01:00+10:00,2023-08-12,08:01,1,0,1
76,2023-08-12T08:08:00+10:00,2023-08-12,08:08,0,1,1
79,2023-08-12T08:00:00+10:00,2023-08-12,08:00,2,0,2
79,2023-08-12T08:05:00+10:00,2023-08-12,08:05,1,0,1
79,2023-08-12T08:08:00+10:00,2023-08-12,08:08,3,2,5
79,2023-08-12T08:09:00+10:00,2023-08-12,08:09,1,0,1
85,2023-08-12T07:59:00+10:00,2023-08-12,07:59,1,0,1
85,2023-08-12T08:00:00+10:00,2023-08-12,08:00,2,0,2
85,2023-08-12T08:01:00+10:00,2023-08-12,08:01,0,2,2
85,2023-08-12T08:02:00+10:00,2023-08-12,08:02,1,0,1
85,2023-08-12T08:03:00+10:00,2023-08-12,08:03,2,2,4
85,2023-08-12T08:09:00+10:00,2023-08-12,08:09,1,0,1
86,2023-08-12T08:03:00+10:00,2023-08-12,08:03,1,0,1
109,2023-08-12T08:00:00+10:00,2023-08-12,08:00,0,6,6
117,2023-08-12T08:00:00+10:00,2023-08-12,08:00,0,1,1
117,2023-08-12T08:05:00+10:00,2023-08-12,08:05,3,0,3
122,2023-08-12T07:57:00+10:00,2023-08-12,07:57,0,1,1
122,2023-08-12T08:01:00+10:00,2023-08-12,08:01,2,0,2
122,2023-08-12T08:07:00+10:00,2023-08-12,08:07,1,0,1
3,2023-08-12T08:12:00+10:00,2023-08-12,08:12,3,3,6
3,2023-08-12T08:14:00+10:00,2023-08-12,08:14,3,0,3
3,2023-08-12T08:18:00+10:00,2023-08-12,08:18,3,1,4
3,2023-08-12T08:20:00+10:00,2023-08-12,08:20,2,1,3
3,2023-08-12T08:21:00+10:00,2023-08-12,08:21,0,1,1
4,2023-08-12T08:10:00+10:00,2023-08-12,08:10,1,2,3
4,2023-08-12T08:11:00+10:00,2023-08-12,08:11,1,0,1
4,2023-08-12T08:14:00+10:00,2023-08-12,08:14,3,1,4
4,2023-08-12T08:22:00+10:00,2023-08-12,08:22,3,3,6
4,2023-08-12T08:23:00+10:00,2023-08-12,08:23,4,2,6
6,2023-08-12T08:14:00+10:00,2023-08-12,08:14,2,1,3
6,2023-08-12T08:18:00+10:00,2023-08-12,08:18,4,3,7
6,2023-08-12T08:19:00+10:00,2023-08-12,08:19,3,6,9
6,2023-08-12T08:23:00+10:00,2023-08-12,08:23,3,0,3
6,2023-08-12T08:24:00+10:00,2023-08-12,08:24,3,2,5
8,2023-08-12T08:16:00+10:00,2023-08-12,08:16,1,1,2
8,2023-08-12T08:17:00+10:00,2023-08-12,08:17,0,3,3
8,2023-08-12T08:20:00+10:00,2023-08-12,08:20,2,0,2
8,2023-08-12T08:22:00+10:00,2023-08-12,08:22,0,2,2
14,2023-08-12T08:11:00+10:00,2023-08-12,08:11,2,3,5
14,2023-08-12T08:12:00+10:00,2023-08-12,08:12,4,3,7
14,2023-08-12T08:13:00+10:00,2023-08-12,08:13,1,1,2
14,2023-08-12T08:19:00+10:00,2023-08-12,08:19,3,0,3
14,2023-08-12T08:21:00+10:00,2023-08-12,08:21,0,1,1
14,2023-08-12T08:22:00+10:00,2023-08-12,08:22,2,0,2
14,2023-08-12T08:24:00+10:00,2023-08-12,08:24,3,1,4
21,2023-08-12T08:21:00+10:00,2023-08-12,08:21,1,4,5
21,2023-08-12T08:22:00+10:00,2023-08-12,08:22,1,3,4
28,2023-08-12T08:10:00+10:00,2023-08-12,08:10,1,1,2
28,2023-08-12T08:21:00+10:00,2023-08-12,08:21,1,0,1
28,2023-08-12T08:22:00+10:00,2023-08-12,08:22,5,1,6
28,2023-08-12T08:24:00+10:00,2023-08-12,08:24,1,0,1
29,2023-08-12T08:15:00+10:00,2023-08-12,08:15,1,1,2
29,2023-08-12T08:16:00+10:00,2023-08-12,08:16,7,1,8
29,2023-08-12T08:21:00+10:00,2023-08-12,08:21,0,1,1
29,2023-08-12T08:24:00+10:00,2023-08-12,08:24,4,0,4
39,2023-08-12T08:15:00+10:00,2023-08-12,08:15,2,0,2
39,2023-08-12T08:19:00+10:00,2023-08-12,08:19,1,1,2
39,2023-08-12T08:24:00+10:00,2023-08-12,08:24,1,0,1
41,2023-08-12T08:14:00+10:00,2023-08-12,08:14,4,1,5
41,2023-08-12T08:16:00+10:00,2023-08-12,08:16,5,5,10
41,2023-08-12T08:17:00+10:00,2023-08-12,08:17,10,2,12
41,2023-08-12T08:18:00+10:00,2023-08-12,08:18,2,3,5
41,2023-08-12T08:19:00+10:00,2023-08-12,08:19,8,0,8
54,2023-08-12T08:16:00+10:00,2023-08-12,08:16,2,1,3
55,2023-08-12T08:11:00+10:00,2023-08-12,08:11,1,0,1
55,2023-08-12T08:19:00+10:00,2023-08-12,08:19,3,2,5
55,2023-08-12T08:22:00+10:00,2023-08-12,08:22,2,0,2
55,2023-08-12T08:23:00+10:00,2023-08-12,08:23,1,3,4
55,2023-08-12T08:24:00+10:00,2023-08-12,08:24,6,2,8
59,2023-08-12T08:20:00+10:00,2023-08-12,08:20,15,7,22
61,2023-08-12T08:11:00+10:00,2023-08-12,08:11,1,3,4
61,2023-08-12T08:12:00+10:00,2023-08-12,08:12,0,4,4
61,2023-08-12T08:14:00+10:00,2023-08-12,08:14,3,0,3
61,2023-08-12T08:17:00+10:00,2023-08-12,08:17,0,1,1
65,2023-08-12T08:15:00+10:00,2023-08-12,08:15,1,2,3
65,2023-08-12T08:21:00+10:00,2023-08-12,08:21,1,7,8
65,2023-08-12T08:22:00+10:00,2023-08-12,08:22,0,1,1
65,2023-08-12T08:24:00+10:00,2023-08-12,08:24,5,0,5
66,2023-08-12T08:10:00+10:00,2023-08-12,08:10,1,2,3
66,2023-08-12T08:12:00+10:00,2023-08-12,08:12,1,0,1
66,2023-08-12T08:13:00+10:00,2023-08-12,08:13,1,1,2
66,2023-08-12T08:14:00+10:00,2023-08-12,08:14,0,1,1
66,2023-08-12T08:24:00+10:00,2023-08-12,08:24,1,0,1
69,2023-08-12T08:19:00+10:00,2023-08-12,08:19,4,1,5
69,2023-08-12T08:22:00+10:00,2023-08-12,08:22,1,1,2
69,2023-08-12T08:24:00+10:00,2023-08-12,08:24,1,0,1
70,2023-08-12T08:10:00+10:00,2023-08-12,08:10,0,1,1
71,2023-08-12T08:11:00+10:00,2023-08-12,08:11,0,1,1
75,2023-08-12T08:11:00+10:00,2023-08-12,08:11,2,0,2
75,2023-08-12T08:12:00+10:00,2023-08-12,08:12,2,1,3
75,2023-08-12T08:18:00+10:00,2023-08-12,08:18,3,0,3
77,2023-08-12T08:12:00+10:00,2023-08-12,08:12,1,0,1
77,2023-08-12T08:17:00+10:00,2023-08-12,08:17,0,4,4
77,2023-08-12T08:19:00+10:00,2023-08-12,08:19,0,1,1
77,2023-08-12T08:21:00+10:00,2023-08-12,08:21,1,4,5
78,2023-08-12T08:14:00+10:00,2023-08-12,08:14,0,2,2
78,2023-08-12T08:23:00+10:00,2023-08-12,08:23,1,1,2
84,2023-08-12T08:20:00+10:00,2023-08-12,08:20,36,15,51
87,2023-08-12T08:10:00+10:00,2023-08-12,08:10,0,1,1
87,2023-08-12T08:11:00+10:00,2023-08-12,08:11,2,1,3
87,2023-08-12T08:12:00+10:00,2023-08-12,08:12,0,1,1
87,2023-08-12T08:20:00+10:00,2023-08-12,08:20,0,1,1
87,2023-08-12T08:21:00+10:00,2023-08-12,08:21,1,0,1
107,2023-08-12T08:15:00+10:00,2023-08-12,08:15,2,2,4
108,2023-08-12T08:10:00+10:00,2023-08-12,08:10,2,0,2
108,2023-08-12T08:16:00+10:00,2023-08-12,08:16,0,3,3
108,2023-08-12T08:23:00+10:00,2023-08-12,08:23,0,3,3
1,2023-08-12T08:18:00+10:00,2023-08-12,08:18,0,3,3
1,2023-08-12T08:19:00+10:00,2023-08-12,08:19,1,1,2
1,2023-08-12T08:21:00+10:00,2023-08-12,08:21,1,0,1
1,2023-08-12T08:24:00+10:00,2023-08-12,08:24,1,1,2
2,2023-08-12T08:12:00+10:00,2023-08-12,08:12,1,0,1
2,2023-08-12T08:15:00+10:00,2023-08-12,08:15,1,0,1
2,2023-08-12T08:18:00+10:00,2023-08-12,08:18,0,2,2
2,2023-08-12T08:19:00+10:00,2023-08-12,08:19,1,1,2
7,2023-08-12T08:16:00+10:00,2023-08-12,08:16,2,0,2
9,2023-08-12T08:13:00+10:00,2023-08-12,08:13,0,1,1
10,2023-08-12T08:23:00+10:00,2023-08-12,08:23,2,0,2
11,2023-08-12T08:20:00+10:00,2023-08-12,08:20,0,3,3
12,2023-08-12T08:11:00+10:00,2023-08-12,08:11,2,0,2
12,2023-08-12T08:16:00+10:00,2023-08-12,08:16,0,1,1
12,2023-08-12T08:18:00+10:00,2023-08-12,08:18,3,0,3
12,2023-08-12T08:19:00+10:00,2023-08-12,08:19,1,0,1
12,2023-08-12T08:20:00+10:00,2023-08-12,08:20,2,0,2
17,2023-08-12T08:11:00+10:00,2023-08-12,08:11,4,0,4
17,2023-08-12T08:12:00+10:00,2023-08-12,08:12,0,1,1
17,2023-08-12T08:16:00+10:00,2023-08-12,08:16,0,1,1
17,2023-08-12T08:18:00+10:00,2023-08-12,08:18,3,1,4
17,2023-08-12T08:23:00+10:00,2023-08-12,08:23,2,0,2
24,2023-08-12T08:10:00+10:00,2023-08-12,08:10,1,3,4
24,2023-08-12T08:15:00+10:00,2023-08-12,08:15,8,5,13
24,2023-08-12T08:16:00+10:00,2023-08-12,08:16,5,7,12
24,2023-08-12T08:21:00+10:00,2023-08-12,08:21,1,1,2
24,2023-08-12T08:22:00+10:00,2023-08-12,08:22,1,0,1
24,2023-08-12T08:23:00+10:00,2023-08-12,08:23,1,1,2
24,2023-08-12T08:24:00+10:00,2023-08-12,08:24,5,0,5
27,2023-08-12T08:13:00+10:00,2023-08-12,08:13,1,2,3
27,2023-08-12T08:17:00+10:00,2023-08-12,08:17,0,1,1
27,2023-08-12T08:24:00+10:00,2023-08-12,08:24,5,2,7
35,2023-08-12T08:10:00+10:00,2023-08-12,08:10,6,2,8
35,2023-08-12T08:11:00+10:00,2023-08-12,08:11,3,3,6
35,2023-08-12T08:12:00+10:00,2023-08-12,08:12,2,3,5
35,2023-08-12T08:14:00+10:00,2023-08-12,08:14,2,3,5
35,2023-08-12T08:15:00+10:00,2023-08-12,08:15,3,2,5
35,2023-08-12T08:18:00+10:00,2023-08-12,08:18,10,2,12
35,2023-08-12T08:20:00+10:00,2023-08-12,08:20,5,3,8
35,2023-08-12T08:23:00+10:00,2023-08-12,08:23,10,5,15
35,2023-08-12T08:24:00+10:00,2023-08-12,08:24,3,5,8
53,2023-08-12T08:11:00+10:00,2023-08-12,08:11,2,2,4
53,2023-08-12T08:15:00+10:00,2023-08-12,08:15,1,1,2
53,2023-08-12T08:18:00+10:00,2023-08-12,08:18,1,0,1
53,2023-08-12T08:19:00+10:00,2023-08-12,08:19,3,1,4
53,2023-08-12T08:21:00+10:00,2023-08-12,08:21,1,1,2
53,2023-08-12T08:23:00+10:00,2023-08-12,08:23,3,0,3
56,2023-08-12T08:18:00+10:00,2023-08-12,08:18,7,0,7
56,2023-08-12T08:21:00+10:00,2023-08-12,08:21,0,1,1
57,2023-08-12T08:13:00+10:00,2023-08-12,08:13,1,0,1
57,2023-08-12T08:20:00+10:00,2023-08-12,08:20,1,0,1
57,2023-08-12T08:22:00+10:00,2023-08-12,08:22,4,0,4
57,2023-08-12T08:24:00+10:00,2023-08-12,08:24,1,1,2
58,2023-08-12T08:11:00+10:00,2023-08-12,08:11,5,2,7
58,2023-08-12T08:12:00+10:00,2023-08-12,08:12,3,0,3
58,2023-08-12T08:15:00+10:00,2023-08-12,08:15,7,1,8
58,2023-08-12T08:16:00+10:00,2023-08-12,08:16,3,0,3
58,2023-08-12T08:19:00+10:00,2023-08-12,08:19,0,6,6
58,2023-08-12T08:21:00+10:00,2023-08-12,08:21,6,2,8
58,2023-08-12T08:23:00+10:00,2023-08-12,08:23,11,0,11
62,2023-08-12T08:10:00+10:00,2023-08-12,08:10,0,1,1
62,2023-08-12T08:13:00+10:00,2023-08-12,08:13,1,0,1
62,2023-08-12T08:14:00+10:00,2023-08-12,08:14,1,0,1
62,2023-08-12T08:16:00+10:00,2023-08-12,08:16,1,0,1
62,2023-08-12T08:19:00+10:00,2023-08-12,08:19,1,0,1
62,2023-08-12T08:20:00+10:00,2023-08-12,08:20,1,0,1
62,2023-08-12T08:21:00+10:00,2023-08-12,08:21,1,5,6
62,2023-08-12T08:23:00+10:00,2023-08-12,08:23,1,0,1
63,2023-08-12T08:24:00+10:00,2023-08-12,08:24,0,2,2
67,2023-08-12T08:10:00+10:00,2023-08-12,08:10,3,2,5
67,2023-08-12T08:11:00+10:00,2023-08-12,08:11,0,1,1
67,2023-08-12T08:16:00+10:00,2023-08-12,08:16,1,0,1
67,2023-08-12T08:17:00+10:00,2023-08-12,08:17,2,1,3
67,2023-08-12T08:18:00+10:00,2023-08-12,08:18,2,2,4
67,2023-08-12T08:19:00+10:00,2023-08-12,08:19,0,4,4
67,2023-08-12T08:20:00+10:00,2023-08-12,08:20,2,1,3
68,2023-08-12T08:10:00+10:00,2023-08-12,08:10,2,1,3
68,2023-08-12T08:12:00+10:00,2023-08-12,08:12,0,1,1
68,2023-08-12T08:13:00+10:00,2023-08-12,08:13,2,2,4
68,2023-08-12T08:22:00+10:00,2023-08-12,08:22,0,1,1
72,2023-08-12T08:10:00+10:00,2023-08-12,08:10,6,0,6
72,2023-08-12T08:20:00+10:00,2023-08-12,08:20,2,0,2
72,2023-08-12T08:23:00+10:00,2023-08-12,08:23,1,0,1
76,2023-08-12T08:12:00+10:00,2023-08-12,08:12,0,1,1
76,2023-08-12T08:16:00+10:00,2023-08-12,08:16,1,0,1
76,2023-08-12T08:24:00+10:00,2023-08-12,08:24,1,0,1
79,2023-08-12T08:10:00+10:00,2023-08-12,08:10,1,2,3
79,2023-08-12T08:12:00+10:00,2023-08-12,08:12,0,4,4
79,2023-08-12T08:13:00+10:00,2023-08-12,08:13,3,3,6
79,2023-08-12T08:22:00+10:00,2023-08-12,08:22,1,2,3
85,2023-08-12T08:13:00+10:00,2023-08-12,08:13,0,3,3
85,2023-08-12T08:18:00+10:00,2023-08-12,08:18,2,0,2
85,2023-08-12T08:22:00+10:00,2023-08-12,08:22,2,1,3
85,2023-08-12T08:24:00+10:00,2023-08-12,08:24,1,0,1
86,2023-08-12T08:19:00+10:00,2023-08-12,08:19,1,0,1
109,2023-08-12T08:15:00+10:00,2023-08-12,08:15,3,7,10
109,2023-08-12T08:20:00+10:00,2023-08-12,08:20,0,5,5
3,2023-08-12T08:25:00+10:00,2023-08-12,08:25,1,3,4
3,2023-08-12T08:29:00+10:00,2023-08-12,08:29,1,2,3
3,2023-08-12T08:30:00+10:00,2023-08-12,08:30,2,1,3
4,2023-08-12T08:28:00+10:00,2023-08-12,08:28,2,0,2
4,2023-08-12T08:29:00+10:00,2023-08-12,08:29,1,4,5
4,2023-08-12T08:30:00+10:00,2023-08-12,08:30,6,4,10
4,2023-08-12T08:33:00+10:00,2023-08-12,08:33,5,0,5
4,2023-08-12T08:35:00+10:00,2023-08-12,08:35,3,4,7
4,2023-08-12T08:36:00+10:00,2023-08-12,08:36,7,0,7
6,2023-08-12T08:26:00+10:00,2023-08-12,08:26,1,1,2
6,2023-08-12T08:27:00+10:00,2023-08-12,08:27,2,4,6
6,2023-08-12T08:31:00+10:00,2023-08-12,08:31,3,2,5
6,2023-08-12T08:33:00+10:00,2023-08-12,08:33,1,0,1
6,2023-08-12T08:35:00+10:00,2023-08-12,08:35,4,1,5
6,2023-08-12T08:36:00+10:00,2023-08-12,08:36,1,4,5
6,2023-08-12T08:37:00+10:00,2023-08-12,08:37,2,4,6
6,2023-08-12T08:39:00+10:00,2023-08-12,08:39,4,4,8
8,2023-08-12T08:28:00+10:00,2023-08-12,08:28,2,0,2
14,2023-08-12T08:25:00+10:00,2023-08-12,08:25,3,0,3
14,2023-08-12T08:27:00+10:00,2023-08-12,08:27,2,1,3
14,2023-08-12T08:28:00+10:00,2023-08-12,08:28,2,1,3
14,2023-08-12T08:35:00+10:00,2023-08-12,08:35,5,1,6
14,2023-08-12T08:36:00+10:00,2023-08-12,08:36,1,0,1
21,2023-08-12T08:26:00+10:00,2023-08-12,08:26,0,2,2
21,2023-08-12T08:27:00+10:00,2023-08-12,08:27,0,1,1
21,2023-08-12T08:28:00+10:00,2023-08-12,08:28,0,3,3
21,2023-08-12T08:31:00+10:00,2023-08-12,08:31,0,3,3
21,2023-08-12T08:38:00+10:00,2023-08-12,08:38,0,1,1
28,2023-08-12T08:37:00+10:00,2023-08-12,08:37,0,1,1
29,2023-08-12T08:29:00+10:00,2023-08-12,08:29,2,2,4
29,2023-08-12T08:37:00+10:00,2023-08-12,08:37,1,0,1
39,2023-08-12T08:27:00+10:00,2023-08-12,08:27,1,2,3
39,2023-08-12T08:30:00+10:00,2023-08-12,08:30,1,0,1
39,2023-08-12T08:32:00+10:00,2023-08-12,08:32,1,0,1
39,2023-08-12T08:33:00+10:00,2023-08-12,08:33,0,1,1
41,2023-08-12T08:33:00+10:00,2023-08-12,08:33,18,4,22
41,2023-08-12T08:34:00+10:00,2023-08-12,08:34,5,6,11
41,2023-08-12T08:35:00+10:00,2023-08-12,08:35,12,6,18
54,2023-08-12T08:27:00+10:00,2023-08-12,08:27,1,0,1
54,2023-08-12T08:31:00+10:00,2023-08-12,08:31,2,1,3
54,2023-08-12T08:35:00+10:00,2023-08-12,08:35,0,1,1
54,2023-08-12T08:37:00+10:00,2023-08-12,08:37,3,1,4
55,2023-08-12T08:26:00+10:00,2023-08-12,08:26,2,2,4
55,2023-08-12T08:28:00+10:00,2023-08-12,08:28,4,1,5
55,2023-08-12T08:30:00+10:00,2023-08-12,08:30,2,6,8
55,2023-08-12T08:32:00+10:00,2023-08-12,08:32,8,1,9
55,2023-08-12T08:38:00+10:00,2023-08-12,08:38,3,7,10
59,2023-08-12T08:25:00+10:00,2023-08-12,08:25,11,2,13
59,2023-08-12T08:30:00+10:00,2023-08-12,08:30,6,5,11
61,2023-08-12T08:26:00+10:00,2023-08-12,08:26,3,4,7
61,2023-08-12T08:27:00+10:00,2023-08-12,08:27,0,1,1
61,2023-08-12T08:28:00+10:00,2023-08-12,08:28,0,3,3
61,2023-08-12T08:30:00+10:00,2023-08-12,08:30,1,1,2
61,2023-08-12T08:31:00+10:00,2023-08-12,08:31,1,1,2
61,2023-08-12T08:39:00+10:00,2023-08-12,08:39,1,2,3
65,2023-08-12T08:26:00+10:00,2023-08-12,08:26,4,1,5
65,2023-08-12T08:28:00+10:00,2023-08-12,08:28,3,1,4
65,2023-08-12T08:30:00+10:00,2023-08-12,08:30,2,2,4
65,2023-08-12T08:36:00+10:00,2023-08-12,08:36,0,5,5
66,2023-08-12T08:25:00+10:00,2023-08-12,08:25,2,3,5
66,2023-08-12T08:28:00+10:00,2023-08-12,08:28,2,0,2
66,2023-08-12T08:35:00+10:00,2023-08-12,08:35,4,2,6
69,2023-08-12T08:28:00+10:00,2023-08-12,08:28,1,0,1
69,2023-08-12T08:29:00+10:00,2023-08-12,08:29,3,0,3
69,2023-08-12T08:30:00+10:00,2023-08-12,08:30,2,0,2
69,2023-08-12T08:33:00+10:00,2023-08-12,08:33,0,2,2
70,2023-08-12T08:26:00+10:00,2023-08-12,08:26,1,0,1
70,2023-08-12T08:28:00+10:00,2023-08-12,08:28,4,0,4
70,2023-08-12T08:33:00+10:00,2023-08-12,08:33,0,1,1
70,2023-08-12T08:36:00+10:00,2023-08-12,08:36,4,1,5
70,2023-08-12T08:37:00+10:00,2023-08-12,08:37,1,1,2
70,2023-08-12T08:38:00+10:00,2023-08-12,08:38,1,1,2
70,2023-08-12T08:39:00+10:00,2023-08-12,08:39,2,2,4
71,2023-08-12T08:27:00+10:00,2023-08-12,08:27,1,0,1
71,2023-08-12T08:33:00+10:00,2023-08-12,08:33,0,1,1
75,2023-08-12T08:25:00+10:00,2023-08-12,08:25,1,0,1
75,2023-08-12T08:31:00+10:00,2023-08-12,08:31,0,1,1
75,2023-08-12T08:35:00+10:00,2023-08-12,08:35,0,1,1
77,2023-08-12T08:31:00+10:00,2023-08-12,08:31,3,1,4
77,2023-08-12T08:33:00+10:00,2023-08-12,08:33,2,0,2
78,2023-08-12T08:28:00+10:00,2023-08-12,08:28,1,0,1
78,2023-08-12T08:37:00+10:00,2023-08-12,08:37,0,3,3
84,2023-08-12T08:35:00+10:00,2023-08-12,08:35,39,23,62
87,2023-08-12T08:30:00+10:00,2023-08-12,08:30,1,2,3
87,2023-08-12T08:32:00+10:00,2023-08-12,08:32,0,3,3
87,2023-08-12T08:33:00+10:00,2023-08-12,08:33,1,1,2
87,2023-08-12T08:39:00+10:00,2023-08-12,08:39,1,1,2
107,2023-08-12T08:30:00+10:00,2023-08-12,08:30,7,3,10
107,2023-08-12T08:35:00+10:00,2023-08-12,08:35,1,2,3
108,2023-08-12T08:25:00+10:00,2023-08-12,08:25,1,0,1
108,2023-08-12T08:27:00+10:00,2023-08-12,08:27,4,1,5
108,2023-08-12T08:33:00+10:00,2023-08-12,08:33,0,4,4
108,2023-08-12T08:38:00+10:00,2023-08-12,08:38,2,5,7
108,2023-08-12T08:39:00+10:00,2023-08-12,08:39,4,1,5
1,2023-08-12T08:25:00+10:00,2023-08-12,08:25,1,2,3
1,2023-08-12T08:28:00+10:00,2023-08-12,08:28,0,2,2
2,2023-08-12T08:25:00+10:00,2023-08-12,08:25,1,1,2
2,2023-08-12T08:27:00+10:00,2023-08-12,08:27,2,0,2
2,2023-08-12T08:29:00+10:00,2023-08-12,08:29,1,2,3
2,2023-08-12T08:30:00+10:00,2023-08-12,08:30,2,1,3
2,2023-08-12T08:32:00+10:00,2023-08-12,08:32,0,1,1
2,2023-08-12T08:34:00+10:00,2023-08-12,08:34,1,1,2
2,2023-08-12T08:36:00+10:00,2023-08-12,08:36,1,2,3
2,2023-08-12T08:38:00+10:00,2023-08-12,08:38,2,1,3
7,2023-08-12T08:28:00+10:00,2023-08-12,08:28,0,4,4
9,2023-08-12T08:33:00+10:00,2023-08-12,08:33,1,1,2
9,2023-08-12T08:35:00+10:00,2023-08-12,08:35,0,1,1
9,2023-08-12T08:38:00+10:00,2023-08-12,08:38,1,1,2
10,2023-08-12T08:33:00+10:00,2023-08-12,08:33,1,2,3
10,2023-08-12T08:37:00+10:00,2023-08-12,08:37,1,0,1
10,2023-08-12T08:38:00+10:00,2023-08-12,08:38,1,0,1
11,2023-08-12T08:25:00+10:00,2023-08-12,08:25,2,1,3
11,2023-08-12T08:38:00+10:00,2023-08-12,08:38,0,1,1
11,2023-08-12T08:39:00+10:00,2023-08-12,08:39,2,2,4
12,2023-08-12T08:30:00+10:00,2023-08-12,08:30,0,1,1
12,2023-08-12T08:31:00+10:00,2023-08-12,08:31,6,0,6
12,2023-08-12T08:34:00+10:00,2023-08-12,08:34,0,2,2
17,2023-08-12T08:25:00+10:00,2023-08-12,08:25,1,2,3
17,2023-08-12T08:26:00+10:00,2023-08-12,08:26,1,1,2
17,2023-08-12T08:28:00+10:00,2023-08-12,08:28,1,3,4
17,2023-08-12T08:29:00+10:00,2023-08-12,08:29,2,0,2
17,2023-08-12T08:31:00+10:00,2023-08-12,08:31,3,0,3
18,2023-08-12T08:28:00+10:00,2023-08-12,08:28,1,1,2
24,2023-08-12T08:25:00+10:00,2023-08-12,08:25,0,18,18
24,2023-08-12T08:27:00+10:00,2023-08-12,08:27,6,2,8
24,2023-08-12T08:30:00+10:00,2023-08-12,08:30,6,6,12
24,2023-08-12T08:31:00+10:00,2023-08-12,08:31,8,3,11
24,2023-08-12T08:32:00+10:00,2023-08-12,08:32,1,3,4
24,2023-08-12T08:33:00+10:00,2023-08-12,08:33,1,5,6
24,2023-08-12T08:34:00+10:00,2023-08-12,08:34,3,1,4
27,2023-08-12T08:28:00+10:00,2023-08-12,08:28,0,5,5
35,2023-08-12T08:26:00+10:00,2023-08-12,08:26,2,1,3
35,2023-08-12T08:27:00+10:00,2023-08-12,08:27,4,3,7
35,2023-08-12T08:35:00+10:00,2023-08-12,08:35,3,0,3
53,2023-08-12T08:26:00+10:00,2023-08-12,08:26,0,2,2
53,2023-08-12T08:28:00+10:00,2023-08-12,08:28,2,0,2
53,2023-08-12T08:30:00+10:00,2023-08-12,08:30,1,0,1
53,2023-08-12T08:39:00+10:00,2023-08-12,08:39,5,3,8
56,2023-08-12T08:29:00+10:00,2023-08-12,08:29,0,2,2
56,2023-08-12T08:31:00+10:00,2023-08-12,08:31,3,0,3
56,2023-08-12T08:33:00+10:00,2023-08-12,08:33,0,1,1
56,2023-08-12T08:34:00+10:00,2023-08-12,08:34,0,1,1
56,2023-08-12T08:38:00+10:00,2023-08-12,08:38,4,0,4
56,2023-08-12T08:39:00+10:00,2023-08-12,08:39,1,1,2
57,2023-08-12T08:29:00+10:00,2023-08-12,08:29,1,0,1
57,2023-08-12T08:33:00+10:00,2023-08-12,08:33,0,1,1
58,2023-08-12T08:31:00+10:00,2023-08-12,08:31,2,2,4
58,2023-08-12T08:32:00+10:00,2023-08-12,08:32,4,0,4
58,2023-08-12T08:34:00+10:00,2023-08-12,08:34,15,5,20
58,2023-08-12T08:35:00+10:00,2023-08-12,08:35,8,1,9
58,2023-08-12T08:37:00+10:00,2023-08-12,08:37,6,3,9
62,2023-08-12T08:29:00+10:00,2023-08-12,08:29,2,2,4
62,2023-08-12T08:30:00+10:00,2023-08-12,08:30,1,0,1
62,2023-08-12T08:31:00+10:00,2023-08-12,08:31,0,1,1
62,2023-08-12T08:33:00+10:00,2023-08-12,08:33,0,1,1
62,2023-08-12T08:34:00+10:00,2023-08-12,08:34,1,2,3
62,2023-08-12T08:35:00+10:00,2023-08-12,08:35,0,1,1
62,2023-08-12T08:37:00+10:00,2023-08-12,08:37,1,1,2
63,2023-08-12T08:25:00+10:00,2023-08-12,08:25,1,0,1
63,2023-08-12T08:34:00+10:00,2023-08-12,08:34,1,0,1
63,2023-08-12T08:36:00+10:00,2023-08-12,08:36,0,3,3
63,2023-08-12T08:37:00+10:00,2023-08-12,08:37,0,1,1
67,2023-08-12T08:30:00+10:00,2023-08-12,08:30,0,3,3
67,2023-08-12T08:36:00+10:00,2023-08-12,08:36,4,7,11
68,2023-08-12T08:30:00+10:00,2023-08-12,08:30,0,2,2
68,2023-08-12T08:32:00+10:00,2023-08-12,08:32,0,1,1
68,2023-08-12T08:37:00+10:00,2023-08-12,08:37,0,1,1
72,2023-08-12T08:26:00+10:00,2023-08-12,08:26,1,1,2
72,2023-08-12T08:29:00+10:00,2023-08-12,08:29,0,2,2
72,2023-08-12T08:31:00+10:00,2023-08-12,08:31,1,1,2
72,2023-08-12T08:35:00+10:00,2023-08-12,08:35,1,1,2
72,2023-08-12T08:37:00+10:00,2023-08-12,08:37,1,7,8
72,2023-08-12T08:38:00+10:00,2023-08-12,08:38,1,2,3
72,2023-08-12T08:39:00+10:00,2023-08-12,08:39,1,1,2
76,2023-08-12T08:34:00+10:00,2023-08-12,08:34,2,0,2
79,2023-08-12T08:26:00+10:00,2023-08-12,08:26,1,1,2
79,2023-08-12T08:29:00+10:00,2023-08-12,08:29,3,3,6
79,2023-08-12T08:31:00+10:00,2023-08-12,08:31,2,3,5
85,2023-08-12T08:25:00+10:00,2023-08-12,08:25,1,1,2
85,2023-08-12T08:31:00+10:00,2023-08-12,08:31,1,3,4
85,2023-08-12T08:33:00+10:00,2023-08-12,08:33,0,1,1
85,2023-08-12T08:37:00+10:00,2023-08-12,08:37,0,2,2
85,2023-08-12T08:38:00+10:00,2023-08-12,08:38,3,1,4
86,2023-08-12T08:29:00+10:00,2023-08-12,08:29,1,0,1
117,2023-08-12T08:35:00+10:00,2023-08-12,08:35,11,4,15
122,2023-08-12T08:26:00+10:00,2023-08-12,08:26,0,1,1
122,2023-08-12T08:28:00+10:00,2023-08-12,08:28,0,2,2
3,2023-08-12T08:41:00+10:00,2023-08-12,08:41,3,1,4
3,2023-08-12T08:43:00+10:00,2023-08-12,08:43,4,3,7
3,2023-08-12T08:46:00+10:00,2023-08-12,08:46,2,3,5
3,2023-08-12T08:53:00+10:00,2023-08-12,08:53,7,2,9
4,2023-08-12T08:40:00+10:00,2023-08-12,08:40,3,6,9
4,2023-08-12T08:41:00+10:00,2023-08-12,08:41,6,6,12
4,2023-08-12T08:42:00+10:00,2023-08-12,08:42,9,3,12
4,2023-08-12T08:45:00+10:00,2023-08-12,08:45,11,3,14
4,2023-08-12T08:47:00+10:00,2023-08-12,08:47,7,3,10
4,2023-08-12T08:48:00+10:00,2023-08-12,08:48,10,6,16
8,2023-08-12T08:45:00+10:00,2023-08-12,08:45,0,3,3
8,2023-08-12T08:49:00+10:00,2023-08-12,08:49,2,5,7
8,2023-08-12T08:51:00+10:00,2023-08-12,08:51,4,0,4
8,2023-08-12T08:52:00+10:00,2023-08-12,08:52,0,3,3
14,2023-08-12T08:46:00+10:00,2023-08-12,08:46,3,1,4
14,2023-08-12T08:47:00+10:00,2023-08-12,08:47,3,0,3
14,2023-08-12T08:51:00+10:00,2023-08-12,08:51,0,2,2
14,2023-08-12T08:53:00+10:00,2023-08-12,08:53,2,0,2
21,2023-08-12T08:47:00+10:00,2023-08-12,08:47,1,4,5
21,2023-08-12T08:49:00+10:00,2023-08-12,08:49,2,0,2
21,2023-08-12T08:51:00+10:00,2023-08-12,08:51,2,3,5
28,2023-08-12T08:41:00+10:00,2023-08-12,08:41,1,1,2
28,2023-08-12T08:50:00+10:00,2023-08-12,08:50,2,2,4
29,2023-08-12T08:42:00+10:00,2023-08-12,08:42,0,5,5
29,2023-08-12T08:45:00+10:00,2023-08-12,08:45,0,6,6
29,2023-08-12T08:48:00+10:00,2023-08-12,08:48,0,2,2
29,2023-08-12T08:51:00+10:00,2023-08-12,08:51,2,0,2
29,2023-08-12T08:53:00+10:00,2023-08-12,08:53,1,1,2
39,2023-08-12T08:40:00+10:00,2023-08-12,08:40,1,0,1
39,2023-08-12T08:43:00+10:00,2023-08-12,08:43,2,1,3
39,2023-08-12T08:46:00+10:00,2023-08-12,08:46,1,2,3
39,2023-08-12T08:50:00+10:00,2023-08-12,08:50,0,1,1
39,2023-08-12T08:52:00+10:00,2023-08-12,08:52,0,1,1
39,2023-08-12T08:53:00+10:00,2023-08-12,08:53,1,2,3
39,2023-08-12T08:54:00+10:00,2023-08-12,08:54,0,2,2
41,2023-08-12T08:41:00+10:00,2023-08-12,08:41,10,5,15
41,2023-08-12T08:42:00+10:00,2023-08-12,08:42,20,2,22
41,2023-08-12T08:45:00+10:00,2023-08-12,08:45,8,6,14
41,2023-08-12T08:50:00+10:00,2023-08-12,08:50,13,4,17
41,2023-08-12T08:54:00+10:00,2023-08-12,08:54,5,6,11
54,2023-08-12T08:42:00+10:00,2023-08-12,08:42,1,0,1
54,2023-08-12T08:45:00+10:00,2023-08-12,08:45,0,5,5
54,2023-08-12T08:50:00+10:00,2023-08-12,08:50,1,0,1
54,2023-08-12T08:52:00+10:00,2023-08-12,08:52,1,0,1
55,2023-08-12T08:43:00+10:00,2023-08-12,08:43,2,8,10
55,2023-08-12T08:45:00+10:00,2023-08-12,08:45,2,2,4
55,2023-08-12T08:46:00+10:00,2023-08-12,08:46,4,8,12
55,2023-08-12T08:51:00+10:00,2023-08-12,08:51,5,9,14
55,2023-08-12T08:53:00+10:00,2023-08-12,08:53,8,7,15
55,2023-08-12T08:54:00+10:00,2023-08-12,08:54,3,10,13
59,2023-08-12T08:40:00+10:00,2023-08-12,08:40,14,4,18
59,2023-08-12T08:45:00+10:00,2023-08-12,08:45,17,26,43
61,2023-08-12T08:41:00+10:00,2023-08-12,08:41,1,2,3
61,2023-08-12T08:45:00+10:00,2023-08-12,08:45,1,0,1
61,2023-08-12T08:46:00+10:00,2023-08-12,08:46,1,1,2
61,2023-08-12T08:48:00+10:00,2023-08-12,08:48,3,0,3
61,2023-08-12T08:54:00+10:00,2023-08-12,08:54,2,2,4
65,2023-08-12T08:48:00+10:00,2023-08-12,08:48,0,2,2
65,2023-08-12T08:51:00+10:00,2023-08-12,08:51,3,2,5
65,2023-08-12T08:53:00+10:00,2023-08-12,08:53,1,2,3
66,2023-08-12T08:41:00+10:00,2023-08-12,08:41,1,2,3
66,2023-08-12T08:46:00+10:00,2023-08-12,08:46,1,2,3
66,2023-08-12T08:47:00+10:00,2023-08-12,08:47,0,3,3
66,2023-08-12T08:48:00+10:00,2023-08-12,08:48,4,7,11
66,2023-08-12T08:51:00+10:00,2023-08-12,08:51,2,0,2
66,2023-08-12T08:52:00+10:00,2023-08-12,08:52,1,6,7
69,2023-08-12T08:40:00+10:00,2023-08-12,08:40,1,1,2
69,2023-08-12T08:42:00+10:00,2023-08-12,08:42,1,5,6
69,2023-08-12T08:43:00+10:00,2023-08-12,08:43,3,0,3
69,2023-08-12T08:44:00+10:00,2023-08-12,08:44,2,0,2
69,2023-08-12T08:48:00+10:00,2023-08-12,08:48,2,0,2
69,2023-08-12T08:49:00+10:00,2023-08-12,08:49,10,3,13
69,2023-08-12T08:50:00+10:00,2023-08-12,08:50,4,0,4
69,2023-08-12T08:53:00+10:00,2023-08-12,08:53,1,0,1
75,2023-08-12T08:40:00+10:00,2023-08-12,08:40,0,1,1
75,2023-08-12T08:50:00+10:00,2023-08-12,08:50,1,1,2
77,2023-08-12T08:40:00+10:00,2023-08-12,08:40,0,1,1
77,2023-08-12T08:44:00+10:00,2023-08-12,08:44,1,1,2
77,2023-08-12T08:45:00+10:00,2023-08-12,08:45,2,3,5
77,2023-08-12T08:46:00+10:00,2023-08-12,08:46,1,0,1
77,2023-08-12T08:50:00+10:00,2023-08-12,08:50,3,1,4
77,2023-08-12T08:51:00+10:00,2023-08-12,08:51,1,0,1
78,2023-08-12T08:41:00+10:00,2023-08-12,08:41,0,2,2
78,2023-08-12T08:47:00+10:00,2023-08-12,08:47,2,2,4
84,2023-08-12T08:45:00+10:00,2023-08-12,08:45,34,34,68
84,2023-08-12T08:50:00+10:00,2023-08-12,08:50,37,26,63
87,2023-08-12T08:45:00+10:00,2023-08-12,08:45,0,1,1
87,2023-08-12T08:46:00+10:00,2023-08-12,08:46,2,3,5
87,2023-08-12T08:50:00+10:00,2023-08-12,08:50,1,0,1
87,2023-08-12T08:54:00+10:00,2023-08-12,08:54,1,1,2
107,2023-08-12T08:45:00+10:00,2023-08-12,08:45,3,4,7
108,2023-08-12T08:42:00+10:00,2023-08-12,08:42,2,2,4
108,2023-08-12T08:46:00+10:00,2023-08-12,08:46,1,3,4
118,2023-08-12T08:50:00+10:00,2023-08-12,08:50,0,1,1
1,2023-08-12T08:51:00+10:00,2023-08-12,08:51,0,7,7
2,2023-08-12T08:41:00+10:00,2023-08-12,08:41,1,1,2
2,2023-08-12T08:42:00+10:00,2023-08-12,08:42,0,4,4
2,2023-08-12T08:43:00+10:00,2023-08-12,08:43,2,0,2
2,2023-08-12T08:44:00+10:00,2023-08-12,08:44,0,1,1
2,2023-08-12T08:45:00+10:00,2023-08-12,08:45,2,2,4
2,2023-08-12T08:46:00+10:00,2023-08-12,08:46,2,3,5
2,2023-08-12T08:48:00+10:00,2023-08-12,08:48,0,4,4
7,2023-08-12T08:50:00+10:00,2023-08-12,08:50,0,1,1
7,2023-08-12T08:53:00+10:00,2023-08-12,08:53,4,3,7
9,2023-08-12T08:41:00+10:00,2023-08-12,08:41,0,1,1
9,2023-08-12T08:46:00+10:00,2023-08-12,08:46,0,4,4
9,2023-08-12T08:49:00+10:00,2023-08-12,08:49,0,1,1
9,2023-08-12T08:54:00+10:00,2023-08-12,08:54,0,6,6
10,2023-08-12T08:41:00+10:00,2023-08-12,08:41,0,2,2
10,2023-08-12T08:43:00+10:00,2023-08-12,08:43,0,1,1
10,2023-08-12T08:47:00+10:00,2023-08-12,08:47,1,1,2
10,2023-08-12T08:48:00+10:00,2023-08-12,08:48,3,0,3
10,2023-08-12T08:51:00+10:00,2023-08-12,08:51,0,1,1
11,2023-08-12T08:40:00+10:00,2023-08-12,08:40,5,1,6
11,2023-08-12T08:44:00+10:00,2023-08-12,08:44,1,0,1
11,2023-08-12T08:45:00+10:00,2023-08-12,08:45,3,0,3
11,2023-08-12T08:48:00+10:00,2023-08-12,08:48,0,2,2
12,2023-08-12T08:40:00+10:00,2023-08-12,08:40,7,0,7
12,2023-08-12T08:42:00+10:00,2023-08-12,08:42,3,0,3
12,2023-08-12T08:44:00+10:00,2023-08-12,08:44,1,3,4
12,2023-08-12T08:46:00+10:00,2023-08-12,08:46,1,0,1
12,2023-08-12T08:47:00+10:00,2023-08-12,08:47,1,0,1
12,2023-08-12T08:50:00+10:00,2023-08-12,08:50,0,1,1
12,2023-08-12T08:52:00+10:00,2023-08-12,08:52,0,2,2
17,2023-08-12T08:44:00+10:00,2023-08-12,08:44,2,2,4
17,2023-08-12T08:48:00+10:00,2023-08-12,08:48,5,0,5
24,2023-08-12T08:42:00+10:00,2023-08-12,08:42,13,0,13
24,2023-08-12T08:47:00+10:00,2023-08-12,08:47,3,7,10
27,2023-08-12T08:42:00+10:00,2023-08-12,08:42,3,5,8
27,2023-08-12T08:43:00+10:00,2023-08-12,08:43,0,3,3
27,2023-08-12T08:44:00+10:00,2023-08-12,08:44,2,0,2
27,2023-08-12T08:47:00+10:00,2023-08-12,08:47,2,1,3
35,2023-08-12T08:45:00+10:00,2023-08-12,08:45,8,7,15
35,2023-08-12T08:47:00+10:00,2023-08-12,08:47,8,3,11
35,2023-08-12T08:48:00+10:00,2023-08-12,08:48,2,4,6
35,2023-08-12T08:51:00+10:00,2023-08-12,08:51,3,9,12
35,2023-08-12T08:53:00+10:00,2023-08-12,08:53,4,3,7
53,2023-08-12T08:45:00+10:00,2023-08-12,08:45,1,4,5
53,2023-08-12T08:50:00+10:00,2023-08-12,08:50,1,2,3
53,2023-08-12T08:52:00+10:00,2023-08-12,08:52,1,4,5
53,2023-08-12T08:53:00+10:00,2023-08-12,08:53,2,6,8
56,2023-08-12T08:40:00+10:00,2023-08-12,08:40,1,0,1
56,2023-08-12T08:42:00+10:00,2023-08-12,08:42,3,1,4
56,2023-08-12T08:43:00+10:00,2023-08-12,08:43,0,1,1
56,2023-08-12T08:44:00+10:00,2023-08-12,08:44,4,1,5
56,2023-08-12T08:48:00+10:00,2023-08-12,08:48,6,0,6
57,2023-08-12T08:48:00+10:00,2023-08-12,08:48,4,0,4
57,2023-08-12T08:51:00+10:00,2023-08-12,08:51,0,1,1
57,2023-08-12T08:52:00+10:00,2023-08-12,08:52,0,1,1
58,2023-08-12T08:43:00+10:00,2023-08-12,08:43,3,2,5
58,2023-08-12T08:51:00+10:00,2023-08-12,08:51,6,3,9
62,2023-08-12T08:41:00+10:00,2023-08-12,08:41,1,1,2
62,2023-08-12T08:43:00+10:00,2023-08-12,08:43,2,1,3
62,2023-08-12T08:45:00+10:00,2023-08-12,08:45,1,2,3
62,2023-08-12T08:50:00+10:00,2023-08-12,08:50,0,2,2
63,2023-08-12T08:46:00+10:00,2023-08-12,08:46,6,3,9
63,2023-08-12T08:50:00+10:00,2023-08-12,08:50,0,3,3
63,2023-08-12T08:52:00+10:00,2023-08-12,08:52,1,3,4
63,2023-08-12T08:54:00+10:00,2023-08-12,08:54,0,1,1
67,2023-08-12T08:40:00+10:00,2023-08-12,08:40,2,1,3
67,2023-08-12T08:43:00+10:00,2023-08-12,08:43,2,2,4
68,2023-08-12T08:43:00+10:00,2023-08-12,08:43,2,1,3
68,2023-08-12T08:49:00+10:00,2023-08-12,08:49,2,3,5
68,2023-08-12T08:53:00+10:00,2023-08-12,08:53,3,0,3
72,2023-08-12T08:47:00+10:00,2023-08-12,08:47,2,0,2
72,2023-08-12T08:50:00+10:00,2023-08-12,08:50,5,0,5
72,2023-08-12T08:54:00+10:00,2023-08-12,08:54,3,2,5
76,2023-08-12T08:43:00+10:00,2023-08-12,08:43,1,0,1
76,2023-08-12T08:50:00+10:00,2023-08-12,08:50,1,0,1
76,2023-08-12T08:51:00+10:00,2023-08-12,08:51,2,0,2
79,2023-08-12T08:41:00+10:00,2023-08-12,08:41,1,1,2
79,2023-08-12T08:43:00+10:00,2023-08-12,08:43,3,2,5
79,2023-08-12T08:44:00+10:00,2023-08-12,08:44,1,0,1
79,2023-08-12T08:48:00+10:00,2023-08-12,08:48,13,2,15
79,2023-08-12T08:49:00+10:00,2023-08-12,08:49,3,0,3
79,2023-08-12T08:52:00+10:00,2023-08-12,08:52,4,0,4
79,2023-08-12T08:53:00+10:00,2023-08-12,08:53,0,2,2
85,2023-08-12T08:40:00+10:00,2023-08-12,08:40,1,0,1
85,2023-08-12T08:42:00+10:00,2023-08-12,08:42,4,2,6
85,2023-08-12T08:46:00+10:00,2023-08-12,08:46,0,2,2
85,2023-08-12T08:49:00+10:00,2023-08-12,08:49,5,0,5
86,2023-08-12T08:46:00+10:00,2023-08-12,08:46,0,1,1
86,2023-08-12T08:47:00+10:00,2023-08-12,08:47,1,0,1
86,2023-08-12T08:54:00+10:00,2023-08-12,08:54,1,0,1
117,2023-08-12T08:40:00+10:00,2023-08-12,08:40,3,1,4
117,2023-08-12T08:50:00+10:00,2023-08-12,08:50,2,9,11
122,2023-08-12T08:45:00+10:00,2023-08-12,08:45,0,1,1
122,2023-08-12T08:54:00+10:00,2023-08-12,08:54,0,1,1
3,2023-08-12T08:56:00+10:00,2023-08-12,08:56,1,8,9
3,2023-08-12T09:01:00+10:00,2023-08-12,09:01,2,3,5
3,2023-08-12T09:02:00+10:00,2023-08-12,09:02,1,3,4
3,2023-08-12T09:03:00+10:00,2023-08-12,09:03,5,3,8
3,2023-08-12T09:04:00+10:00,2023-08-12,09:04,3,5,8
4,2023-08-12T08:56:00+10:00,2023-08-12,08:56,2,5,7
4,2023-08-12T08:57:00+10:00,2023-08-12,08:57,8,2,10
4,2023-08-12T09:01:00+10:00,2023-08-12,09:01,5,3,8
4,2023-08-12T09:09:00+10:00,2023-08-12,09:09,5,1,6
6,2023-08-12T08:56:00+10:00,2023-08-12,08:56,4,4,8
6,2023-08-12T08:57:00+10:00,2023-08-12,08:57,4,7,11
6,2023-08-12T09:04:00+10:00,2023-08-12,09:04,3,3,6
6,2023-08-12T09:05:00+10:00,2023-08-12,09:05,8,1,9
6,2023-08-12T09:07:00+10:00,2023-08-12,09:07,5,8,13
8,2023-08-12T09:05:00+10:00,2023-08-12,09:05,0,2,2
8,2023-08-12T09:06:00+10:00,2023-08-12,09:06,0,1,1
14,2023-08-12T08:56:00+10:00,2023-08-12,08:56,0,2,2
14,2023-08-12T08:57:00+10:00,2023-08-12,08:57,0,1,1
14,2023-08-12T09:03:00+10:00,2023-08-12,09:03,2,2,4
14,2023-08-12T09:04:00+10:00,2023-08-12,09:04,0,1,1
14,2023-08-12T09:07:00+10:00,2023-08-12,09:07,2,1,3
14,2023-08-12T09:08:00+10:00,2023-08-12,09:08,1,0,1
21,2023-08-12T09:08:00+10:00,2023-08-12,09:08,3,0,3
28,2023-08-12T08:58:00+10:00,2023-08-12,08:58,1,1,2
28,2023-08-12T09:00:00+10:00,2023-08-12,09:00,5,3,8
28,2023-08-12T09:09:00+10:00,2023-08-12,09:09,1,2,3
29,2023-08-12T09:00:00+10:00,2023-08-12,09:00,2,1,3
29,2023-08-12T09:02:00+10:00,2023-08-12,09:02,2,4,6
29,2023-08-12T09:04:00+10:00,2023-08-12,09:04,5,1,6
29,2023-08-12T09:08:00+10:00,2023-08-12,09:08,1,5,6
39,2023-08-12T08:56:00+10:00,2023-08-12,08:56,5,1,6
39,2023-08-12T08:57:00+10:00,2023-08-12,08:57,1,0,1
39,2023-08-12T08:58:00+10:00,2023-08-12,08:58,1,0,1
39,2023-08-12T09:03:00+10:00,2023-08-12,09:03,0,1,1
39,2023-08-12T09:05:00+10:00,2023-08-12,09:05,0,1,1
41,2023-08-12T09:00:00+10:00,2023-08-12,09:00,8,3,11
41,2023-08-12T09:02:00+10:00,2023-08-12,09:02,9,8,17
41,2023-08-12T09:03:00+10:00,2023-08-12,09:03,6,8,14
41,2023-08-12T09:05:00+10:00,2023-08-12,09:05,0,3,3
54,2023-08-12T08:56:00+10:00,2023-08-12,08:56,1,2,3
54,2023-08-12T09:04:00+10:00,2023-08-12,09:04,3,0,3
54,2023-08-12T09:08:00+10:00,2023-08-12,09:08,0,1,1
55,2023-08-12T08:55:00+10:00,2023-08-12,08:55,4,5,9
55,2023-08-12T08:56:00+10:00,2023-08-12,08:56,6,4,10
55,2023-08-12T08:57:00+10:00,2023-08-12,08:57,5,3,8
55,2023-08-12T09:02:00+10:00,2023-08-12,09:02,2,4,6
55,2023-08-12T09:05:00+10:00,2023-08-12,09:05,7,9,16
59,2023-08-12T08:55:00+10:00,2023-08-12,08:55,13,20,33
61,2023-08-12T08:55:00+10:00,2023-08-12,08:55,1,2,3
61,2023-08-12T08:57:00+10:00,2023-08-12,08:57,1,2,3
61,2023-08-12T08:58:00+10:00,2023-08-12,08:58,0,1,1
61,2023-08-12T09:06:00+10:00,2023-08-12,09:06,0,3,3
61,2023-08-12T09:07:00+10:00,2023-08-12,09:07,3,3,6
65,2023-08-12T08:56:00+10:00,2023-08-12,08:56,2,0,2
65,2023-08-12T08:57:00+10:00,2023-08-12,08:57,4,6,10
65,2023-08-12T08:59:00+10:00,2023-08-12,08:59,0,3,3
65,2023-08-12T09:00:00+10:00,2023-08-12,09:00,3,4,7
65,2023-08-12T09:06:00+10:00,2023-08-12,09:06,3,5,8
65,2023-08-12T09:07:00+10:00,2023-08-12,09:07,2,2,4
65,2023-08-12T09:08:00+10:00,2023-08-12,09:08,0,1,1
66,2023-08-12T08:59:00+10:00,2023-08-12,08:59,1,0,1
66,2023-08-12T09:01:00+10:00,2023-08-12,09:01,0,2,2
66,2023-08-12T09:09:00+10:00,2023-08-12,09:09,4,5,9
69,2023-08-12T08:58:00+10:00,2023-08-12,08:58,3,0,3
69,2023-08-12T09:02:00+10:00,2023-08-12,09:02,2,0,2
69,2023-08-12T09:03:00+10:00,2023-08-12,09:03,2,3,5
69,2023-08-12T09:04:00+10:00,2023-08-12,09:04,2,2,4
69,2023-08-12T09:05:00+10:00,2023-08-12,09:05,3,2,5
69,2023-08-12T09:06:00+10:00,2023-08-12,09:06,0,2,2
69,2023-08-12T09:08:00+10:00,2023-08-12,09:08,3,0,3
70,2023-08-12T08:57:00+10:00,2023-08-12,08:57,1,0,1
70,2023-08-12T09:07:00+10:00,2023-08-12,09:07,0,1,1
70,2023-08-12T09:08:00+10:00,2023-08-12,09:08,2,2,4
71,2023-08-12T08:58:00+10:00,2023-08-12,08:58,1,1,2
71,2023-08-12T09:07:00+10:00,2023-08-12,09:07,0,1,1
75,2023-08-12T08:55:00+10:00,2023-08-12,08:55,1,0,1
75,2023-08-12T08:57:00+10:00,2023-08-12,08:57,0,1,1
75,2023-08-12T08:58:00+10:00,2023-08-12,08:58,2,0,2
75,2023-08-12T09:06:00+10:00,2023-08-12,09:06,0,1,1
75,2023-08-12T09:07:00+10:00,2023-08-12,09:07,0,1,1
77,2023-08-12T08:57:00+10:00,2023-08-12,08:57,1,3,4
78,2023-08-12T08:57:00+10:00,2023-08-12,08:57,0,1,1
78,2023-08-12T09:08:00+10:00,2023-08-12,09:08,5,0,5
84,2023-08-12T08:55:00+10:00,2023-08-12,08:55,48,15,63
84,2023-08-12T09:05:00+10:00,2023-08-12,09:05,55,19,74
87,2023-08-12T08:59:00+10:00,2023-08-12,08:59,0,1,1
87,2023-08-12T09:02:00+10:00,2023-08-12,09:02,3,2,5
107,2023-08-12T08:55:00+10:00,2023-08-12,08:55,11,7,18
107,2023-08-12T09:00:00+10:00,2023-08-12,09:00,2,11,13
108,2023-08-12T08:55:00+10:00,2023-08-12,08:55,2,4,6
108,2023-08-12T08:59:00+10:00,2023-08-12,08:59,1,5,6
108,2023-08-12T09:01:00+10:00,2023-08-12,09:01,1,2,3
108,2023-08-12T09:03:00+10:00,2023-08-12,09:03,3,4,7
108,2023-08-12T09:05:00+10:00,2023-08-12,09:05,1,4,5
118,2023-08-12T08:55:00+10:00,2023-08-12,08:55,1,0,1
1,2023-08-12T08:55:00+10:00,2023-08-12,08:55,1,2,3
1,2023-08-12T08:57:00+10:00,2023-08-12,08:57,3,6,9
1,2023-08-12T09:01:00+10:00,2023-08-12,09:01,1,8,9
2,2023-08-12T08:56:00+10:00,2023-08-12,08:56,1,1,2
2,2023-08-12T08:58:00+10:00,2023-08-12,08:58,3,1,4
2,2023-08-12T09:01:00+10:00,2023-08-12,09:01,0,2,2
2,2023-08-12T09:05:00+10:00,2023-08-12,09:05,4,2,6
2,2023-08-12T09:06:00+10:00,2023-08-12,09:06,0,2,2
2,2023-08-12T09:09:00+10:00,2023-08-12,09:09,0,4,4
7,2023-08-12T08:57:00+10:00,2023-08-12,08:57,0,2,2
7,2023-08-12T08:58:00+10:00,2023-08-12,08:58,0,2,2
7,2023-08-12T09:03:00+10:00,2023-08-12,09:03,1,0,1
7,2023-08-12T09:08:00+10:00,2023-08-12,09:08,2,1,3
9,2023-08-12T08:55:00+10:00,2023-08-12,08:55,1,1,2
9,2023-08-12T08:56:00+10:00,2023-08-12,08:56,2,4,6
9,2023-08-12T08:58:00+10:00,2023-08-12,08:58,0,2,2
9,2023-08-12T09:00:00+10:00,2023-08-12,09:00,0,9,9
10,2023-08-12T08:56:00+10:00,2023-08-12,08:56,0,1,1
10,2023-08-12T08:57:00+10:00,2023-08-12,08:57,2,0,2
10,2023-08-12T09:00:00+10:00,2023-08-12,09:00,2,0,2
10,2023-08-12T09:06:00+10:00,2023-08-12,09:06,1,1,2
11,2023-08-12T09:02:00+10:00,2023-08-12,09:02,0,1,1
11,2023-08-12T09:06:00+10:00,2023-08-12,09:06,1,1,2
12,2023-08-12T08:57:00+10:00,2023-08-12,08:57,3,0,3
12,2023-08-12T09:00:00+10:00,2023-08-12,09:00,4,2,6
12,2023-08-12T09:01:00+10:00,2023-08-12,09:01,5,2,7
12,2023-08-12T09:05:00+10:00,2023-08-12,09:05,2,0,2
12,2023-08-12T09:07:00+10:00,2023-08-12,09:07,2,1,3
17,2023-08-12T08:56:00+10:00,2023-08-12,08:56,1,7,8
17,2023-08-12T09:00:00+10:00,2023-08-12,09:00,2,0,2
17,2023-08-12T09:01:00+10:00,2023-08-12,09:01,1,2,3
17,2023-08-12T09:03:00+10:00,2023-08-12,09:03,3,2,5
17,2023-08-12T09:06:00+10:00,2023-08-12,09:06,1,0,1
17,2023-08-12T09:08:00+10:00,2023-08-12,09:08,3,2,5
24,2023-08-12T08:56:00+10:00,2023-08-12,08:56,3,2,5
24,2023-08-12T08:57:00+10:00,2023-08-12,08:57,9,2,11
24,2023-08-12T09:04:00+10:00,2023-08-12,09:04,9,7,16
24,2023-08-12T09:06:00+10:00,2023-08-12,09:06,3,2,5
27,2023-08-12T09:01:00+10:00,2023-08-12,09:01,0,1,1
27,2023-08-12T09:02:00+10:00,2023-08-12,09:02,0,3,3
27,2023-08-12T09:03:00+10:00,2023-08-12,09:03,0,1,1
27,2023-08-12T09:05:00+10:00,2023-08-12,09:05,1,0,1
35,2023-08-12T08:55:00+10:00,2023-08-12,08:55,5,2,7
35,2023-08-12T08:56:00+10:00,2023-08-12,08:56,5,2,7
35,2023-08-12T08:57:00+10:00,2023-08-12,08:57,13,1,14
53,2023-08-12T09:02:00+10:00,2023-08-12,09:02,3,2,5
53,2023-08-12T09:04:00+10:00,2023-08-12,09:04,2,2,4
53,2023-08-12T09:05:00+10:00,2023-08-12,09:05,1,9,10
53,2023-08-12T09:06:00+10:00,2023-08-12,09:06,3,0,3
53,2023-08-12T09:08:00+10:00,2023-08-12,09:08,12,0,12
56,2023-08-12T08:55:00+10:00,2023-08-12,08:55,0,1,1
56,2023-08-12T08:57:00+10:00,2023-08-12,08:57,6,2,8
56,2023-08-12T09:00:00+10:00,2023-08-12,09:00,1,0,1
56,2023-08-12T09:01:00+10:00,2023-08-12,09:01,3,1,4
56,2023-08-12T09:06:00+10:00,2023-08-12,09:06,0,2,2
56,2023-08-12T09:07:00+10:00,2023-08-12,09:07,0,1,1
57,2023-08-12T08:55:00+10:00,2023-08-12,08:55,2,3,5
58,2023-08-12T09:00:00+10:00,2023-08-12,09:00,7,3,10
58,2023-08-12T09:03:00+10:00,2023-08-12,09:03,2,0,2
58,2023-08-12T09:06:00+10:00,2023-08-12,09:06,2,1,3
58,2023-08-12T09:08:00+10:00,2023-08-12,09:08,6,3,9
62,2023-08-12T08:55:00+10:00,2023-08-12,08:55,3,1,4
62,2023-08-12T09:00:00+10:00,2023-08-12,09:00,0,1,1
62,2023-08-12T09:05:00+10:00,2023-08-12,09:05,3,1,4
62,2023-08-12T09:07:00+10:00,2023-08-12,09:07,0,1,1
62,2023-08-12T09:09:00+10:00,2023-08-12,09:09,1,1,2
63,2023-08-12T08:59:00+10:00,2023-08-12,08:59,1,2,3
63,2023-08-12T09:02:00+10:00,2023-08-12,09:02,0,2,2
63,2023-08-12T09:04:00+10:00,2023-08-12,09:04,7,2,9
63,2023-08-12T09:09:00+10:00,2023-08-12,09:09,0,1,1
67,2023-08-12T08:58:00+10:00,2023-08-12,08:58,4,6,10
67,2023-08-12T09:00:00+10:00,2023-08-12,09:00,5,2,7
67,2023-08-12T09:03:00+10:00,2023-08-12,09:03,4,5,9
67,2023-08-12T09:04:00+10:00,2023-08-12,09:04,0,11,11
67,2023-08-12T09:08:00+10:00,2023-08-12,09:08,1,2,3
68,2023-08-12T08:56:00+10:00,2023-08-12,08:56,3,1,4
68,2023-08-12T09:01:00+10:00,2023-08-12,09:01,1,0,1
68,2023-08-12T09:02:00+10:00,2023-08-12,09:02,0,2,2
72,2023-08-12T08:55:00+10:00,2023-08-12,08:55,3,0,3
72,2023-08-12T08:58:00+10:00,2023-08-12,08:58,2,1,3
72,2023-08-12T08:59:00+10:00,2023-08-12,08:59,1,0,1
72,2023-08-12T09:01:00+10:00,2023-08-12,09:01,3,0,3
72,2023-08-12T09:03:00+10:00,2023-08-12,09:03,3,0,3
72,2023-08-12T09:05:00+10:00,2023-08-12,09:05,6,3,9
72,2023-08-12T09:06:00+10:00,2023-08-12,09:06,3,1,4
72,2023-08-12T09:08:00+10:00,2023-08-12,09:08,0,7,7
72,2023-08-12T09:09:00+10:00,2023-08-12,09:09,10,0,10
76,2023-08-12T08:57:00+10:00,2023-08-12,08:57,2,1,3
76,2023-08-12T09:01:00+10:00,2023-08-12,09:01,5,0,5
79,2023-08-12T08:55:00+10:00,2023-08-12,08:55,4,5,9
79,2023-08-12T08:56:00+10:00,2023-08-12,08:56,6,3,9
79,2023-08-12T08:57:00+10:00,2023-08-12,08:57,7,7,14
79,2023-08-12T08:58:00+10:00,2023-08-12,08:58,2,0,2
79,2023-08-12T08:59:00+10:00,2023-08-12,08:59,6,2,8
79,2023-08-12T09:02:00+10:00,2023-08-12,09:02,1,3,4
79,2023-08-12T09:03:00+10:00,2023-08-12,09:03,4,3,7
79,2023-08-12T09:06:00+10:00,2023-08-12,09:06,1,6,7
79,2023-08-12T09:08:00+10:00,2023-08-12,09:08,6,4,10
79,2023-08-12T09:09:00+10:00,2023-08-12,09:09,0,1,1
85,2023-08-12T08:58:00+10:00,2023-08-12,08:58,2,0,2
85,2023-08-12T09:02:00+10:00,2023-08-12,09:02,2,0,2
85,2023-08-12T09:03:00+10:00,2023-08-12,09:03,0,2,2
85,2023-08-12T09:05:00+10:00,2023-08-12,09:05,2,0,2
85,2023-08-12T09:08:00+10:00,2023-08-12,09:08,2,0,2
86,2023-08-12T09:05:00+10:00,2023-08-12,09:05,0,1,1
86,2023-08-12T09:06:00+10:00,2023-08-12,09:06,0,2,2
109,2023-08-12T08:55:00+10:00,2023-08-12,08:55,7,12,19
109,2023-08-12T09:05:00+10:00,2023-08-12,09:05,6,15,21
117,2023-08-12T08:55:00+10:00,2023-08-12,08:55,1,8,9
117,2023-08-12T09:05:00+10:00,2023-08-12,09:05,2,6,8
122,2023-08-12T08:55:00+10:00,2023-08-12,08:55,1,0,1
122,2023-08-12T08:57:00+10:00,2023-08-12,08:57,1,0,1
122,2023-08-12T09:02:00+10:00,2023-08-12,09:02,1,0,1
3,2023-08-11T23:57:00+10:00,2023-08-11,23:57,10,14,24
3,2023-08-12T00:01:00+10:00,2023-08-12,00:01,4,19,23
3,2023-08-12T00:03:00+10:00,2023-08-12,00:03,13,0,13
3,2023-08-12T00:04:00+10:00,2023-08-12,00:04,8,5,13
3,2023-08-12T00:05:00+10:00,2023-08-12,00:05,5,9,14
3,2023-08-12T00:06:00+10:00,2023-08-12,00:06,13,13,26
3,2023-08-12T00:09:00+10:00,2023-08-12,00:09,3,6,9
4,2023-08-12T00:02:00+10:00,2023-08-12,00:02,7,12,19
4,2023-08-12T00:07:00+10:00,2023-08-12,00:07,3,12,15
4,2023-08-12T00:09:00+10:00,2023-08-12,00:09,8,23,31
6,2023-08-11T23:57:00+10:00,2023-08-11,23:57,2,1,3
6,2023-08-12T00:02:00+10:00,2023-08-12,00:02,6,4,10
6,2023-08-12T00:04:00+10:00,2023-08-12,00:04,6,7,13
6,2023-08-12T00:05:00+10:00,2023-08-12,00:05,5,2,7
6,2023-08-12T00:06:00+10:00,2023-08-12,00:06,5,6,11
8,2023-08-12T00:08:00+10:00,2023-08-12,00:08,0,2,2
14,2023-08-11T23:55:00+10:00,2023-08-11,23:55,2,0,2
14,2023-08-11T23:59:00+10:00,2023-08-11,23:59,4,0,4
14,2023-08-12T00:04:00+10:00,2023-08-12,00:04,0,1,1
21,2023-08-11T23:57:00+10:00,2023-08-11,23:57,13,3,16
21,2023-08-12T00:08:00+10:00,2023-08-12,00:08,0,1,1
28,2023-08-11T23:55:00+10:00,2023-08-11,23:55,1,5,6
28,2023-08-11T23:56:00+10:00,2023-08-11,23:56,4,2,6
28,2023-08-11T23:59:00+10:00,2023-08-11,23:59,2,1,3
28,2023-08-12T00:01:00+10:00,2023-08-12,00:01,2,0,2
28,2023-08-12T00:08:00+10:00,2023-08-12,00:08,2,2,4
29,2023-08-11T23:56:00+10:00,2023-08-11,23:56,0,1,1
29,2023-08-12T00:03:00+10:00,2023-08-12,00:03,0,2,2
29,2023-08-12T00:04:00+10:00,2023-08-12,00:04,1,0,1
39,2023-08-12T00:04:00+10:00,2023-08-12,00:04,1,0,1
41,2023-08-11T23:55:00+10:00,2023-08-11,23:55,8,17,25
41,2023-08-11T23:56:00+10:00,2023-08-11,23:56,7,15,22
41,2023-08-11T23:57:00+10:00,2023-08-11,23:57,6,13,19
41,2023-08-11T23:59:00+10:00,2023-08-11,23:59,8,5,13
41,2023-08-12T00:00:00+10:00,2023-08-12,00:00,7,9,16
41,2023-08-12T00:02:00+10:00,2023-08-12,00:02,15,23,38
41,2023-08-12T00:04:00+10:00,2023-08-12,00:04,8,13,21
41,2023-08-12T00:07:00+10:00,2023-08-12,00:07,12,15,27
41,2023-08-12T00:08:00+10:00,2023-08-12,00:08,2,8,10
41,2023-08-12T00:09:00+10:00,2023-08-12,00:09,5,7,12
54,2023-08-11T23:55:00+10:00,2023-08-11,23:55,1,0,1
54,2023-08-12T00:01:00+10:00,2023-08-12,00:01,1,0,1
54,2023-08-12T00:04:00+10:00,2023-08-12,00:04,0,1,1
54,2023-08-12T00:08:00+10:00,2023-08-12,00:08,3,0,3
55,2023-08-11T23:59:00+10:00,2023-08-11,23:59,9,3,12
55,2023-08-12T00:05:00+10:00,2023-08-12,00:05,2,6,8
55,2023-08-12T00:07:00+10:00,2023-08-12,00:07,7,3,10
59,2023-08-12T00:00:00+10:00,2023-08-12,00:00,19,12,31
61,2023-08-11T23:55:00+10:00,2023-08-11,23:55,0,10,10
61,2023-08-11T23:58:00+10:00,2023-08-11,23:58,1,0,1
61,2023-08-12T00:02:00+10:00,2023-08-12,00:02,1,6,7
61,2023-08-12T00:06:00+10:00,2023-08-12,00:06,1,1,2
65,2023-08-11T23:57:00+10:00,2023-08-11,23:57,3,10,13
65,2023-08-12T00:05:00+10:00,2023-08-12,00:05,1,2,3
65,2023-08-12T00:06:00+10:00,2023-08-12,00:06,1,4,5
66,2023-08-11T23:58:00+10:00,2023-08-11,23:58,4,2,6
66,2023-08-12T00:00:00+10:00,2023-08-12,00:00,3,3,6
66,2023-08-12T00:01:00+10:00,2023-08-12,00:01,3,5,8
66,2023-08-12T00:03:00+10:00,2023-08-12,00:03,3,8,11
66,2023-08-12T00:04:00+10:00,2023-08-12,00:04,3,9,12
66,2023-08-12T00:07:00+10:00,2023-08-12,00:07,14,13,27
69,2023-08-11T23:55:00+10:00,2023-08-11,23:55,0,3,3
69,2023-08-11T23:58:00+10:00,2023-08-11,23:58,1,1,2
69,2023-08-12T00:00:00+10:00,2023-08-12,00:00,2,0,2
70,2023-08-11T23:56:00+10:00,2023-08-11,23:56,2,0,2
70,2023-08-12T00:05:00+10:00,2023-08-12,00:05,0,2,2
77,2023-08-11T23:59:00+10:00,2023-08-11,23:59,5,0,5
77,2023-08-12T00:05:00+10:00,2023-08-12,00:05,2,0,2
84,2023-08-11T23:55:00+10:00,2023-08-11,23:55,34,44,78
84,2023-08-12T00:00:00+10:00,2023-08-12,00:00,24,30,54
107,2023-08-12T00:05:00+10:00,2023-08-12,00:05,2,3,5
108,2023-08-11T23:55:00+10:00,2023-08-11,23:55,5,0,5
108,2023-08-12T00:03:00+10:00,2023-08-12,00:03,5,1,6
108,2023-08-12T00:04:00+10:00,2023-08-12,00:04,0,6,6
108,2023-08-12T00:07:00+10:00,2023-08-12,00:07,4,0,4
108,2023-08-12T00:09:00+10:00,2023-08-12,00:09,0,1,1
118,2023-08-12T00:00:00+10:00,2023-08-12,00:00,0,2,2
1,2023-08-11T23:58:00+10:00,2023-08-11,23:58,3,1,4
1,2023-08-12T00:00:00+10:00,2023-08-12,00:00,1,1,2
1,2023-08-12T00:03:00+10:00,2023-08-12,00:03,1,4,5
1,2023-08-12T00:05:00+10:00,2023-08-12,00:05,0,2,2
1,2023-08-12T00:08:00+10:00,2023-08-12,00:08,5,0,5
1,2023-08-12T00:09:00+10:00,2023-08-12,00:09,5,0,5
2,2023-08-11T23:57:00+10:00,2023-08-11,23:57,0,4,4
2,2023-08-12T00:01:00+10:00,2023-08-12,00:01,2,0,2
2,2023-08-12T00:07:00+10:00,2023-08-12,00:07,0,2,2
7,2023-08-11T23:55:00+10:00,2023-08-11,23:55,0,9,9
7,2023-08-11T23:59:00+10:00,2023-08-11,23:59,0,3,3
7,2023-08-12T00:03:00+10:00,2023-08-12,00:03,0,3,3
7,2023-08-12T00:04:00+10:00,2023-08-12,00:04,0,7,7
7,2023-08-12T00:06:00+10:00,2023-08-12,00:06,0,1,1
7,2023-08-12T00:08:00+10:00,2023-08-12,00:08,0,3,3
9,2023-08-11T23:55:00+10:00,2023-08-11,23:55,0,3,3
9,2023-08-11T23:56:00+10:00,2023-08-11,23:56,0,4,4
9,2023-08-11T23:57:00+10:00,2023-08-11,23:57,0,2,2
9,2023-08-12T00:06:00+10:00,2023-08-12,00:06,0,2,2
10,2023-08-11T23:58:00+10:00,2023-08-11,23:58,0,2,2
11,2023-08-11T23:55:00+10:00,2023-08-11,23:55,0,5,5
11,2023-08-12T00:08:00+10:00,2023-08-12,00:08,3,0,3
12,2023-08-11T23:58:00+10:00,2023-08-11,23:58,0,2,2
12,2023-08-12T00:01:00+10:00,2023-08-12,00:01,0,4,4
12,2023-08-12T00:06:00+10:00,2023-08-12,00:06,0,2,2
17,2023-08-12T00:00:00+10:00,2023-08-12,00:00,2,0,2
17,2023-08-12T00:03:00+10:00,2023-08-12,00:03,2,1,3
17,2023-08-12T00:04:00+10:00,2023-08-12,00:04,0,2,2
18,2023-08-11T23:56:00+10:00,2023-08-11,23:56,0,1,1
24,2023-08-11T23:55:00+10:00,2023-08-11,23:55,4,1,5
24,2023-08-11T23:56:00+10:00,2023-08-11,23:56,6,14,20
24,2023-08-11T23:58:00+10:00,2023-08-11,23:58,6,1,7
24,2023-08-12T00:00:00+10:00,2023-08-12,00:00,9,1,10
24,2023-08-12T00:02:00+10:00,2023-08-12,00:02,3,4,7
24,2023-08-12T00:07:00+10:00,2023-08-12,00:07,4,1,5
24,2023-08-12T00:08:00+10:00,2023-08-12,00:08,3,3,6
24,2023-08-12T00:09:00+10:00,2023-08-12,00:09,6,4,10
27,2023-08-12T00:02:00+10:00,2023-08-12,00:02,3,0,3
35,2023-08-11T23:57:00+10:00,2023-08-11,23:57,4,11,15
35,2023-08-11T23:58:00+10:00,2023-08-11,23:58,10,10,20
35,2023-08-12T00:01:00+10:00,2023-08-12,00:01,0,15,15
35,2023-08-12T00:04:00+10:00,2023-08-12,00:04,8,22,30
35,2023-08-12T00:05:00+10:00,2023-08-12,00:05,5,3,8
35,2023-08-12T00:08:00+10:00,2023-08-12,00:08,3,4,7
53,2023-08-11T23:55:00+10:00,2023-08-11,23:55,0,1,1
53,2023-08-12T00:02:00+10:00,2023-08-12,00:02,2,0,2
53,2023-08-12T00:03:00+10:00,2023-08-12,00:03,2,8,10
53,2023-08-12T00:04:00+10:00,2023-08-12,00:04,0,2,2
53,2023-08-12T00:05:00+10:00,2023-08-12,00:05,0,5,5
53,2023-08-12T00:08:00+10:00,2023-08-12,00:08,1,3,4
56,2023-08-11T23:55:00+10:00,2023-08-11,23:55,0,4,4
56,2023-08-11T23:56:00+10:00,2023-08-11,23:56,2,0,2
56,2023-08-12T00:01:00+10:00,2023-08-12,00:01,4,0,4
56,2023-08-12T00:02:00+10:00,2023-08-12,00:02,0,1,1
56,2023-08-12T00:06:00+10:00,2023-08-12,00:06,7,1,8
56,2023-08-12T00:07:00+10:00,2023-08-12,00:07,3,2,5
58,2023-08-11T23:57:00+10:00,2023-08-11,23:57,4,1,5
58,2023-08-12T00:03:00+10:00,2023-08-12,00:03,1,1,2
62,2023-08-11T23:55:00+10:00,2023-08-11,23:55,2,0,2
62,2023-08-11T23:56:00+10:00,2023-08-11,23:56,2,1,3
62,2023-08-11T23:57:00+10:00,2023-08-11,23:57,1,2,3
62,2023-08-12T00:01:00+10:00,2023-08-12,00:01,0,3,3
62,2023-08-12T00:04:00+10:00,2023-08-12,00:04,6,0,6
62,2023-08-12T00:08:00+10:00,2023-08-12,00:08,2,1,3
63,2023-08-11T23:56:00+10:00,2023-08-11,23:56,1,8,9
63,2023-08-11T23:58:00+10:00,2023-08-11,23:58,3,8,11
63,2023-08-11T23:59:00+10:00,2023-08-11,23:59,7,7,14
63,2023-08-12T00:02:00+10:00,2023-08-12,00:02,0,10,10
63,2023-08-12T00:05:00+10:00,2023-08-12,00:05,6,12,18
63,2023-08-12T00:07:00+10:00,2023-08-12,00:07,4,3,7
67,2023-08-11T23:55:00+10:00,2023-08-11,23:55,0,2,2
67,2023-08-12T00:01:00+10:00,2023-08-12,00:01,1,3,4
67,2023-08-12T00:04:00+10:00,2023-08-12,00:04,0,2,2
67,2023-08-12T00:05:00+10:00,2023-08-12,00:05,0,4,4
67,2023-08-12T00:06:00+10:00,2023-08-12,00:06,1,4,5
67,2023-08-12T00:09:00+10:00,2023-08-12,00:09,0,5,5
68,2023-08-11T23:55:00+10:00,2023-08-11,23:55,4,0,4
68,2023-08-11T23:59:00+10:00,2023-08-11,23:59,1,0,1
68,2023-08-12T00:04:00+10:00,2023-08-12,00:04,1,0,1
72,2023-08-11T23:56:00+10:00,2023-08-11,23:56,0,1,1
72,2023-08-11T23:58:00+10:00,2023-08-11,23:58,0,3,3
72,2023-08-11T23:59:00+10:00,2023-08-11,23:59,0,2,2
72,2023-08-12T00:04:00+10:00,2023-08-12,00:04,0,1,1
72,2023-08-12T00:07:00+10:00,2023-08-12,00:07,0,4,4
72,2023-08-12T00:09:00+10:00,2023-08-12,00:09,2,1,3
79,2023-08-12T00:00:00+10:00,2023-08-12,00:00,6,3,9
79,2023-08-12T00:07:00+10:00,2023-08-12,00:07,3,8,11
86,2023-08-11T23:56:00+10:00,2023-08-11,23:56,0,1,1
86,2023-08-12T00:05:00+10:00,2023-08-12,00:05,1,0,1
109,2023-08-12T00:05:00+10:00,2023-08-12,00:05,3,0,3
117,2023-08-11T23:55:00+10:00,2023-08-11,23:55,6,4,10
117,2023-08-12T00:00:00+10:00,2023-08-12,00:00,11,10,21
122,2023-08-12T00:02:00+10:00,2023-08-12,00:02,1,0,1
122,2023-08-12T00:04:00+10:00,2023-08-12,00:04,1,4,5
3,2023-08-12T00:10:00+10:00,2023-08-12,00:10,12,5,17
3,2023-08-12T00:12:00+10:00,2023-08-12,00:12,3,9,12
3,2023-08-12T00:13:00+10:00,2023-08-12,00:13,12,2,14
3,2023-08-12T00:15:00+10:00,2023-08-12,00:15,26,7,33
3,2023-08-12T00:16:00+10:00,2023-08-12,00:16,9,8,17
3,2023-08-12T00:18:00+10:00,2023-08-12,00:18,4,11,15
3,2023-08-12T00:20:00+10:00,2023-08-12,00:20,11,7,18
3,2023-08-12T00:22:00+10:00,2023-08-12,00:22,20,1,21
4,2023-08-12T00:13:00+10:00,2023-08-12,00:13,6,11,17
4,2023-08-12T00:17:00+10:00,2023-08-12,00:17,3,18,21
4,2023-08-12T00:18:00+10:00,2023-08-12,00:18,10,3,13
4,2023-08-12T00:19:00+10:00,2023-08-12,00:19,1,10,11
4,2023-08-12T00:20:00+10:00,2023-08-12,00:20,14,7,21
4,2023-08-12T00:22:00+10:00,2023-08-12,00:22,10,1,11
4,2023-08-12T00:23:00+10:00,2023-08-12,00:23,4,5,9
6,2023-08-12T00:12:00+10:00,2023-08-12,00:12,3,12,15
6,2023-08-12T00:14:00+10:00,2023-08-12,00:14,14,2,16
6,2023-08-12T00:17:00+10:00,2023-08-12,00:17,10,0,10
6,2023-08-12T00:18:00+10:00,2023-08-12,00:18,4,3,7
6,2023-08-12T00:23:00+10:00,2023-08-12,00:23,7,3,10
6,2023-08-12T00:24:00+10:00,2023-08-12,00:24,7,3,10
8,2023-08-12T00:11:00+10:00,2023-08-12,00:11,0,2,2
8,2023-08-12T00:16:00+10:00,2023-08-12,00:16,1,0,1
14,2023-08-12T00:12:00+10:00,2023-08-12,00:12,3,0,3
14,2023-08-12T00:14:00+10:00,2023-08-12,00:14,3,0,3
14,2023-08-12T00:21:00+10:00,2023-08-12,00:21,4,0,4
21,2023-08-12T00:20:00+10:00,2023-08-12,00:20,4,8,12
28,2023-08-12T00:10:00+10:00,2023-08-12,00:10,2,3,5
28,2023-08-12T00:14:00+10:00,2023-08-12,00:14,1,0,1
28,2023-08-12T00:15:00+10:00,2023-08-12,00:15,3,1,4
28,2023-08-12T00:16:00+10:00,2023-08-12,00:16,1,0,1
28,2023-08-12T00:17:00+10:00,2023-08-12,00:17,2,2,4
28,2023-08-12T00:19:00+10:00,2023-08-12,00:19,1,0,1
28,2023-08-12T00:22:00+10:00,2023-08-12,00:22,1,0,1
29,2023-08-12T00:14:00+10:00,2023-08-12,00:14,4,4,8
29,2023-08-12T00:16:00+10:00,2023-08-12,00:16,0,2,2
29,2023-08-12T00:19:00+10:00,2023-08-12,00:19,3,0,3
29,2023-08-12T00:20:00+10:00,2023-08-12,00:20,0,2,2
29,2023-08-12T00:23:00+10:00,2023-08-12,00:23,0,1,1
41,2023-08-12T00:14:00+10:00,2023-08-12,00:14,4,14,18
41,2023-08-12T00:15:00+10:00,2023-08-12,00:15,5,12,17
41,2023-08-12T00:17:00+10:00,2023-08-12,00:17,11,13,24
41,2023-08-12T00:18:00+10:00,2023-08-12,00:18,12,13,25
41,2023-08-12T00:19:00+10:00,2023-08-12,00:19,5,12,17
41,2023-08-12T00:21:00+10:00,2023-08-12,00:21,11,6,17
54,2023-08-12T00:10:00+10:00,2023-08-12,00:10,1,0,1
54,2023-08-12T00:13:00+10:00,2023-08-12,00:13,1,3,4
54,2023-08-12T00:20:00+10:00,2023-08-12,00:20,1,0,1
54,2023-08-12T00:21:00+10:00,2023-08-12,00:21,0,2,2
54,2023-08-12T00:23:00+10:00,2023-08-12,00:23,0,3,3
55,2023-08-12T00:17:00+10:00,2023-08-12,00:17,3,1,4
55,2023-08-12T00:20:00+10:00,2023-08-12,00:20,6,7,13
55,2023-08-12T00:21:00+10:00,2023-08-12,00:21,6,3,9
55,2023-08-12T00:22:00+10:00,2023-08-12,00:22,3,4,7
59,2023-08-12T00:10:00+10:00,2023-08-12,00:10,14,3,17
61,2023-08-12T00:15:00+10:00,2023-08-12,00:15,2,0,2
61,2023-08-12T00:20:00+10:00,2023-08-12,00:20,5,0,5
61,2023-08-12T00:21:00+10:00,2023-08-12,00:21,0,2,2
61,2023-08-12T00:23:00+10:00,2023-08-12,00:23,3,0,3
65,2023-08-12T00:10:00+10:00,2023-08-12,00:10,0,4,4
65,2023-08-12T00:11:00+10:00,2023-08-12,00:11,3,1,4
65,2023-08-12T00:14:00+10:00,2023-08-12,00:14,0,2,2
65,2023-08-12T00:19:00+10:00,2023-08-12,00:19,5,2,7
65,2023-08-12T00:24:00+10:00,2023-08-12,00:24,0,3,3
66,2023-08-12T00:10:00+10:00,2023-08-12,00:10,8,3,11
66,2023-08-12T00:18:00+10:00,2023-08-12,00:18,6,6,12
66,2023-08-12T00:19:00+10:00,2023-08-12,00:19,1,2,3
66,2023-08-12T00:21:00+10:00,2023-08-12,00:21,6,1,7
70,2023-08-12T00:11:00+10:00,2023-08-12,00:11,1,0,1
75,2023-08-12T00:15:00+10:00,2023-08-12,00:15,0,2,2
75,2023-08-12T00:17:00+10:00,2023-08-12,00:17,0,1,1
77,2023-08-12T00:17:00+10:00,2023-08-12,00:17,3,1,4
77,2023-08-12T00:19:00+10:00,2023-08-12,00:19,0,4,4
77,2023-08-12T00:22:00+10:00,2023-08-12,00:22,0,3,3
84,2023-08-12T00:10:00+10:00,2023-08-12,00:10,25,24,49
84,2023-08-12T00:20:00+10:00,2023-08-12,00:20,17,21,38
107,2023-08-12T00:15:00+10:00,2023-08-12,00:15,0,1,1
108,2023-08-12T00:10:00+10:00,2023-08-12,00:10,2,2,4
108,2023-08-12T00:12:00+10:00,2023-08-12,00:12,0,4,4
108,2023-08-12T00:18:00+10:00,2023-08-12,00:18,3,0,3
108,2023-08-12T00:21:00+10:00,2023-08-12,00:21,2,0,2
1,2023-08-12T00:11:00+10:00,2023-08-12,00:11,3,2,5
1,2023-08-12T00:14:00+10:00,2023-08-12,00:14,2,0,2
1,2023-08-12T00:17:00+10:00,2023-08-12,00:17,3,2,5
1,2023-08-12T00:19:00+10:00,2023-08-12,00:19,1,1,2
1,2023-08-12T00:21:00+10:00,2023-08-12,00:21,3,4,7
1,2023-08-12T00:23:00+10:00,2023-08-12,00:23,2,0,2
2,2023-08-12T00:11:00+10:00,2023-08-12,00:11,0,3,3
2,2023-08-12T00:13:00+10:00,2023-08-12,00:13,0,4,4
2,2023-08-12T00:19:00+10:00,2023-08-12,00:19,0,1,1
2,2023-08-12T00:21:00+10:00,2023-08-12,00:21,4,4,8
7,2023-08-12T00:15:00+10:00,2023-08-12,00:15,0,1,1
7,2023-08-12T00:17:00+10:00,2023-08-12,00:17,0,3,3
7,2023-08-12T00:20:00+10:00,2023-08-12,00:20,0,4,4
7,2023-08-12T00:23:00+10:00,2023-08-12,00:23,2,2,4
9,2023-08-12T00:11:00+10:00,2023-08-12,00:11,0,4,4
9,2023-08-12T00:18:00+10:00,2023-08-12,00:18,0,1,1
9,2023-08-12T00:19:00+10:00,2023-08-12,00:19,1,0,1
10,2023-08-12T00:17:00+10:00,2023-08-12,00:17,0,1,1
10,2023-08-12T00:21:00+10:00,2023-08-12,00:21,0,1,1
11,2023-08-12T00:16:00+10:00,2023-08-12,00:16,3,0,3
11,2023-08-12T00:20:00+10:00,2023-08-12,00:20,2,2,4
12,2023-08-12T00:17:00+10:00,2023-08-12,00:17,0,7,7
12,2023-08-12T00:19:00+10:00,2023-08-12,00:19,3,0,3
17,2023-08-12T00:16:00+10:00,2023-08-12,00:16,2,2,4
17,2023-08-12T00:17:00+10:00,2023-08-12,00:17,1,2,3
17,2023-08-12T00:21:00+10:00,2023-08-12,00:21,0,2,2
17,2023-08-12T00:24:00+10:00,2023-08-12,00:24,1,0,1
24,2023-08-12T00:16:00+10:00,2023-08-12,00:16,3,3,6
24,2023-08-12T00:17:00+10:00,2023-08-12,00:17,2,6,8
24,2023-08-12T00:23:00+10:00,2023-08-12,00:23,1,0,1
24,2023-08-12T00:24:00+10:00,2023-08-12,00:24,4,0,4
35,2023-08-12T00:15:00+10:00,2023-08-12,00:15,5,11,16
35,2023-08-12T00:16:00+10:00,2023-08-12,00:16,7,10,17
35,2023-08-12T00:18:00+10:00,2023-08-12,00:18,2,3,5
35,2023-08-12T00:19:00+10:00,2023-08-12,00:19,2,9,11
35,2023-08-12T00:23:00+10:00,2023-08-12,00:23,2,9,11
35,2023-08-12T00:24:00+10:00,2023-08-12,00:24,7,3,10
53,2023-08-12T00:10:00+10:00,2023-08-12,00:10,1,2,3
53,2023-08-12T00:12:00+10:00,2023-08-12,00:12,0,2,2
53,2023-08-12T00:15:00+10:00,2023-08-12,00:15,1,1,2
53,2023-08-12T00:21:00+10:00,2023-08-12,00:21,2,0,2
53,2023-08-12T00:23:00+10:00,2023-08-12,00:23,0,1,1
53,2023-08-12T00:24:00+10:00,2023-08-12,00:24,0,4,4
56,2023-08-12T00:11:00+10:00,2023-08-12,00:11,0,5,5
56,2023-08-12T00:15:00+10:00,2023-08-12,00:15,1,2,3
56,2023-08-12T00:22:00+10:00,2023-08-12,00:22,1,2,3
56,2023-08-12T00:23:00+10:00,2023-08-12,00:23,0,2,2
56,2023-08-12T00:24:00+10:00,2023-08-12,00:24,2,0,2
57,2023-08-12T00:14:00+10:00,2023-08-12,00:14,0,1,1
58,2023-08-12T00:10:00+10:00,2023-08-12,00:10,5,3,8
58,2023-08-12T00:22:00+10:00,2023-08-12,00:22,0,2,2
58,2023-08-12T00:23:00+10:00,2023-08-12,00:23,2,0,2
62,2023-08-12T00:12:00+10:00,2023-08-12,00:12,4,0,4
62,2023-08-12T00:13:00+10:00,2023-08-12,00:13,12,2,14
62,2023-08-12T00:16:00+10:00,2023-08-12,00:16,1,1,2
62,2023-08-12T00:17:00+10:00,2023-08-12,00:17,12,1,13
62,2023-08-12T00:18:00+10:00,2023-08-12,00:18,0,2,2
62,2023-08-12T00:24:00+10:00,2023-08-12,00:24,0,6,6
63,2023-08-12T00:14:00+10:00,2023-08-12,00:14,1,2,3
63,2023-08-12T00:18:00+10:00,2023-08-12,00:18,5,5,10
63,2023-08-12T00:19:00+10:00,2023-08-12,00:19,4,6,10
63,2023-08-12T00:22:00+10:00,2023-08-12,00:22,1,0,1
63,2023-08-12T00:23:00+10:00,2023-08-12,00:23,0,7,7
67,2023-08-12T00:10:00+10:00,2023-08-12,00:10,9,0,9
67,2023-08-12T00:16:00+10:00,2023-08-12,00:16,0,1,1
67,2023-08-12T00:21:00+10:00,2023-08-12,00:21,1,1,2
68,2023-08-12T00:12:00+10:00,2023-08-12,00:12,1,0,1
68,2023-08-12T00:21:00+10:00,2023-08-12,00:21,1,1,2
72,2023-08-12T00:14:00+10:00,2023-08-12,00:14,2,1,3
72,2023-08-12T00:17:00+10:00,2023-08-12,00:17,0,4,4
72,2023-08-12T00:18:00+10:00,2023-08-12,00:18,0,1,1
76,2023-08-12T00:17:00+10:00,2023-08-12,00:17,4,0,4
79,2023-08-12T00:15:00+10:00,2023-08-12,00:15,1,4,5
79,2023-08-12T00:16:00+10:00,2023-08-12,00:16,2,5,7
79,2023-08-12T00:17:00+10:00,2023-08-12,00:17,2,6,8
79,2023-08-12T00:18:00+10:00,2023-08-12,00:18,4,6,10
79,2023-08-12T00:20:00+10:00,2023-08-12,00:20,4,6,10
79,2023-08-12T00:22:00+10:00,2023-08-12,00:22,3,11,14
85,2023-08-12T00:13:00+10:00,2023-08-12,00:13,1,0,1
85,2023-08-12T00:18:00+10:00,2023-08-12,00:18,0,1,1
85,2023-08-12T00:22:00+10:00,2023-08-12,00:22,0,2,2
85,2023-08-12T00:23:00+10:00,2023-08-12,00:23,0,1,1
109,2023-08-12T00:10:00+10:00,2023-08-12,00:10,2,6,8
117,2023-08-12T00:15:00+10:00,2023-08-12,00:15,14,0,14
122,2023-08-12T00:17:00+10:00,2023-08-12,00:17,1,0,1
3,2023-08-12T00:25:00+10:00,2023-08-12,00:25,6,8,14
3,2023-08-12T00:26:00+10:00,2023-08-12,00:26,8,5,13
3,2023-08-12T00:27:00+10:00,2023-08-12,00:27,13,11,24
3,2023-08-12T00:29:00+10:00,2023-08-12,00:29,4,0,4
3,2023-08-12T00:32:00+10:00,2023-08-12,00:32,3,4,7
3,2023-08-12T00:36:00+10:00,2023-08-12,00:36,10,9,19
3,2023-08-12T00:39:00+10:00,2023-08-12,00:39,7,3,10
4,2023-08-12T00:27:00+10:00,2023-08-12,00:27,5,5,10
4,2023-08-12T00:28:00+10:00,2023-08-12,00:28,3,11,14
4,2023-08-12T00:33:00+10:00,2023-08-12,00:33,2,5,7
4,2023-08-12T00:39:00+10:00,2023-08-12,00:39,6,4,10
6,2023-08-12T00:25:00+10:00,2023-08-12,00:25,3,7,10
6,2023-08-12T00:33:00+10:00,2023-08-12,00:33,3,0,3
6,2023-08-12T00:36:00+10:00,2023-08-12,00:36,8,7,15
6,2023-08-12T00:38:00+10:00,2023-08-12,00:38,5,1,6
8,2023-08-12T00:32:00+10:00,2023-08-12,00:32,0,2,2
14,2023-08-12T00:25:00+10:00,2023-08-12,00:25,1,3,4
14,2023-08-12T00:26:00+10:00,2023-08-12,00:26,2,2,4
14,2023-08-12T00:28:00+10:00,2023-08-12,00:28,2,2,4
14,2023-08-12T00:30:00+10:00,2023-08-12,00:30,3,1,4
14,2023-08-12T00:34:00+10:00,2023-08-12,00:34,2,1,3
14,2023-08-12T00:37:00+10:00,2023-08-12,00:37,9,0,9
21,2023-08-12T00:28:00+10:00,2023-08-12,00:28,4,2,6
21,2023-08-12T00:29:00+10:00,2023-08-12,00:29,7,3,10
21,2023-08-12T00:35:00+10:00,2023-08-12,00:35,4,3,7
21,2023-08-12T00:37:00+10:00,2023-08-12,00:37,4,4,8
28,2023-08-12T00:31:00+10:00,2023-08-12,00:31,2,0,2
28,2023-08-12T00:32:00+10:00,2023-08-12,00:32,1,0,1
28,2023-08-12T00:36:00+10:00,2023-08-12,00:36,1,0,1
39,2023-08-12T00:31:00+10:00,2023-08-12,00:31,0,1,1
39,2023-08-12T00:33:00+10:00,2023-08-12,00:33,0,1,1
39,2023-08-12T00:34:00+10:00,2023-08-12,00:34,3,1,4
41,2023-08-12T00:28:00+10:00,2023-08-12,00:28,2,2,4
41,2023-08-12T00:29:00+10:00,2023-08-12,00:29,6,7,13
41,2023-08-12T00:30:00+10:00,2023-08-12,00:30,13,2,15
41,2023-08-12T00:33:00+10:00,2023-08-12,00:33,2,9,11
41,2023-08-12T00:35:00+10:00,2023-08-12,00:35,9,8,17
54,2023-08-12T00:26:00+10:00,2023-08-12,00:26,0,2,2
54,2023-08-12T00:29:00+10:00,2023-08-12,00:29,0,1,1
54,2023-08-12T00:33:00+10:00,2023-08-12,00:33,3,0,3
55,2023-08-12T00:25:00+10:00,2023-08-12,00:25,2,4,6
55,2023-08-12T00:26:00+10:00,2023-08-12,00:26,5,2,7
55,2023-08-12T00:27:00+10:00,2023-08-12,00:27,10,8,18
55,2023-08-12T00:33:00+10:00,2023-08-12,00:33,2,1,3
55,2023-08-12T00:38:00+10:00,2023-08-12,00:38,7,5,12
61,2023-08-12T00:25:00+10:00,2023-08-12,00:25,3,1,4
61,2023-08-12T00:31:00+10:00,2023-08-12,00:31,1,1,2
65,2023-08-12T00:31:00+10:00,2023-08-12,00:31,0,4,4
65,2023-08-12T00:33:00+10:00,2023-08-12,00:33,0,8,8
65,2023-08-12T00:34:00+10:00,2023-08-12,00:34,0,1,1
65,2023-08-12T00:39:00+10:00,2023-08-12,00:39,2,5,7
66,2023-08-12T00:26:00+10:00,2023-08-12,00:26,4,2,6
66,2023-08-12T00:33:00+10:00,2023-08-12,00:33,7,0,7
70,2023-08-12T00:26:00+10:00,2023-08-12,00:26,0,2,2
70,2023-08-12T00:30:00+10:00,2023-08-12,00:30,1,0,1
84,2023-08-12T00:25:00+10:00,2023-08-12,00:25,12,19,31
107,2023-08-12T00:25:00+10:00,2023-08-12,00:25,1,3,4
107,2023-08-12T00:30:00+10:00,2023-08-12,00:30,0,1,1
108,2023-08-12T00:26:00+10:00,2023-08-12,00:26,1,1,2
108,2023-08-12T00:38:00+10:00,2023-08-12,00:38,1,1,2
108,2023-08-12T00:39:00+10:00,2023-08-12,00:39,1,2,3
1,2023-08-12T00:26:00+10:00,2023-08-12,00:26,1,4,5
2,2023-08-12T00:25:00+10:00,2023-08-12,00:25,0,2,2
2,2023-08-12T00:26:00+10:00,2023-08-12,00:26,3,6,9
2,2023-08-12T00:28:00+10:00,2023-08-12,00:28,0,1,1
2,2023-08-12T00:32:00+10:00,2023-08-12,00:32,0,1,1
2,2023-08-12T00:36:00+10:00,2023-08-12,00:36,0,3,3
7,2023-08-12T00:26:00+10:00,2023-08-12,00:26,0,4,4
7,2023-08-12T00:27:00+10:00,2023-08-12,00:27,0,1,1
7,2023-08-12T00:29:00+10:00,2023-08-12,00:29,0,3,3
7,2023-08-12T00:31:00+10:00,2023-08-12,00:31,3,4,7
7,2023-08-12T00:32:00+10:00,2023-08-12,00:32,1,0,1
7,2023-08-12T00:33:00+10:00,2023-08-12,00:33,0,1,1
9,2023-08-12T00:32:00+10:00,2023-08-12,00:32,1,0,1
17,2023-08-12T00:25:00+10:00,2023-08-12,00:25,0,7,7
17,2023-08-12T00:27:00+10:00,2023-08-12,00:27,1,0,1
17,2023-08-12T00:38:00+10:00,2023-08-12,00:38,0,1,1
24,2023-08-12T00:29:00+10:00,2023-08-12,00:29,2,1,3
24,2023-08-12T00:32:00+10:00,2023-08-12,00:32,2,6,8
24,2023-08-12T00:38:00+10:00,2023-08-12,00:38,2,0,2
27,2023-08-12T00:26:00+10:00,2023-08-12,00:26,2,0,2
27,2023-08-12T00:39:00+10:00,2023-08-12,00:39,0,2,2
35,2023-08-12T00:26:00+10:00,2023-08-12,00:26,1,7,8
35,2023-08-12T00:31:00+10:00,2023-08-12,00:31,4,7,11
35,2023-08-12T00:32:00+10:00,2023-08-12,00:32,5,4,9
35,2023-08-12T00:34:00+10:00,2023-08-12,00:34,9,8,17
35,2023-08-12T00:35:00+10:00,2023-08-12,00:35,5,4,9
35,2023-08-12T00:37:00+10:00,2023-08-12,00:37,2,2,4
35,2023-08-12T00:39:00+10:00,2023-08-12,00:39,1,2,3
53,2023-08-12T00:25:00+10:00,2023-08-12,00:25,1,0,1
53,2023-08-12T00:26:00+10:00,2023-08-12,00:26,3,0,3
53,2023-08-12T00:34:00+10:00,2023-08-12,00:34,0,1,1
53,2023-08-12T00:37:00+10:00,2023-08-12,00:37,1,4,5
56,2023-08-12T00:25:00+10:00,2023-08-12,00:25,0,4,4
56,2023-08-12T00:27:00+10:00,2023-08-12,00:27,0,3,3
56,2023-08-12T00:32:00+10:00,2023-08-12,00:32,0,1,1
56,2023-08-12T00:33:00+10:00,2023-08-12,00:33,0,1,1
56,2023-08-12T00:34:00+10:00,2023-08-12,00:34,7,3,10
56,2023-08-12T00:35:00+10:00,2023-08-12,00:35,0,2,2
56,2023-08-12T00:37:00+10:00,2023-08-12,00:37,0,2,2
56,2023-08-12T00:39:00+10:00,2023-08-12,00:39,4,2,6
57,2023-08-12T00:25:00+10:00,2023-08-12,00:25,2,1,3
58,2023-08-12T00:26:00+10:00,2023-08-12,00:26,1,0,1
58,2023-08-12T00:30:00+10:00,2023-08-12,00:30,4,0,4
58,2023-08-12T00:31:00+10:00,2023-08-12,00:31,3,0,3
58,2023-08-12T00:34:00+10:00,2023-08-12,00:34,1,0,1
58,2023-08-12T00:35:00+10:00,2023-08-12,00:35,6,3,9
62,2023-08-12T00:27:00+10:00,2023-08-12,00:27,6,1,7
62,2023-08-12T00:29:00+10:00,2023-08-12,00:29,4,3,7
62,2023-08-12T00:30:00+10:00,2023-08-12,00:30,2,3,5
62,2023-08-12T00:32:00+10:00,2023-08-12,00:32,1,0,1
62,2023-08-12T00:33:00+10:00,2023-08-12,00:33,1,1,2
62,2023-08-12T00:35:00+10:00,2023-08-12,00:35,3,0,3
62,2023-08-12T00:36:00+10:00,2023-08-12,00:36,9,0,9
62,2023-08-12T00:37:00+10:00,2023-08-12,00:37,2,0,2
63,2023-08-12T00:32:00+10:00,2023-08-12,00:32,5,0,5
63,2023-08-12T00:36:00+10:00,2023-08-12,00:36,0,17,17
63,2023-08-12T00:37:00+10:00,2023-08-12,00:37,1,7,8
63,2023-08-12T00:38:00+10:00,2023-08-12,00:38,0,2,2
67,2023-08-12T00:37:00+10:00,2023-08-12,00:37,0,1,1
67,2023-08-12T00:38:00+10:00,2023-08-12,00:38,6,2,8
72,2023-08-12T00:26:00+10:00,2023-08-12,00:26,1,1,2
72,2023-08-12T00:28:00+10:00,2023-08-12,00:28,0,1,1
72,2023-08-12T00:37:00+10:00,2023-08-12,00:37,1,2,3
79,2023-08-12T00:25:00+10:00,2023-08-12,00:25,3,13,16
79,2023-08-12T00:26:00+10:00,2023-08-12,00:26,0,11,11
79,2023-08-12T00:29:00+10:00,2023-08-12,00:29,0,4,4
79,2023-08-12T00:31:00+10:00,2023-08-12,00:31,1,1,2
79,2023-08-12T00:32:00+10:00,2023-08-12,00:32,0,6,6
79,2023-08-12T00:34:00+10:00,2023-08-12,00:34,8,12,20
79,2023-08-12T00:35:00+10:00,2023-08-12,00:35,3,0,3
79,2023-08-12T00:37:00+10:00,2023-08-12,00:37,2,18,20
79,2023-08-12T00:38:00+10:00,2023-08-12,00:38,0,1,1
79,2023-08-12T00:39:00+10:00,2023-08-12,00:39,2,6,8
109,2023-08-12T00:25:00+10:00,2023-08-12,00:25,0,6,6
109,2023-08-12T00:30:00+10:00,2023-08-12,00:30,4,14,18
117,2023-08-12T00:25:00+10:00,2023-08-12,00:25,3,3,6
117,2023-08-12T00:30:00+10:00,2023-08-12,00:30,10,4,14
117,2023-08-12T00:35:00+10:00,2023-08-12,00:35,3,2,5
122,2023-08-12T00:38:00+10:00,2023-08-12,00:38,1,0,1
3,2023-08-12T00:40:00+10:00,2023-08-12,00:40,2,12,14
3,2023-08-12T00:42:00+10:00,2023-08-12,00:42,6,0,6
3,2023-08-12T00:45:00+10:00,2023-08-12,00:45,4,7,11
3,2023-08-12T00:51:00+10:00,2023-08-12,00:51,1,2,3
4,2023-08-12T00:40:00+10:00,2023-08-12,00:40,6,2,8
4,2023-08-12T00:51:00+10:00,2023-08-12,00:51,6,1,7
4,2023-08-12T00:54:00+10:00,2023-08-12,00:54,7,3,10
6,2023-08-12T00:40:00+10:00,2023-08-12,00:40,3,4,7
6,2023-08-12T00:41:00+10:00,2023-08-12,00:41,7,2,9
6,2023-08-12T00:44:00+10:00,2023-08-12,00:44,3,3,6
6,2023-08-12T00:48:00+10:00,2023-08-12,00:48,5,0,5
6,2023-08-12T00:49:00+10:00,2023-08-12,00:49,1,1,2
6,2023-08-12T00:53:00+10:00,2023-08-12,00:53,5,2,7
8,2023-08-12T00:42:00+10:00,2023-08-12,00:42,3,0,3
8,2023-08-12T00:52:00+10:00,2023-08-12,00:52,0,1,1
14,2023-08-12T00:40:00+10:00,2023-08-12,00:40,3,0,3
14,2023-08-12T00:49:00+10:00,2023-08-12,00:49,13,1,14
14,2023-08-12T00:50:00+10:00,2023-08-12,00:50,2,0,2
14,2023-08-12T00:52:00+10:00,2023-08-12,00:52,4,2,6
14,2023-08-12T00:54:00+10:00,2023-08-12,00:54,3,0,3
21,2023-08-12T00:46:00+10:00,2023-08-12,00:46,4,2,6
21,2023-08-12T00:47:00+10:00,2023-08-12,00:47,1,3,4
21,2023-08-12T00:48:00+10:00,2023-08-12,00:48,3,0,3
21,2023-08-12T00:49:00+10:00,2023-08-12,00:49,4,4,8
21,2023-08-12T00:50:00+10:00,2023-08-12,00:50,8,4,12
28,2023-08-12T00:48:00+10:00,2023-08-12,00:48,0,1,1
28,2023-08-12T00:49:00+10:00,2023-08-12,00:49,1,5,6
28,2023-08-12T00:50:00+10:00,2023-08-12,00:50,1,0,1
28,2023-08-12T00:54:00+10:00,2023-08-12,00:54,0,1,1
29,2023-08-12T00:40:00+10:00,2023-08-12,00:40,0,2,2
29,2023-08-12T00:46:00+10:00,2023-08-12,00:46,0,2,2
39,2023-08-12T00:45:00+10:00,2023-08-12,00:45,0,1,1
41,2023-08-12T00:41:00+10:00,2023-08-12,00:41,3,3,6
41,2023-08-12T00:42:00+10:00,2023-08-12,00:42,5,7,12
41,2023-08-12T00:44:00+10:00,2023-08-12,00:44,3,6,9
41,2023-08-12T00:46:00+10:00,2023-08-12,00:46,2,10,12
41,2023-08-12T00:47:00+10:00,2023-08-12,00:47,3,19,22
41,2023-08-12T00:50:00+10:00,2023-08-12,00:50,4,6,10
41,2023-08-12T00:54:00+10:00,2023-08-12,00:54,6,2,8
54,2023-08-12T00:45:00+10:00,2023-08-12,00:45,1,0,1
54,2023-08-12T00:51:00+10:00,2023-08-12,00:51,0,1,1
54,2023-08-12T00:53:00+10:00,2023-08-12,00:53,0,3,3
55,2023-08-12T00:42:00+10:00,2023-08-12,00:42,3,3,6
55,2023-08-12T00:43:00+10:00,2023-08-12,00:43,3,10,13
55,2023-08-12T00:45:00+10:00,2023-08-12,00:45,4,6,10
55,2023-08-12T00:47:00+10:00,2023-08-12,00:47,11,1,12
55,2023-08-12T00:49:00+10:00,2023-08-12,00:49,2,1,3
55,2023-08-12T00:53:00+10:00,2023-08-12,00:53,8,3,11
55,2023-08-12T00:54:00+10:00,2023-08-12,00:54,9,1,10
59,2023-08-12T00:40:00+10:00,2023-08-12,00:40,11,5,16
59,2023-08-12T00:45:00+10:00,2023-08-12,00:45,17,5,22
61,2023-08-12T00:43:00+10:00,2023-08-12,00:43,4,0,4
61,2023-08-12T00:45:00+10:00,2023-08-12,00:45,0,1,1
61,2023-08-12T00:54:00+10:00,2023-08-12,00:54,1,0,1
65,2023-08-12T00:42:00+10:00,2023-08-12,00:42,1,3,4
65,2023-08-12T00:46:00+10:00,2023-08-12,00:46,2,2,4
65,2023-08-12T00:48:00+10:00,2023-08-12,00:48,1,1,2
65,2023-08-12T00:51:00+10:00,2023-08-12,00:51,0,7,7
65,2023-08-12T00:54:00+10:00,2023-08-12,00:54,0,7,7
66,2023-08-12T00:44:00+10:00,2023-08-12,00:44,0,3,3
66,2023-08-12T00:48:00+10:00,2023-08-12,00:48,6,1,7
66,2023-08-12T00:52:00+10:00,2023-08-12,00:52,3,2,5
69,2023-08-12T00:51:00+10:00,2023-08-12,00:51,1,0,1
69,2023-08-12T00:54:00+10:00,2023-08-12,00:54,0,1,1
70,2023-08-12T00:44:00+10:00,2023-08-12,00:44,0,1,1
75,2023-08-12T00:44:00+10:00,2023-08-12,00:44,0,1,1
77,2023-08-12T00:43:00+10:00,2023-08-12,00:43,0,1,1
77,2023-08-12T00:49:00+10:00,2023-08-12,00:49,1,0,1
78,2023-08-12T00:50:00+10:00,2023-08-12,00:50,0,1,1
87,2023-08-12T00:43:00+10:00,2023-08-12,00:43,2,0,2
107,2023-08-12T00:40:00+10:00,2023-08-12,00:40,0,6,6
107,2023-08-12T00:45:00+10:00,2023-08-12,00:45,4,0,4
107,2023-08-12T00:50:00+10:00,2023-08-12,00:50,5,2,7
108,2023-08-12T00:40:00+10:00,2023-08-12,00:40,0,1,1
108,2023-08-12T00:45:00+10:00,2023-08-12,00:45,7,3,10
108,2023-08-12T00:54:00+10:00,2023-08-12,00:54,0,1,1
1,2023-08-12T00:46:00+10:00,2023-08-12,00:46,1,0,1
1,2023-08-12T00:47:00+10:00,2023-08-12,00:47,1,0,1
1,2023-08-12T00:48:00+10:00,2023-08-12,00:48,1,0,1
1,2023-08-12T00:50:00+10:00,2023-08-12,00:50,2,0,2
2,2023-08-12T00:41:00+10:00,2023-08-12,00:41,1,3,4
2,2023-08-12T00:53:00+10:00,2023-08-12,00:53,1,0,1
7,2023-08-12T00:44:00+10:00,2023-08-12,00:44,0,2,2
7,2023-08-12T00:54:00+10:00,2023-08-12,00:54,0,1,1
9,2023-08-12T00:40:00+10:00,2023-08-12,00:40,0,1,1
9,2023-08-12T00:42:00+10:00,2023-08-12,00:42,1,0,1
9,2023-08-12T00:50:00+10:00,2023-08-12,00:50,0,1,1
10,2023-08-12T00:52:00+10:00,2023-08-12,00:52,0,1,1
12,2023-08-12T00:41:00+10:00,2023-08-12,00:41,0,3,3
12,2023-08-12T00:42:00+10:00,2023-08-12,00:42,0,1,1
12,2023-08-12T00:48:00+10:00,2023-08-12,00:48,0,1,1
12,2023-08-12T00:54:00+10:00,2023-08-12,00:54,0,2,2
17,2023-08-12T00:43:00+10:00,2023-08-12,00:43,0,1,1
17,2023-08-12T00:46:00+10:00,2023-08-12,00:46,0,3,3
18,2023-08-12T00:41:00+10:00,2023-08-12,00:41,0,1,1
24,2023-08-12T00:41:00+10:00,2023-08-12,00:41,3,2,5
24,2023-08-12T00:45:00+10:00,2023-08-12,00:45,4,4,8
24,2023-08-12T00:46:00+10:00,2023-08-12,00:46,2,6,8
27,2023-08-12T00:51:00+10:00,2023-08-12,00:51,1,0,1
35,2023-08-12T00:42:00+10:00,2023-08-12,00:42,2,8,10
35,2023-08-12T00:43:00+10:00,2023-08-12,00:43,3,1,4
35,2023-08-12T00:45:00+10:00,2023-08-12,00:45,4,5,9
35,2023-08-12T00:49:00+10:00,2023-08-12,00:49,1,5,6
35,2023-08-12T00:53:00+10:00,2023-08-12,00:53,1,1,2
53,2023-08-12T00:41:00+10:00,2023-08-12,00:41,0,4,4
53,2023-08-12T00:42:00+10:00,2023-08-12,00:42,3,0,3
53,2023-08-12T00:45:00+10:00,2023-08-12,00:45,0,1,1
56,2023-08-12T00:41:00+10:00,2023-08-12,00:41,1,2,3
56,2023-08-12T00:44:00+10:00,2023-08-12,00:44,1,0,1
56,2023-08-12T00:54:00+10:00,2023-08-12,00:54,0,1,1
57,2023-08-12T00:43:00+10:00,2023-08-12,00:43,1,0,1
58,2023-08-12T00:40:00+10:00,2023-08-12,00:40,0,6,6
58,2023-08-12T00:44:00+10:00,2023-08-12,00:44,5,3,8
58,2023-08-12T00:49:00+10:00,2023-08-12,00:49,1,12,13
58,2023-08-12T00:51:00+10:00,2023-08-12,00:51,2,6,8
58,2023-08-12T00:53:00+10:00,2023-08-12,00:53,0,7,7
62,2023-08-12T00:44:00+10:00,2023-08-12,00:44,1,3,4
62,2023-08-12T00:45:00+10:00,2023-08-12,00:45,3,3,6
62,2023-08-12T00:49:00+10:00,2023-08-12,00:49,3,0,3
62,2023-08-12T00:52:00+10:00,2023-08-12,00:52,3,1,4
63,2023-08-12T00:43:00+10:00,2023-08-12,00:43,8,5,13
63,2023-08-12T00:45:00+10:00,2023-08-12,00:45,4,3,7
63,2023-08-12T00:47:00+10:00,2023-08-12,00:47,4,6,10
63,2023-08-12T00:48:00+10:00,2023-08-12,00:48,1,0,1
63,2023-08-12T00:52:00+10:00,2023-08-12,00:52,0,2,2
67,2023-08-12T00:40:00+10:00,2023-08-12,00:40,0,3,3
67,2023-08-12T00:46:00+10:00,2023-08-12,00:46,1,0,1
67,2023-08-12T00:47:00+10:00,2023-08-12,00:47,0,6,6
67,2023-08-12T00:48:00+10:00,2023-08-12,00:48,1,4,5
67,2023-08-12T00:50:00+10:00,2023-08-12,00:50,2,6,8
67,2023-08-12T00:51:00+10:00,2023-08-12,00:51,0,1,1
67,2023-08-12T00:52:00+10:00,2023-08-12,00:52,2,0,2
72,2023-08-12T00:40:00+10:00,2023-08-12,00:40,0,1,1
72,2023-08-12T00:41:00+10:00,2023-08-12,00:41,1,0,1
72,2023-08-12T00:43:00+10:00,2023-08-12,00:43,3,0,3
72,2023-08-12T00:45:00+10:00,2023-08-12,00:45,1,2,3
79,2023-08-12T00:41:00+10:00,2023-08-12,00:41,1,2,3
79,2023-08-12T00:43:00+10:00,2023-08-12,00:43,2,2,4
79,2023-08-12T00:46:00+10:00,2023-08-12,00:46,2,2,4
79,2023-08-12T00:47:00+10:00,2023-08-12,00:47,0,8,8
79,2023-08-12T00:49:00+10:00,2023-08-12,00:49,3,6,9
79,2023-08-12T00:50:00+10:00,2023-08-12,00:50,4,7,11
79,2023-08-12T00:52:00+10:00,2023-08-12,00:52,3,1,4
79,2023-08-12T00:54:00+10:00,2023-08-12,00:54,0,3,3
85,2023-08-12T00:53:00+10:00,2023-08-12,00:53,1,0,1
117,2023-08-12T00:45:00+10:00,2023-08-12,00:45,8,6,14
122,2023-08-12T00:42:00+10:00,2023-08-12,00:42,0,1,1
3,2023-08-12T00:59:00+10:00,2023-08-12,00:59,1,10,11
3,2023-08-12T01:07:00+10:00,2023-08-12,01:07,13,9,22
4,2023-08-12T00:55:00+10:00,2023-08-12,00:55,1,2,3
4,2023-08-12T00:58:00+10:00,2023-08-12,00:58,7,2,9
4,2023-08-12T00:59:00+10:00,2023-08-12,00:59,2,4,6
4,2023-08-12T01:03:00+10:00,2023-08-12,01:03,1,5,6
4,2023-08-12T01:06:00+10:00,2023-08-12,01:06,7,0,7
4,2023-08-12T01:09:00+10:00,2023-08-12,01:09,1,7,8
6,2023-08-12T01:00:00+10:00,2023-08-12,01:00,3,5,8
6,2023-08-12T01:02:00+10:00,2023-08-12,01:02,1,0,1
6,2023-08-12T01:07:00+10:00,2023-08-12,01:07,0,3,3
6,2023-08-12T01:08:00+10:00,2023-08-12,01:08,2,4,6
8,2023-08-12T00:59:00+10:00,2023-08-12,00:59,0,2,2
14,2023-08-12T00:56:00+10:00,2023-08-12,00:56,4,2,6
14,2023-08-12T00:57:00+10:00,2023-08-12,00:57,3,4,7
14,2023-08-12T00:59:00+10:00,2023-08-12,00:59,1,0,1
14,2023-08-12T01:01:00+10:00,2023-08-12,01:01,1,0,1
14,2023-08-12T01:04:00+10:00,2023-08-12,01:04,5,1,6
21,2023-08-12T01:04:00+10:00,2023-08-12,01:04,0,2,2
21,2023-08-12T01:05:00+10:00,2023-08-12,01:05,5,1,6
28,2023-08-12T01:00:00+10:00,2023-08-12,01:00,1,0,1
28,2023-08-12T01:02:00+10:00,2023-08-12,01:02,2,0,2
28,2023-08-12T01:07:00+10:00,2023-08-12,01:07,1,0,1
29,2023-08-12T00:55:00+10:00,2023-08-12,00:55,4,2,6
29,2023-08-12T00:56:00+10:00,2023-08-12,00:56,0,1,1
29,2023-08-12T01:05:00+10:00,2023-08-12,01:05,1,0,1
39,2023-08-12T00:57:00+10:00,2023-08-12,00:57,1,0,1
41,2023-08-12T00:56:00+10:00,2023-08-12,00:56,4,4,8
41,2023-08-12T00:58:00+10:00,2023-08-12,00:58,3,2,5
41,2023-08-12T01:01:00+10:00,2023-08-12,01:01,8,5,13
41,2023-08-12T01:02:00+10:00,2023-08-12,01:02,1,10,11
41,2023-08-12T01:04:00+10:00,2023-08-12,01:04,1,1,2
54,2023-08-12T01:02:00+10:00,2023-08-12,01:02,1,0,1
55,2023-08-12T01:05:00+10:00,2023-08-12,01:05,1,2,3
55,2023-08-12T01:06:00+10:00,2023-08-12,01:06,2,2,4
55,2023-08-12T01:07:00+10:00,2023-08-12,01:07,9,5,14
59,2023-08-12T01:05:00+10:00,2023-08-12,01:05,9,11,20
61,2023-08-12T00:56:00+10:00,2023-08-12,00:56,0,2,2
61,2023-08-12T01:01:00+10:00,2023-08-12,01:01,3,2,5
61,2023-08-12T01:02:00+10:00,2023-08-12,01:02,1,0,1
61,2023-08-12T01:04:00+10:00,2023-08-12,01:04,1,0,1
61,2023-08-12T01:08:00+10:00,2023-08-12,01:08,0,1,1
65,2023-08-12T01:04:00+10:00,2023-08-12,01:04,2,1,3
65,2023-08-12T01:08:00+10:00,2023-08-12,01:08,1,10,11
66,2023-08-12T00:57:00+10:00,2023-08-12,00:57,3,0,3
66,2023-08-12T00:58:00+10:00,2023-08-12,00:58,2,3,5
66,2023-08-12T01:04:00+10:00,2023-08-12,01:04,4,4,8
66,2023-08-12T01:09:00+10:00,2023-08-12,01:09,0,1,1
69,2023-08-12T01:05:00+10:00,2023-08-12,01:05,1,5,6
107,2023-08-12T01:05:00+10:00,2023-08-12,01:05,0,4,4
108,2023-08-12T01:01:00+10:00,2023-08-12,01:01,1,0,1
108,2023-08-12T01:05:00+10:00,2023-08-12,01:05,1,0,1
1,2023-08-12T00:55:00+10:00,2023-08-12,00:55,0,3,3
1,2023-08-12T00:58:00+10:00,2023-08-12,00:58,0,1,1
1,2023-08-12T01:00:00+10:00,2023-08-12,01:00,2,0,2
1,2023-08-12T01:02:00+10:00,2023-08-12,01:02,1,0,1
1,2023-08-12T01:05:00+10:00,2023-08-12,01:05,1,0,1
1,2023-08-12T01:07:00+10:00,2023-08-12,01:07,0,1,1
2,2023-08-12T00:55:00+10:00,2023-08-12,00:55,0,2,2
2,2023-08-12T00:59:00+10:00,2023-08-12,00:59,0,1,1
2,2023-08-12T01:08:00+10:00,2023-08-12,01:08,0,1,1
7,2023-08-12T00:55:00+10:00,2023-08-12,00:55,1,0,1
9,2023-08-12T00:57:00+10:00,2023-08-12,00:57,0,3,3
9,2023-08-12T01:05:00+10:00,2023-08-12,01:05,2,0,2
9,2023-08-12T01:08:00+10:00,2023-08-12,01:08,0,2,2
12,2023-08-12T01:00:00+10:00,2023-08-12,01:00,1,0,1
24,2023-08-12T00:58:00+10:00,2023-08-12,00:58,1,5,6
24,2023-08-12T00:59:00+10:00,2023-08-12,00:59,2,2,4
24,2023-08-12T01:02:00+10:00,2023-08-12,01:02,1,4,5
24,2023-08-12T01:04:00+10:00,2023-08-12,01:04,5,0,5
24,2023-08-12T01:09:00+10:00,2023-08-12,01:09,1,0,1
27,2023-08-12T00:58:00+10:00,2023-08-12,00:58,0,2,2
27,2023-08-12T01:00:00+10:00,2023-08-12,01:00,1,1,2
27,2023-08-12T01:01:00+10:00,2023-08-12,01:01,1,0,1
35,2023-08-12T00:56:00+10:00,2023-08-12,00:56,3,4,7
35,2023-08-12T00:57:00+10:00,2023-08-12,00:57,5,2,7
35,2023-08-12T01:01:00+10:00,2023-08-12,01:01,1,0,1
35,2023-08-12T01:05:00+10:00,2023-08-12,01:05,0,3,3
35,2023-08-12T01:07:00+10:00,2023-08-12,01:07,1,1,2
53,2023-08-12T00:55:00+10:00,2023-08-12,00:55,0,4,4
53,2023-08-12T01:02:00+10:00,2023-08-12,01:02,0,2,2
56,2023-08-12T01:00:00+10:00,2023-08-12,01:00,0,1,1
56,2023-08-12T01:05:00+10:00,2023-08-12,01:05,2,0,2
56,2023-08-12T01:07:00+10:00,2023-08-12,01:07,3,1,4
56,2023-08-12T01:08:00+10:00,2023-08-12,01:08,3,0,3
58,2023-08-12T00:56:00+10:00,2023-08-12,00:56,1,0,1
58,2023-08-12T00:57:00+10:00,2023-08-12,00:57,0,3,3
58,2023-08-12T00:58:00+10:00,2023-08-12,00:58,0,3,3
58,2023-08-12T01:01:00+10:00,2023-08-12,01:01,2,1,3
58,2023-08-12T01:02:00+10:00,2023-08-12,01:02,1,3,4
58,2023-08-12T01:03:00+10:00,2023-08-12,01:03,1,0,1
58,2023-08-12T01:07:00+10:00,2023-08-12,01:07,0,2,2
62,2023-08-12T00:56:00+10:00,2023-08-12,00:56,2,2,4
62,2023-08-12T00:58:00+10:00,2023-08-12,00:58,2,2,4
62,2023-08-12T00:59:00+10:00,2023-08-12,00:59,1,1,2
62,2023-08-12T01:00:00+10:00,2023-08-12,01:00,1,0,1
62,2023-08-12T01:02:00+10:00,2023-08-12,01:02,1,1,2
62,2023-08-12T01:04:00+10:00,2023-08-12,01:04,5,1,6
62,2023-08-12T01:05:00+10:00,2023-08-12,01:05,0,1,1
62,2023-08-12T01:07:00+10:00,2023-08-12,01:07,4,0,4
63,2023-08-12T00:55:00+10:00,2023-08-12,00:55,4,2,6
63,2023-08-12T01:00:00+10:00,2023-08-12,01:00,9,1,10
63,2023-08-12T01:01:00+10:00,2023-08-12,01:01,2,2,4
63,2023-08-12T01:04:00+10:00,2023-08-12,01:04,2,3,5
63,2023-08-12T01:08:00+10:00,2023-08-12,01:08,14,1,15
67,2023-08-12T00:55:00+10:00,2023-08-12,00:55,0,2,2
67,2023-08-12T01:01:00+10:00,2023-08-12,01:01,2,1,3
67,2023-08-12T01:07:00+10:00,2023-08-12,01:07,1,0,1
67,2023-08-12T01:09:00+10:00,2023-08-12,01:09,2,0,2
68,2023-08-12T01:03:00+10:00,2023-08-12,01:03,1,0,1
72,2023-08-12T01:00:00+10:00,2023-08-12,01:00,0,6,6
72,2023-08-12T01:02:00+10:00,2023-08-12,01:02,7,1,8
72,2023-08-12T01:07:00+10:00,2023-08-12,01:07,0,1,1
79,2023-08-12T00:56:00+10:00,2023-08-12,00:56,3,5,8
79,2023-08-12T00:57:00+10:00,2023-08-12,00:57,0,3,3
79,2023-08-12T00:58:00+10:00,2023-08-12,00:58,0,4,4
79,2023-08-12T00:59:00+10:00,2023-08-12,00:59,1,1,2
79,2023-08-12T01:05:00+10:00,2023-08-12,01:05,1,5,6
79,2023-08-12T01:07:00+10:00,2023-08-12,01:07,2,4,6
86,2023-08-12T00:58:00+10:00,2023-08-12,00:58,1,0,1
86,2023-08-12T01:02:00+10:00,2023-08-12,01:02,1,0,1
86,2023-08-12T01:05:00+10:00,2023-08-12,01:05,0,1,1
117,2023-08-12T00:55:00+10:00,2023-08-12,00:55,7,1,8
3,2023-08-12T01:11:00+10:00,2023-08-12,01:11,3,5,8
3,2023-08-12T01:18:00+10:00,2023-08-12,01:18,12,13,25
3,2023-08-12T01:20:00+10:00,2023-08-12,01:20,3,6,9
3,2023-08-12T01:21:00+10:00,2023-08-12,01:21,8,3,11
4,2023-08-12T01:12:00+10:00,2023-08-12,01:12,12,1,13
4,2023-08-12T01:13:00+10:00,2023-08-12,01:13,3,3,6
4,2023-08-12T01:18:00+10:00,2023-08-12,01:18,2,9,11
4,2023-08-12T01:19:00+10:00,2023-08-12,01:19,0,5,5
4,2023-08-12T01:22:00+10:00,2023-08-12,01:22,3,3,6
6,2023-08-12T01:13:00+10:00,2023-08-12,01:13,3,5,8
6,2023-08-12T01:19:00+10:00,2023-08-12,01:19,2,0,2
6,2023-08-12T01:21:00+10:00,2023-08-12,01:21,2,0,2
6,2023-08-12T01:24:00+10:00,2023-08-12,01:24,1,6,7
14,2023-08-12T01:16:00+10:00,2023-08-12,01:16,2,0,2
14,2023-08-12T01:17:00+10:00,2023-08-12,01:17,1,0,1
14,2023-08-12T01:21:00+10:00,2023-08-12,01:21,0,1,1
14,2023-08-12T01:22:00+10:00,2023-08-12,01:22,6,1,7
21,2023-08-12T01:10:00+10:00,2023-08-12,01:10,0,3,3
21,2023-08-12T01:14:00+10:00,2023-08-12,01:14,5,1,6
21,2023-08-12T01:17:00+10:00,2023-08-12,01:17,2,6,8
21,2023-08-12T01:18:00+10:00,2023-08-12,01:18,7,3,10
21,2023-08-12T01:21:00+10:00,2023-08-12,01:21,4,5,9
21,2023-08-12T01:24:00+10:00,2023-08-12,01:24,2,2,4
28,2023-08-12T01:11:00+10:00,2023-08-12,01:11,1,0,1
28,2023-08-12T01:13:00+10:00,2023-08-12,01:13,0,1,1
28,2023-08-12T01:17:00+10:00,2023-08-12,01:17,3,0,3
29,2023-08-12T01:11:00+10:00,2023-08-12,01:11,2,0,2
29,2023-08-12T01:17:00+10:00,2023-08-12,01:17,4,0,4
29,2023-08-12T01:20:00+10:00,2023-08-12,01:20,0,1,1
41,2023-08-12T01:15:00+10:00,2023-08-12,01:15,2,1,3
41,2023-08-12T01:16:00+10:00,2023-08-12,01:16,3,6,9
41,2023-08-12T01:19:00+10:00,2023-08-12,01:19,0,5,5
54,2023-08-12T01:13:00+10:00,2023-08-12,01:13,1,1,2
54,2023-08-12T01:17:00+10:00,2023-08-12,01:17,0,1,1
55,2023-08-12T01:16:00+10:00,2023-08-12,01:16,7,4,11
55,2023-08-12T01:17:00+10:00,2023-08-12,01:17,10,2,12
55,2023-08-12T01:21:00+10:00,2023-08-12,01:21,7,8,15
55,2023-08-12T01:23:00+10:00,2023-08-12,01:23,9,3,12
59,2023-08-12T01:15:00+10:00,2023-08-12,01:15,3,1,4
59,2023-08-12T01:20:00+10:00,2023-08-12,01:20,11,2,13
61,2023-08-12T01:10:00+10:00,2023-08-12,01:10,0,1,1
61,2023-08-12T01:15:00+10:00,2023-08-12,01:15,0,1,1
65,2023-08-12T01:10:00+10:00,2023-08-12,01:10,1,0,1
65,2023-08-12T01:13:00+10:00,2023-08-12,01:13,0,3,3
66,2023-08-12T01:13:00+10:00,2023-08-12,01:13,4,8,12
66,2023-08-12T01:17:00+10:00,2023-08-12,01:17,3,0,3
66,2023-08-12T01:18:00+10:00,2023-08-12,01:18,5,1,6
66,2023-08-12T01:19:00+10:00,2023-08-12,01:19,1,1,2
108,2023-08-12T01:14:00+10:00,2023-08-12,01:14,0,1,1
108,2023-08-12T01:20:00+10:00,2023-08-12,01:20,0,2,2
1,2023-08-12T01:10:00+10:00,2023-08-12,01:10,8,0,8
1,2023-08-12T01:17:00+10:00,2023-08-12,01:17,1,0,1
2,2023-08-12T01:10:00+10:00,2023-08-12,01:10,5,0,5
2,2023-08-12T01:12:00+10:00,2023-08-12,01:12,0,6,6
2,2023-08-12T01:13:00+10:00,2023-08-12,01:13,0,4,4
2,2023-08-12T01:18:00+10:00,2023-08-12,01:18,0,1,1
2,2023-08-12T01:20:00+10:00,2023-08-12,01:20,0,8,8
2,2023-08-12T01:22:00+10:00,2023-08-12,01:22,0,4,4
9,2023-08-12T01:14:00+10:00,2023-08-12,01:14,2,0,2
10,2023-08-12T01:11:00+10:00,2023-08-12,01:11,2,0,2
12,2023-08-12T01:17:00+10:00,2023-08-12,01:17,1,0,1
17,2023-08-12T01:15:00+10:00,2023-08-12,01:15,0,1,1
17,2023-08-12T01:17:00+10:00,2023-08-12,01:17,1,0,1
17,2023-08-12T01:21:00+10:00,2023-08-12,01:21,0,1,1
24,2023-08-12T01:13:00+10:00,2023-08-12,01:13,1,2,3
24,2023-08-12T01:15:00+10:00,2023-08-12,01:15,0,1,1
24,2023-08-12T01:17:00+10:00,2023-08-12,01:17,0,11,11
27,2023-08-12T01:10:00+10:00,2023-08-12,01:10,2,0,2
27,2023-08-12T01:23:00+10:00,2023-08-12,01:23,1,0,1
35,2023-08-12T01:11:00+10:00,2023-08-12,01:11,5,5,10
35,2023-08-12T01:15:00+10:00,2023-08-12,01:15,1,4,5
35,2023-08-12T01:16:00+10:00,2023-08-12,01:16,5,3,8
35,2023-08-12T01:17:00+10:00,2023-08-12,01:17,2,1,3
35,2023-08-12T01:20:00+10:00,2023-08-12,01:20,0,4,4
35,2023-08-12T01:24:00+10:00,2023-08-12,01:24,2,3,5
53,2023-08-12T01:15:00+10:00,2023-08-12,01:15,1,0,1
53,2023-08-12T01:21:00+10:00,2023-08-12,01:21,1,2,3
56,2023-08-12T01:11:00+10:00,2023-08-12,01:11,1,1,2
56,2023-08-12T01:14:00+10:00,2023-08-12,01:14,2,0,2
56,2023-08-12T01:20:00+10:00,2023-08-12,01:20,3,4,7
58,2023-08-12T01:11:00+10:00,2023-08-12,01:11,2,1,3
58,2023-08-12T01:12:00+10:00,2023-08-12,01:12,0,2,2
58,2023-08-12T01:16:00+10:00,2023-08-12,01:16,2,0,2
58,2023-08-12T01:18:00+10:00,2023-08-12,01:18,1,1,2
62,2023-08-12T01:10:00+10:00,2023-08-12,01:10,1,0,1
62,2023-08-12T01:16:00+10:00,2023-08-12,01:16,2,0,2
62,2023-08-12T01:17:00+10:00,2023-08-12,01:17,3,4,7
62,2023-08-12T01:18:00+10:00,2023-08-12,01:18,0,3,3
62,2023-08-12T01:19:00+10:00,2023-08-12,01:19,1,0,1
62,2023-08-12T01:21:00+10:00,2023-08-12,01:21,2,2,4
62,2023-08-12T01:23:00+10:00,2023-08-12,01:23,2,3,5
63,2023-08-12T01:10:00+10:00,2023-08-12,01:10,1,1,2
63,2023-08-12T01:14:00+10:00,2023-08-12,01:14,2,4,6
63,2023-08-12T01:15:00+10:00,2023-08-12,01:15,2,3,5
63,2023-08-12T01:17:00+10:00,2023-08-12,01:17,2,11,13
63,2023-08-12T01:21:00+10:00,2023-08-12,01:21,0,3,3
67,2023-08-12T01:11:00+10:00,2023-08-12,01:11,0,3,3
67,2023-08-12T01:14:00+10:00,2023-08-12,01:14,0,3,3
67,2023-08-12T01:15:00+10:00,2023-08-12,01:15,0,1,1
67,2023-08-12T01:17:00+10:00,2023-08-12,01:17,0,1,1
67,2023-08-12T01:22:00+10:00,2023-08-12,01:22,3,3,6
79,2023-08-12T01:12:00+10:00,2023-08-12,01:12,9,3,12
79,2023-08-12T01:15:00+10:00,2023-08-12,01:15,1,0,1
79,2023-08-12T01:17:00+10:00,2023-08-12,01:17,3,4,7
79,2023-08-12T01:18:00+10:00,2023-08-12,01:18,0,2,2
79,2023-08-12T01:19:00+10:00,2023-08-12,01:19,3,0,3
79,2023-08-12T01:22:00+10:00,2023-08-12,01:22,2,1,3
85,2023-08-12T01:18:00+10:00,2023-08-12,01:18,1,0,1
109,2023-08-12T01:15:00+10:00,2023-08-12,01:15,1,0,1
117,2023-08-12T01:10:00+10:00,2023-08-12,01:10,1,1,2
117,2023-08-12T01:15:00+10:00,2023-08-12,01:15,7,2,9
122,2023-08-12T01:23:00+10:00,2023-08-12,01:23,1,0,1
3,2023-08-11T23:11:00+10:00,2023-08-11,23:11,35,15,50
3,2023-08-11T23:14:00+10:00,2023-08-11,23:14,17,14,31
3,2023-08-11T23:17:00+10:00,2023-08-11,23:17,25,7,32
3,2023-08-11T23:22:00+10:00,2023-08-11,23:22,10,25,35
4,2023-08-11T23:12:00+10:00,2023-08-11,23:12,20,3,23
4,2023-08-11T23:15:00+10:00,2023-08-11,23:15,29,2,31
4,2023-08-11T23:16:00+10:00,2023-08-11,23:16,25,20,45
4,2023-08-11T23:17:00+10:00,2023-08-11,23:17,14,15,29
4,2023-08-11T23:24:00+10:00,2023-08-11,23:24,14,13,27
6,2023-08-11T23:10:00+10:00,2023-08-11,23:10,7,17,24
6,2023-08-11T23:15:00+10:00,2023-08-11,23:15,2,16,18
6,2023-08-11T23:17:00+10:00,2023-08-11,23:17,7,16,23
6,2023-08-11T23:18:00+10:00,2023-08-11,23:18,11,9,20
6,2023-08-11T23:20:00+10:00,2023-08-11,23:20,8,23,31
6,2023-08-11T23:23:00+10:00,2023-08-11,23:23,19,14,33
8,2023-08-11T23:11:00+10:00,2023-08-11,23:11,0,2,2
14,2023-08-11T23:13:00+10:00,2023-08-11,23:13,8,8,16
14,2023-08-11T23:18:00+10:00,2023-08-11,23:18,6,13,19
21,2023-08-11T23:14:00+10:00,2023-08-11,23:14,14,4,18
21,2023-08-11T23:21:00+10:00,2023-08-11,23:21,8,3,11
28,2023-08-11T23:10:00+10:00,2023-08-11,23:10,18,3,21
28,2023-08-11T23:12:00+10:00,2023-08-11,23:12,12,3,15
28,2023-08-11T23:14:00+10:00,2023-08-11,23:14,25,3,28
28,2023-08-11T23:15:00+10:00,2023-08-11,23:15,13,2,15
28,2023-08-11T23:17:00+10:00,2023-08-11,23:17,19,2,21
28,2023-08-11T23:18:00+10:00,2023-08-11,23:18,2,0,2
28,2023-08-11T23:23:00+10:00,2023-08-11,23:23,6,3,9
29,2023-08-11T23:11:00+10:00,2023-08-11,23:11,4,26,30
29,2023-08-11T23:15:00+10:00,2023-08-11,23:15,4,28,32
29,2023-08-11T23:16:00+10:00,2023-08-11,23:16,0,23,23
29,2023-08-11T23:22:00+10:00,2023-08-11,23:22,0,3,3
39,2023-08-11T23:15:00+10:00,2023-08-11,23:15,4,0,4
39,2023-08-11T23:18:00+10:00,2023-08-11,23:18,0,2,2
41,2023-08-11T23:11:00+10:00,2023-08-11,23:11,41,5,46
41,2023-08-11T23:12:00+10:00,2023-08-11,23:12,43,13,56
41,2023-08-11T23:14:00+10:00,2023-08-11,23:14,29,22,51
41,2023-08-11T23:15:00+10:00,2023-08-11,23:15,27,17,44
41,2023-08-11T23:18:00+10:00,2023-08-11,23:18,19,12,31
41,2023-08-11T23:19:00+10:00,2023-08-11,23:19,46,12,58
41,2023-08-11T23:20:00+10:00,2023-08-11,23:20,23,21,44
54,2023-08-11T23:10:00+10:00,2023-08-11,23:10,0,6,6
54,2023-08-11T23:11:00+10:00,2023-08-11,23:11,2,0,2
54,2023-08-11T23:14:00+10:00,2023-08-11,23:14,1,0,1
54,2023-08-11T23:20:00+10:00,2023-08-11,23:20,4,2,6
54,2023-08-11T23:23:00+10:00,2023-08-11,23:23,2,0,2
54,2023-08-11T23:24:00+10:00,2023-08-11,23:24,0,1,1
55,2023-08-11T23:10:00+10:00,2023-08-11,23:10,10,6,16
55,2023-08-11T23:14:00+10:00,2023-08-11,23:14,14,7,21
55,2023-08-11T23:15:00+10:00,2023-08-11,23:15,21,12,33
55,2023-08-11T23:22:00+10:00,2023-08-11,23:22,6,12,18
59,2023-08-11T23:10:00+10:00,2023-08-11,23:10,26,19,45
61,2023-08-11T23:10:00+10:00,2023-08-11,23:10,3,0,3
61,2023-08-11T23:11:00+10:00,2023-08-11,23:11,2,5,7
61,2023-08-11T23:19:00+10:00,2023-08-11,23:19,2,2,4
61,2023-08-11T23:20:00+10:00,2023-08-11,23:20,10,0,10
65,2023-08-11T23:13:00+10:00,2023-08-11,23:13,7,10,17
65,2023-08-11T23:14:00+10:00,2023-08-11,23:14,2,9,11
65,2023-08-11T23:15:00+10:00,2023-08-11,23:15,7,13,20
65,2023-08-11T23:17:00+10:00,2023-08-11,23:17,3,7,10
65,2023-08-11T23:18:00+10:00,2023-08-11,23:18,15,14,29
65,2023-08-11T23:20:00+10:00,2023-08-11,23:20,9,12,21
65,2023-08-11T23:22:00+10:00,2023-08-11,23:22,2,0,2
66,2023-08-11T23:13:00+10:00,2023-08-11,23:13,15,0,15
66,2023-08-11T23:14:00+10:00,2023-08-11,23:14,10,23,33
66,2023-08-11T23:23:00+10:00,2023-08-11,23:23,15,4,19
70,2023-08-11T23:10:00+10:00,2023-08-11,23:10,1,0,1
70,2023-08-11T23:12:00+10:00,2023-08-11,23:12,1,2,3
70,2023-08-11T23:19:00+10:00,2023-08-11,23:19,0,5,5
75,2023-08-11T23:16:00+10:00,2023-08-11,23:16,1,1,2
75,2023-08-11T23:22:00+10:00,2023-08-11,23:22,4,0,4
75,2023-08-11T23:24:00+10:00,2023-08-11,23:24,3,0,3
77,2023-08-11T23:15:00+10:00,2023-08-11,23:15,0,2,2
77,2023-08-11T23:20:00+10:00,2023-08-11,23:20,1,0,1
78,2023-08-11T23:15:00+10:00,2023-08-11,23:15,0,2,2
84,2023-08-11T23:10:00+10:00,2023-08-11,23:10,78,51,129
84,2023-08-11T23:20:00+10:00,2023-08-11,23:20,65,61,126
87,2023-08-11T23:15:00+10:00,2023-08-11,23:15,3,0,3
87,2023-08-11T23:18:00+10:00,2023-08-11,23:18,2,0,2
107,2023-08-11T23:10:00+10:00,2023-08-11,23:10,1,9,10
108,2023-08-11T23:11:00+10:00,2023-08-11,23:11,0,2,2
108,2023-08-11T23:12:00+10:00,2023-08-11,23:12,1,0,1
108,2023-08-11T23:20:00+10:00,2023-08-11,23:20,1,4,5
118,2023-08-11T23:20:00+10:00,2023-08-11,23:20,5,0,5
1,2023-08-11T23:11:00+10:00,2023-08-11,23:11,2,4,6
1,2023-08-11T23:12:00+10:00,2023-08-11,23:12,4,8,12
1,2023-08-11T23:13:00+10:00,2023-08-11,23:13,3,4,7
1,2023-08-11T23:18:00+10:00,2023-08-11,23:18,1,5,6
1,2023-08-11T23:19:00+10:00,2023-08-11,23:19,0,7,7
1,2023-08-11T23:20:00+10:00,2023-08-11,23:20,1,3,4
1,2023-08-11T23:22:00+10:00,2023-08-11,23:22,4,5,9
2,2023-08-11T23:12:00+10:00,2023-08-11,23:12,2,1,3
2,2023-08-11T23:16:00+10:00,2023-08-11,23:16,0,1,1
7,2023-08-11T23:12:00+10:00,2023-08-11,23:12,2,46,48
7,2023-08-11T23:14:00+10:00,2023-08-11,23:14,3,59,62
7,2023-08-11T23:17:00+10:00,2023-08-11,23:17,1,49,50
7,2023-08-11T23:19:00+10:00,2023-08-11,23:19,0,5,5
7,2023-08-11T23:22:00+10:00,2023-08-11,23:22,0,19,19
7,2023-08-11T23:23:00+10:00,2023-08-11,23:23,0,11,11
9,2023-08-11T23:20:00+10:00,2023-08-11,23:20,0,5,5
9,2023-08-11T23:24:00+10:00,2023-08-11,23:24,0,2,2
10,2023-08-11T23:15:00+10:00,2023-08-11,23:15,0,1,1
10,2023-08-11T23:16:00+10:00,2023-08-11,23:16,1,1,2
11,2023-08-11T23:10:00+10:00,2023-08-11,23:10,5,1,6
12,2023-08-11T23:11:00+10:00,2023-08-11,23:11,0,5,5
12,2023-08-11T23:23:00+10:00,2023-08-11,23:23,5,1,6
17,2023-08-11T23:15:00+10:00,2023-08-11,23:15,2,4,6
17,2023-08-11T23:17:00+10:00,2023-08-11,23:17,0,3,3
17,2023-08-11T23:24:00+10:00,2023-08-11,23:24,3,1,4
18,2023-08-11T23:10:00+10:00,2023-08-11,23:10,0,1,1
18,2023-08-11T23:13:00+10:00,2023-08-11,23:13,0,1,1
18,2023-08-11T23:23:00+10:00,2023-08-11,23:23,1,0,1
24,2023-08-11T23:13:00+10:00,2023-08-11,23:13,5,4,9
24,2023-08-11T23:16:00+10:00,2023-08-11,23:16,13,3,16
24,2023-08-11T23:21:00+10:00,2023-08-11,23:21,3,8,11
24,2023-08-11T23:24:00+10:00,2023-08-11,23:24,7,10,17
27,2023-08-11T23:13:00+10:00,2023-08-11,23:13,0,1,1
27,2023-08-11T23:14:00+10:00,2023-08-11,23:14,3,0,3
27,2023-08-11T23:17:00+10:00,2023-08-11,23:17,4,0,4
27,2023-08-11T23:18:00+10:00,2023-08-11,23:18,1,0,1
27,2023-08-11T23:21:00+10:00,2023-08-11,23:21,4,1,5
35,2023-08-11T23:13:00+10:00,2023-08-11,23:13,4,58,62
35,2023-08-11T23:16:00+10:00,2023-08-11,23:16,5,45,50
35,2023-08-11T23:18:00+10:00,2023-08-11,23:18,21,48,69
53,2023-08-11T23:11:00+10:00,2023-08-11,23:11,0,10,10
53,2023-08-11T23:13:00+10:00,2023-08-11,23:13,2,4,6
53,2023-08-11T23:17:00+10:00,2023-08-11,23:17,1,6,7
53,2023-08-11T23:18:00+10:00,2023-08-11,23:18,2,6,8
53,2023-08-11T23:24:00+10:00,2023-08-11,23:24,0,3,3
56,2023-08-11T23:11:00+10:00,2023-08-11,23:11,0,4,4
56,2023-08-11T23:14:00+10:00,2023-08-11,23:14,4,2,6
56,2023-08-11T23:19:00+10:00,2023-08-11,23:19,7,2,9
57,2023-08-11T23:13:00+10:00,2023-08-11,23:13,0,2,2
57,2023-08-11T23:15:00+10:00,2023-08-11,23:15,2,0,2
58,2023-08-11T23:12:00+10:00,2023-08-11,23:12,8,6,14
58,2023-08-11T23:21:00+10:00,2023-08-11,23:21,8,4,12
62,2023-08-11T23:14:00+10:00,2023-08-11,23:14,1,0,1
62,2023-08-11T23:17:00+10:00,2023-08-11,23:17,3,0,3
62,2023-08-11T23:18:00+10:00,2023-08-11,23:18,0,1,1
62,2023-08-11T23:20:00+10:00,2023-08-11,23:20,0,1,1
62,2023-08-11T23:21:00+10:00,2023-08-11,23:21,7,4,11
63,2023-08-11T23:10:00+10:00,2023-08-11,23:10,1,12,13
63,2023-08-11T23:16:00+10:00,2023-08-11,23:16,1,12,13
63,2023-08-11T23:23:00+10:00,2023-08-11,23:23,2,12,14
63,2023-08-11T23:24:00+10:00,2023-08-11,23:24,2,4,6
67,2023-08-11T23:10:00+10:00,2023-08-11,23:10,4,15,19
67,2023-08-11T23:16:00+10:00,2023-08-11,23:16,1,9,10
67,2023-08-11T23:18:00+10:00,2023-08-11,23:18,8,8,16
67,2023-08-11T23:20:00+10:00,2023-08-11,23:20,1,7,8
67,2023-08-11T23:24:00+10:00,2023-08-11,23:24,0,9,9
68,2023-08-11T23:14:00+10:00,2023-08-11,23:14,1,0,1
68,2023-08-11T23:19:00+10:00,2023-08-11,23:19,1,0,1
68,2023-08-11T23:20:00+10:00,2023-08-11,23:20,0,1,1
72,2023-08-11T23:10:00+10:00,2023-08-11,23:10,11,44,55
72,2023-08-11T23:16:00+10:00,2023-08-11,23:16,19,15,34
72,2023-08-11T23:22:00+10:00,2023-08-11,23:22,0,5,5
72,2023-08-11T23:23:00+10:00,2023-08-11,23:23,12,15,27
79,2023-08-11T23:11:00+10:00,2023-08-11,23:11,2,42,44
79,2023-08-11T23:12:00+10:00,2023-08-11,23:12,1,42,43
79,2023-08-11T23:15:00+10:00,2023-08-11,23:15,4,34,38
79,2023-08-11T23:18:00+10:00,2023-08-11,23:18,4,34,38
85,2023-08-11T23:12:00+10:00,2023-08-11,23:12,1,0,1
109,2023-08-11T23:15:00+10:00,2023-08-11,23:15,9,5,14
117,2023-08-11T23:10:00+10:00,2023-08-11,23:10,28,204,232
3,2023-08-12T01:27:00+10:00,2023-08-12,01:27,0,6,6
3,2023-08-12T01:28:00+10:00,2023-08-12,01:28,9,3,12
3,2023-08-12T01:30:00+10:00,2023-08-12,01:30,3,11,14
3,2023-08-12T01:33:00+10:00,2023-08-12,01:33,5,7,12
3,2023-08-12T01:39:00+10:00,2023-08-12,01:39,1,9,10
4,2023-08-12T01:25:00+10:00,2023-08-12,01:25,3,3,6
4,2023-08-12T01:30:00+10:00,2023-08-12,01:30,5,3,8
4,2023-08-12T01:31:00+10:00,2023-08-12,01:31,6,0,6
4,2023-08-12T01:33:00+10:00,2023-08-12,01:33,6,2,8
6,2023-08-12T01:26:00+10:00,2023-08-12,01:26,1,1,2
6,2023-08-12T01:27:00+10:00,2023-08-12,01:27,6,2,8
6,2023-08-12T01:28:00+10:00,2023-08-12,01:28,4,0,4
6,2023-08-12T01:30:00+10:00,2023-08-12,01:30,3,2,5
6,2023-08-12T01:35:00+10:00,2023-08-12,01:35,1,1,2
6,2023-08-12T01:39:00+10:00,2023-08-12,01:39,3,2,5
8,2023-08-12T01:30:00+10:00,2023-08-12,01:30,1,0,1
8,2023-08-12T01:39:00+10:00,2023-08-12,01:39,1,0,1
14,2023-08-12T01:25:00+10:00,2023-08-12,01:25,5,0,5
14,2023-08-12T01:32:00+10:00,2023-08-12,01:32,1,1,2
14,2023-08-12T01:35:00+10:00,2023-08-12,01:35,0,1,1
14,2023-08-12T01:37:00+10:00,2023-08-12,01:37,1,2,3
14,2023-08-12T01:39:00+10:00,2023-08-12,01:39,1,0,1
21,2023-08-12T01:25:00+10:00,2023-08-12,01:25,3,5,8
21,2023-08-12T01:32:00+10:00,2023-08-12,01:32,3,3,6
21,2023-08-12T01:33:00+10:00,2023-08-12,01:33,0,3,3
21,2023-08-12T01:37:00+10:00,2023-08-12,01:37,5,0,5
28,2023-08-12T01:28:00+10:00,2023-08-12,01:28,1,0,1
28,2023-08-12T01:33:00+10:00,2023-08-12,01:33,1,0,1
28,2023-08-12T01:34:00+10:00,2023-08-12,01:34,0,1,1
28,2023-08-12T01:35:00+10:00,2023-08-12,01:35,3,0,3
28,2023-08-12T01:36:00+10:00,2023-08-12,01:36,3,0,3
29,2023-08-12T01:25:00+10:00,2023-08-12,01:25,2,1,3
29,2023-08-12T01:27:00+10:00,2023-08-12,01:27,0,1,1
41,2023-08-12T01:26:00+10:00,2023-08-12,01:26,3,1,4
41,2023-08-12T01:28:00+10:00,2023-08-12,01:28,5,6,11
41,2023-08-12T01:30:00+10:00,2023-08-12,01:30,17,1,18
41,2023-08-12T01:37:00+10:00,2023-08-12,01:37,4,6,10
54,2023-08-12T01:31:00+10:00,2023-08-12,01:31,0,1,1
55,2023-08-12T01:27:00+10:00,2023-08-12,01:27,4,3,7
55,2023-08-12T01:29:00+10:00,2023-08-12,01:29,4,2,6
55,2023-08-12T01:30:00+10:00,2023-08-12,01:30,12,1,13
55,2023-08-12T01:31:00+10:00,2023-08-12,01:31,2,0,2
55,2023-08-12T01:33:00+10:00,2023-08-12,01:33,3,3,6
55,2023-08-12T01:34:00+10:00,2023-08-12,01:34,1,7,8
55,2023-08-12T01:35:00+10:00,2023-08-12,01:35,3,3,6
55,2023-08-12T01:37:00+10:00,2023-08-12,01:37,2,8,10
59,2023-08-12T01:35:00+10:00,2023-08-12,01:35,6,0,6
61,2023-08-12T01:25:00+10:00,2023-08-12,01:25,0,1,1
61,2023-08-12T01:27:00+10:00,2023-08-12,01:27,4,0,4
61,2023-08-12T01:28:00+10:00,2023-08-12,01:28,2,0,2
61,2023-08-12T01:31:00+10:00,2023-08-12,01:31,0,1,1
61,2023-08-12T01:37:00+10:00,2023-08-12,01:37,5,0,5
65,2023-08-12T01:27:00+10:00,2023-08-12,01:27,1,1,2
65,2023-08-12T01:30:00+10:00,2023-08-12,01:30,0,2,2
65,2023-08-12T01:31:00+10:00,2023-08-12,01:31,3,7,10
65,2023-08-12T01:32:00+10:00,2023-08-12,01:32,1,0,1
65,2023-08-12T01:34:00+10:00,2023-08-12,01:34,0,1,1
66,2023-08-12T01:31:00+10:00,2023-08-12,01:31,0,3,3
66,2023-08-12T01:34:00+10:00,2023-08-12,01:34,0,5,5
66,2023-08-12T01:35:00+10:00,2023-08-12,01:35,11,4,15
66,2023-08-12T01:36:00+10:00,2023-08-12,01:36,2,2,4
66,2023-08-12T01:39:00+10:00,2023-08-12,01:39,0,1,1
78,2023-08-12T01:38:00+10:00,2023-08-12,01:38,0,1,1
84,2023-08-12T01:25:00+10:00,2023-08-12,01:25,16,13,29
84,2023-08-12T01:30:00+10:00,2023-08-12,01:30,15,15,30
107,2023-08-12T01:30:00+10:00,2023-08-12,01:30,3,1,4
108,2023-08-12T01:30:00+10:00,2023-08-12,01:30,0,1,1
108,2023-08-12T01:32:00+10:00,2023-08-12,01:32,1,0,1
118,2023-08-12T01:25:00+10:00,2023-08-12,01:25,2,0,2
1,2023-08-12T01:26:00+10:00,2023-08-12,01:26,0,5,5
1,2023-08-12T01:33:00+10:00,2023-08-12,01:33,3,0,3
1,2023-08-12T01:36:00+10:00,2023-08-12,01:36,0,3,3
2,2023-08-12T01:33:00+10:00,2023-08-12,01:33,0,1,1
7,2023-08-12T01:34:00+10:00,2023-08-12,01:34,0,1,1
10,2023-08-12T01:31:00+10:00,2023-08-12,01:31,1,1,2
17,2023-08-12T01:30:00+10:00,2023-08-12,01:30,1,0,1
17,2023-08-12T01:38:00+10:00,2023-08-12,01:38,2,0,2
24,2023-08-12T01:36:00+10:00,2023-08-12,01:36,1,10,11
24,2023-08-12T01:37:00+10:00,2023-08-12,01:37,0,1,1
24,2023-08-12T01:38:00+10:00,2023-08-12,01:38,1,2,3
27,2023-08-12T01:25:00+10:00,2023-08-12,01:25,0,1,1
27,2023-08-12T01:27:00+10:00,2023-08-12,01:27,2,0,2
27,2023-08-12T01:28:00+10:00,2023-08-12,01:28,0,1,1
27,2023-08-12T01:37:00+10:00,2023-08-12,01:37,0,3,3
35,2023-08-12T01:25:00+10:00,2023-08-12,01:25,5,3,8
35,2023-08-12T01:26:00+10:00,2023-08-12,01:26,0,5,5
35,2023-08-12T01:29:00+10:00,2023-08-12,01:29,5,5,10
35,2023-08-12T01:31:00+10:00,2023-08-12,01:31,3,1,4
35,2023-08-12T01:37:00+10:00,2023-08-12,01:37,0,4,4
53,2023-08-12T01:36:00+10:00,2023-08-12,01:36,3,0,3
56,2023-08-12T01:28:00+10:00,2023-08-12,01:28,0,1,1
57,2023-08-12T01:39:00+10:00,2023-08-12,01:39,2,0,2
58,2023-08-12T01:25:00+10:00,2023-08-12,01:25,0,6,6
58,2023-08-12T01:29:00+10:00,2023-08-12,01:29,1,1,2
62,2023-08-12T01:26:00+10:00,2023-08-12,01:26,4,2,6
62,2023-08-12T01:27:00+10:00,2023-08-12,01:27,2,0,2
62,2023-08-12T01:36:00+10:00,2023-08-12,01:36,2,0,2
63,2023-08-12T01:26:00+10:00,2023-08-12,01:26,1,1,2
63,2023-08-12T01:28:00+10:00,2023-08-12,01:28,1,1,2
63,2023-08-12T01:36:00+10:00,2023-08-12,01:36,1,0,1
63,2023-08-12T01:38:00+10:00,2023-08-12,01:38,6,0,6
63,2023-08-12T01:39:00+10:00,2023-08-12,01:39,0,3,3
67,2023-08-12T01:31:00+10:00,2023-08-12,01:31,3,4,7
67,2023-08-12T01:34:00+10:00,2023-08-12,01:34,0,2,2
72,2023-08-12T01:31:00+10:00,2023-08-12,01:31,0,1,1
72,2023-08-12T01:32:00+10:00,2023-08-12,01:32,3,0,3
72,2023-08-12T01:39:00+10:00,2023-08-12,01:39,2,0,2
79,2023-08-12T01:25:00+10:00,2023-08-12,01:25,0,1,1
79,2023-08-12T01:26:00+10:00,2023-08-12,01:26,0,10,10
79,2023-08-12T01:28:00+10:00,2023-08-12,01:28,0,2,2
3,2023-08-11T23:28:00+10:00,2023-08-11,23:28,13,11,24
79,2023-08-12T01:32:00+10:00,2023-08-12,01:32,2,5,7
3,2023-08-11T23:29:00+10:00,2023-08-11,23:29,5,9,14
79,2023-08-12T01:33:00+10:00,2023-08-12,01:33,7,1,8
3,2023-08-11T23:31:00+10:00,2023-08-11,23:31,4,7,11
79,2023-08-12T01:37:00+10:00,2023-08-12,01:37,4,7,11
3,2023-08-11T23:33:00+10:00,2023-08-11,23:33,26,11,37
79,2023-08-12T01:39:00+10:00,2023-08-12,01:39,4,3,7
3,2023-08-11T23:36:00+10:00,2023-08-11,23:36,11,8,19
86,2023-08-12T01:29:00+10:00,2023-08-12,01:29,0,1,1
3,2023-08-11T23:37:00+10:00,2023-08-11,23:37,3,2,5
109,2023-08-12T01:25:00+10:00,2023-08-12,01:25,0,1,1
4,2023-08-11T23:25:00+10:00,2023-08-11,23:25,11,29,40
117,2023-08-12T01:25:00+10:00,2023-08-12,01:25,7,1,8
4,2023-08-11T23:26:00+10:00,2023-08-11,23:26,29,14,43
122,2023-08-12T01:26:00+10:00,2023-08-12,01:26,0,3,3
4,2023-08-11T23:28:00+10:00,2023-08-11,23:28,3,9,12
122,2023-08-12T01:27:00+10:00,2023-08-12,01:27,1,0,1
4,2023-08-11T23:32:00+10:00,2023-08-11,23:32,14,13,27
122,2023-08-12T01:34:00+10:00,2023-08-12,01:34,2,2,4
4,2023-08-11T23:33:00+10:00,2023-08-11,23:33,8,10,18
4,2023-08-11T23:34:00+10:00,2023-08-11,23:34,16,13,29
4,2023-08-11T23:39:00+10:00,2023-08-11,23:39,4,16,20
6,2023-08-11T23:29:00+10:00,2023-08-11,23:29,3,12,15
6,2023-08-11T23:38:00+10:00,2023-08-11,23:38,7,4,11
8,2023-08-11T23:25:00+10:00,2023-08-11,23:25,1,0,1
8,2023-08-11T23:29:00+10:00,2023-08-11,23:29,1,0,1
8,2023-08-11T23:32:00+10:00,2023-08-11,23:32,0,2,2
8,2023-08-11T23:37:00+10:00,2023-08-11,23:37,0,1,1
14,2023-08-11T23:26:00+10:00,2023-08-11,23:26,1,10,11
14,2023-08-11T23:28:00+10:00,2023-08-11,23:28,9,5,14
14,2023-08-11T23:37:00+10:00,2023-08-11,23:37,14,0,14
14,2023-08-11T23:38:00+10:00,2023-08-11,23:38,3,1,4
21,2023-08-11T23:25:00+10:00,2023-08-11,23:25,16,10,26
21,2023-08-11T23:35:00+10:00,2023-08-11,23:35,12,9,21
21,2023-08-11T23:36:00+10:00,2023-08-11,23:36,5,7,12
21,2023-08-11T23:37:00+10:00,2023-08-11,23:37,7,0,7
28,2023-08-11T23:26:00+10:00,2023-08-11,23:26,4,1,5
29,2023-08-11T23:29:00+10:00,2023-08-11,23:29,0,3,3
29,2023-08-11T23:32:00+10:00,2023-08-11,23:32,0,8,8
29,2023-08-11T23:34:00+10:00,2023-08-11,23:34,2,0,2
29,2023-08-11T23:37:00+10:00,2023-08-11,23:37,0,3,3
29,2023-08-11T23:39:00+10:00,2023-08-11,23:39,0,1,1
39,2023-08-11T23:27:00+10:00,2023-08-11,23:27,0,2,2
39,2023-08-11T23:34:00+10:00,2023-08-11,23:34,0,2,2
39,2023-08-11T23:38:00+10:00,2023-08-11,23:38,0,1,1
39,2023-08-11T23:39:00+10:00,2023-08-11,23:39,1,1,2
41,2023-08-11T23:35:00+10:00,2023-08-11,23:35,8,12,20
41,2023-08-11T23:37:00+10:00,2023-08-11,23:37,16,15,31
54,2023-08-11T23:32:00+10:00,2023-08-11,23:32,0,2,2
54,2023-08-11T23:36:00+10:00,2023-08-11,23:36,1,6,7
54,2023-08-11T23:37:00+10:00,2023-08-11,23:37,0,2,2
54,2023-08-11T23:38:00+10:00,2023-08-11,23:38,0,2,2
55,2023-08-11T23:30:00+10:00,2023-08-11,23:30,12,5,17
55,2023-08-11T23:34:00+10:00,2023-08-11,23:34,7,14,21
55,2023-08-11T23:35:00+10:00,2023-08-11,23:35,6,10,16
55,2023-08-11T23:36:00+10:00,2023-08-11,23:36,13,6,19
59,2023-08-11T23:25:00+10:00,2023-08-11,23:25,29,7,36
59,2023-08-11T23:35:00+10:00,2023-08-11,23:35,23,13,36
61,2023-08-11T23:27:00+10:00,2023-08-11,23:27,2,3,5
61,2023-08-11T23:31:00+10:00,2023-08-11,23:31,0,1,1
61,2023-08-11T23:33:00+10:00,2023-08-11,23:33,3,0,3
65,2023-08-11T23:25:00+10:00,2023-08-11,23:25,0,13,13
65,2023-08-11T23:28:00+10:00,2023-08-11,23:28,0,3,3
65,2023-08-11T23:34:00+10:00,2023-08-11,23:34,5,9,14
66,2023-08-11T23:26:00+10:00,2023-08-11,23:26,7,12,19
66,2023-08-11T23:29:00+10:00,2023-08-11,23:29,19,8,27
66,2023-08-11T23:30:00+10:00,2023-08-11,23:30,3,2,5
66,2023-08-11T23:31:00+10:00,2023-08-11,23:31,6,3,9
66,2023-08-11T23:33:00+10:00,2023-08-11,23:33,1,3,4
69,2023-08-11T23:28:00+10:00,2023-08-11,23:28,3,0,3
75,2023-08-11T23:25:00+10:00,2023-08-11,23:25,1,1,2
75,2023-08-11T23:39:00+10:00,2023-08-11,23:39,1,0,1
77,2023-08-11T23:27:00+10:00,2023-08-11,23:27,3,0,3
84,2023-08-11T23:25:00+10:00,2023-08-11,23:25,62,78,140
84,2023-08-11T23:30:00+10:00,2023-08-11,23:30,47,53,100
87,2023-08-11T23:29:00+10:00,2023-08-11,23:29,0,1,1
87,2023-08-11T23:31:00+10:00,2023-08-11,23:31,1,0,1
87,2023-08-11T23:33:00+10:00,2023-08-11,23:33,0,3,3
87,2023-08-11T23:38:00+10:00,2023-08-11,23:38,0,1,1
107,2023-08-11T23:35:00+10:00,2023-08-11,23:35,6,1,7
108,2023-08-11T23:26:00+10:00,2023-08-11,23:26,1,1,2
108,2023-08-11T23:28:00+10:00,2023-08-11,23:28,5,0,5
108,2023-08-11T23:31:00+10:00,2023-08-11,23:31,5,1,6
108,2023-08-11T23:32:00+10:00,2023-08-11,23:32,3,6,9
108,2023-08-11T23:34:00+10:00,2023-08-11,23:34,6,0,6
108,2023-08-11T23:37:00+10:00,2023-08-11,23:37,1,2,3
108,2023-08-11T23:38:00+10:00,2023-08-11,23:38,1,1,2
1,2023-08-11T23:27:00+10:00,2023-08-11,23:27,0,6,6
1,2023-08-11T23:28:00+10:00,2023-08-11,23:28,3,1,4
1,2023-08-11T23:30:00+10:00,2023-08-11,23:30,1,0,1
1,2023-08-11T23:36:00+10:00,2023-08-11,23:36,12,0,12
1,2023-08-11T23:38:00+10:00,2023-08-11,23:38,4,0,4
2,2023-08-11T23:28:00+10:00,2023-08-11,23:28,1,4,5
2,2023-08-11T23:31:00+10:00,2023-08-11,23:31,0,3,3
2,2023-08-11T23:33:00+10:00,2023-08-11,23:33,2,0,2
2,2023-08-11T23:35:00+10:00,2023-08-11,23:35,0,3,3
2,2023-08-11T23:36:00+10:00,2023-08-11,23:36,0,1,1
2,2023-08-11T23:39:00+10:00,2023-08-11,23:39,0,2,2
7,2023-08-11T23:27:00+10:00,2023-08-11,23:27,0,12,12
7,2023-08-11T23:34:00+10:00,2023-08-11,23:34,0,8,8
7,2023-08-11T23:36:00+10:00,2023-08-11,23:36,3,11,14
7,2023-08-11T23:37:00+10:00,2023-08-11,23:37,5,8,13
9,2023-08-11T23:26:00+10:00,2023-08-11,23:26,2,1,3
9,2023-08-11T23:33:00+10:00,2023-08-11,23:33,0,3,3
9,2023-08-11T23:39:00+10:00,2023-08-11,23:39,0,1,1
10,2023-08-11T23:39:00+10:00,2023-08-11,23:39,0,2,2
12,2023-08-11T23:31:00+10:00,2023-08-11,23:31,0,1,1
17,2023-08-11T23:25:00+10:00,2023-08-11,23:25,0,3,3
17,2023-08-11T23:29:00+10:00,2023-08-11,23:29,0,2,2
17,2023-08-11T23:30:00+10:00,2023-08-11,23:30,2,4,6
17,2023-08-11T23:32:00+10:00,2023-08-11,23:32,0,4,4
17,2023-08-11T23:36:00+10:00,2023-08-11,23:36,1,1,2
17,2023-08-11T23:38:00+10:00,2023-08-11,23:38,4,0,4
17,2023-08-11T23:39:00+10:00,2023-08-11,23:39,1,1,2
18,2023-08-11T23:39:00+10:00,2023-08-11,23:39,0,1,1
24,2023-08-11T23:28:00+10:00,2023-08-11,23:28,3,6,9
24,2023-08-11T23:31:00+10:00,2023-08-11,23:31,4,8,12
24,2023-08-11T23:32:00+10:00,2023-08-11,23:32,8,10,18
24,2023-08-11T23:34:00+10:00,2023-08-11,23:34,11,6,17
24,2023-08-11T23:35:00+10:00,2023-08-11,23:35,0,7,7
24,2023-08-11T23:36:00+10:00,2023-08-11,23:36,3,2,5
24,2023-08-11T23:39:00+10:00,2023-08-11,23:39,6,8,14
27,2023-08-11T23:27:00+10:00,2023-08-11,23:27,6,0,6
27,2023-08-11T23:32:00+10:00,2023-08-11,23:32,0,1,1
35,2023-08-11T23:27:00+10:00,2023-08-11,23:27,3,33,36
35,2023-08-11T23:28:00+10:00,2023-08-11,23:28,7,21,28
35,2023-08-11T23:32:00+10:00,2023-08-11,23:32,8,23,31
35,2023-08-11T23:33:00+10:00,2023-08-11,23:33,3,18,21
35,2023-08-11T23:38:00+10:00,2023-08-11,23:38,11,11,22
53,2023-08-11T23:25:00+10:00,2023-08-11,23:25,0,23,23
53,2023-08-11T23:30:00+10:00,2023-08-11,23:30,3,1,4
53,2023-08-11T23:31:00+10:00,2023-08-11,23:31,0,7,7
53,2023-08-11T23:33:00+10:00,2023-08-11,23:33,1,0,1
53,2023-08-11T23:35:00+10:00,2023-08-11,23:35,4,3,7
53,2023-08-11T23:37:00+10:00,2023-08-11,23:37,0,1,1
53,2023-08-11T23:39:00+10:00,2023-08-11,23:39,2,1,3
56,2023-08-11T23:27:00+10:00,2023-08-11,23:27,8,3,11
56,2023-08-11T23:38:00+10:00,2023-08-11,23:38,1,5,6
57,2023-08-11T23:26:00+10:00,2023-08-11,23:26,1,1,2
58,2023-08-11T23:32:00+10:00,2023-08-11,23:32,8,1,9
58,2023-08-11T23:33:00+10:00,2023-08-11,23:33,4,1,5
58,2023-08-11T23:34:00+10:00,2023-08-11,23:34,1,0,1
3,2023-08-12T01:40:00+10:00,2023-08-12,01:40,5,0,5
58,2023-08-11T23:38:00+10:00,2023-08-11,23:38,4,2,6
3,2023-08-12T01:43:00+10:00,2023-08-12,01:43,3,3,6
58,2023-08-11T23:39:00+10:00,2023-08-11,23:39,0,9,9
3,2023-08-12T01:44:00+10:00,2023-08-12,01:44,0,3,3
62,2023-08-11T23:27:00+10:00,2023-08-11,23:27,2,0,2
3,2023-08-12T01:45:00+10:00,2023-08-12,01:45,7,4,11
62,2023-08-11T23:30:00+10:00,2023-08-11,23:30,1,2,3
3,2023-08-12T01:47:00+10:00,2023-08-12,01:47,3,1,4
62,2023-08-11T23:32:00+10:00,2023-08-11,23:32,6,0,6
4,2023-08-12T01:40:00+10:00,2023-08-12,01:40,0,1,1
62,2023-08-11T23:33:00+10:00,2023-08-11,23:33,1,0,1
4,2023-08-12T01:50:00+10:00,2023-08-12,01:50,1,0,1
62,2023-08-11T23:37:00+10:00,2023-08-11,23:37,2,3,5
4,2023-08-12T01:52:00+10:00,2023-08-12,01:52,2,0,2
63,2023-08-11T23:28:00+10:00,2023-08-11,23:28,5,3,8
4,2023-08-12T01:54:00+10:00,2023-08-12,01:54,0,4,4
63,2023-08-11T23:30:00+10:00,2023-08-11,23:30,1,7,8
6,2023-08-12T01:40:00+10:00,2023-08-12,01:40,2,8,10
63,2023-08-11T23:34:00+10:00,2023-08-11,23:34,3,3,6
6,2023-08-12T01:41:00+10:00,2023-08-12,01:41,2,2,4
63,2023-08-11T23:35:00+10:00,2023-08-11,23:35,2,7,9
6,2023-08-12T01:42:00+10:00,2023-08-12,01:42,5,3,8
63,2023-08-11T23:36:00+10:00,2023-08-11,23:36,2,1,3
6,2023-08-12T01:45:00+10:00,2023-08-12,01:45,2,1,3
63,2023-08-11T23:39:00+10:00,2023-08-11,23:39,6,7,13
6,2023-08-12T01:49:00+10:00,2023-08-12,01:49,1,2,3
67,2023-08-11T23:36:00+10:00,2023-08-11,23:36,1,7,8
6,2023-08-12T01:52:00+10:00,2023-08-12,01:52,1,1,2
68,2023-08-11T23:33:00+10:00,2023-08-11,23:33,1,0,1
6,2023-08-12T01:53:00+10:00,2023-08-12,01:53,7,1,8
68,2023-08-11T23:37:00+10:00,2023-08-11,23:37,1,0,1
8,2023-08-12T01:50:00+10:00,2023-08-12,01:50,0,1,1
72,2023-08-11T23:28:00+10:00,2023-08-11,23:28,0,11,11
14,2023-08-12T01:42:00+10:00,2023-08-12,01:42,1,1,2
72,2023-08-11T23:29:00+10:00,2023-08-11,23:29,0,4,4
14,2023-08-12T01:50:00+10:00,2023-08-12,01:50,1,0,1
72,2023-08-11T23:30:00+10:00,2023-08-11,23:30,1,4,5
14,2023-08-12T01:51:00+10:00,2023-08-12,01:51,4,0,4
72,2023-08-11T23:34:00+10:00,2023-08-11,23:34,0,6,6
14,2023-08-12T01:52:00+10:00,2023-08-12,01:52,2,1,3
79,2023-08-11T23:25:00+10:00,2023-08-11,23:25,2,22,24
21,2023-08-12T01:43:00+10:00,2023-08-12,01:43,3,2,5
79,2023-08-11T23:26:00+10:00,2023-08-11,23:26,8,22,30
21,2023-08-12T01:44:00+10:00,2023-08-12,01:44,2,4,6
79,2023-08-11T23:28:00+10:00,2023-08-11,23:28,10,10,20
21,2023-08-12T01:47:00+10:00,2023-08-12,01:47,2,0,2
79,2023-08-11T23:32:00+10:00,2023-08-11,23:32,1,11,12
21,2023-08-12T01:48:00+10:00,2023-08-12,01:48,0,1,1
79,2023-08-11T23:36:00+10:00,2023-08-11,23:36,4,16,20
21,2023-08-12T01:51:00+10:00,2023-08-12,01:51,3,1,4
85,2023-08-11T23:25:00+10:00,2023-08-11,23:25,0,2,2
28,2023-08-12T01:46:00+10:00,2023-08-12,01:46,2,2,4
85,2023-08-11T23:32:00+10:00,2023-08-11,23:32,0,4,4
39,2023-08-12T01:47:00+10:00,2023-08-12,01:47,2,1,3
85,2023-08-11T23:38:00+10:00,2023-08-11,23:38,0,3,3
39,2023-08-12T01:52:00+10:00,2023-08-12,01:52,0,1,1
86,2023-08-11T23:35:00+10:00,2023-08-11,23:35,0,1,1
39,2023-08-12T01:53:00+10:00,2023-08-12,01:53,0,1,1
109,2023-08-11T23:30:00+10:00,2023-08-11,23:30,8,9,17
41,2023-08-12T01:41:00+10:00,2023-08-12,01:41,5,6,11
122,2023-08-11T23:29:00+10:00,2023-08-11,23:29,1,0,1
41,2023-08-12T01:43:00+10:00,2023-08-12,01:43,0,4,4
122,2023-08-11T23:30:00+10:00,2023-08-11,23:30,1,0,1
41,2023-08-12T01:47:00+10:00,2023-08-12,01:47,3,8,11
122,2023-08-11T23:31:00+10:00,2023-08-11,23:31,0,1,1
41,2023-08-12T01:52:00+10:00,2023-08-12,01:52,6,3,9
122,2023-08-11T23:33:00+10:00,2023-08-11,23:33,1,0,1
54,2023-08-12T01:44:00+10:00,2023-08-12,01:44,2,0,2
54,2023-08-12T01:45:00+10:00,2023-08-12,01:45,1,0,1
54,2023-08-12T01:49:00+10:00,2023-08-12,01:49,0,2,2
55,2023-08-12T01:40:00+10:00,2023-08-12,01:40,0,7,7
55,2023-08-12T01:44:00+10:00,2023-08-12,01:44,8,6,14
55,2023-08-12T01:46:00+10:00,2023-08-12,01:46,4,0,4
55,2023-08-12T01:48:00+10:00,2023-08-12,01:48,3,4,7
55,2023-08-12T01:49:00+10:00,2023-08-12,01:49,2,6,8
55,2023-08-12T01:53:00+10:00,2023-08-12,01:53,2,3,5
59,2023-08-12T01:50:00+10:00,2023-08-12,01:50,5,0,5
61,2023-08-12T01:45:00+10:00,2023-08-12,01:45,0,2,2
61,2023-08-12T01:50:00+10:00,2023-08-12,01:50,1,0,1
65,2023-08-12T01:40:00+10:00,2023-08-12,01:40,1,1,2
65,2023-08-12T01:41:00+10:00,2023-08-12,01:41,3,0,3
65,2023-08-12T01:46:00+10:00,2023-08-12,01:46,0,1,1
65,2023-08-12T01:51:00+10:00,2023-08-12,01:51,1,2,3
65,2023-08-12T01:52:00+10:00,2023-08-12,01:52,0,1,1
107,2023-08-12T01:50:00+10:00,2023-08-12,01:50,2,2,4
108,2023-08-12T01:44:00+10:00,2023-08-12,01:44,0,5,5
108,2023-08-12T01:47:00+10:00,2023-08-12,01:47,2,2,4
108,2023-08-12T01:48:00+10:00,2023-08-12,01:48,0,2,2
108,2023-08-12T01:53:00+10:00,2023-08-12,01:53,0,2,2
1,2023-08-12T01:41:00+10:00,2023-08-12,01:41,2,0,2
1,2023-08-12T01:49:00+10:00,2023-08-12,01:49,0,2,2
1,2023-08-12T01:50:00+10:00,2023-08-12,01:50,1,0,1
1,2023-08-12T01:51:00+10:00,2023-08-12,01:51,1,1,2
1,2023-08-12T01:52:00+10:00,2023-08-12,01:52,0,4,4
1,2023-08-12T01:54:00+10:00,2023-08-12,01:54,0,3,3
2,2023-08-12T01:54:00+10:00,2023-08-12,01:54,0,1,1
7,2023-08-12T01:44:00+10:00,2023-08-12,01:44,3,0,3
9,2023-08-12T01:51:00+10:00,2023-08-12,01:51,0,1,1
9,2023-08-12T01:54:00+10:00,2023-08-12,01:54,0,1,1
12,2023-08-12T01:44:00+10:00,2023-08-12,01:44,2,0,2
12,2023-08-12T01:51:00+10:00,2023-08-12,01:51,3,0,3
17,2023-08-12T01:50:00+10:00,2023-08-12,01:50,0,1,1
24,2023-08-12T01:49:00+10:00,2023-08-12,01:49,2,1,3
24,2023-08-12T01:50:00+10:00,2023-08-12,01:50,0,4,4
27,2023-08-12T01:42:00+10:00,2023-08-12,01:42,1,0,1
35,2023-08-12T01:40:00+10:00,2023-08-12,01:40,4,1,5
35,2023-08-12T01:43:00+10:00,2023-08-12,01:43,2,6,8
35,2023-08-12T01:52:00+10:00,2023-08-12,01:52,0,3,3
35,2023-08-12T01:54:00+10:00,2023-08-12,01:54,3,1,4
53,2023-08-12T01:43:00+10:00,2023-08-12,01:43,1,0,1
53,2023-08-12T01:45:00+10:00,2023-08-12,01:45,0,1,1
53,2023-08-12T01:51:00+10:00,2023-08-12,01:51,0,1,1
53,2023-08-12T01:54:00+10:00,2023-08-12,01:54,0,2,2
57,2023-08-12T01:48:00+10:00,2023-08-12,01:48,1,0,1
58,2023-08-12T01:43:00+10:00,2023-08-12,01:43,0,3,3
58,2023-08-12T01:45:00+10:00,2023-08-12,01:45,1,0,1
58,2023-08-12T01:49:00+10:00,2023-08-12,01:49,2,1,3
62,2023-08-12T01:42:00+10:00,2023-08-12,01:42,2,0,2
62,2023-08-12T01:43:00+10:00,2023-08-12,01:43,0,1,1
62,2023-08-12T01:45:00+10:00,2023-08-12,01:45,1,2,3
62,2023-08-12T01:47:00+10:00,2023-08-12,01:47,1,0,1
62,2023-08-12T01:48:00+10:00,2023-08-12,01:48,0,3,3
62,2023-08-12T01:52:00+10:00,2023-08-12,01:52,2,0,2
62,2023-08-12T01:54:00+10:00,2023-08-12,01:54,1,0,1
63,2023-08-12T01:41:00+10:00,2023-08-12,01:41,0,7,7
63,2023-08-12T01:42:00+10:00,2023-08-12,01:42,0,7,7
63,2023-08-12T01:46:00+10:00,2023-08-12,01:46,2,0,2
63,2023-08-12T01:49:00+10:00,2023-08-12,01:49,0,4,4
63,2023-08-12T01:52:00+10:00,2023-08-12,01:52,6,3,9
67,2023-08-12T01:45:00+10:00,2023-08-12,01:45,0,4,4
67,2023-08-12T01:46:00+10:00,2023-08-12,01:46,2,1,3
67,2023-08-12T01:51:00+10:00,2023-08-12,01:51,2,0,2
68,2023-08-12T01:51:00+10:00,2023-08-12,01:51,1,0,1
72,2023-08-12T01:49:00+10:00,2023-08-12,01:49,2,0,2
79,2023-08-12T01:41:00+10:00,2023-08-12,01:41,1,3,4
79,2023-08-12T01:43:00+10:00,2023-08-12,01:43,0,1,1
79,2023-08-12T01:45:00+10:00,2023-08-12,01:45,1,3,4
79,2023-08-12T01:46:00+10:00,2023-08-12,01:46,1,0,1
79,2023-08-12T01:50:00+10:00,2023-08-12,01:50,9,0,9
79,2023-08-12T01:54:00+10:00,2023-08-12,01:54,6,0,6
109,2023-08-12T01:40:00+10:00,2023-08-12,01:40,0,2,2
117,2023-08-12T01:40:00+10:00,2023-08-12,01:40,4,1,5
3,2023-08-12T01:55:00+10:00,2023-08-12,01:55,7,0,7
3,2023-08-12T01:56:00+10:00,2023-08-12,01:56,0,3,3
3,2023-08-12T02:02:00+10:00,2023-08-12,02:02,0,9,9
3,2023-08-12T02:07:00+10:00,2023-08-12,02:07,4,0,4
3,2023-08-12T02:08:00+10:00,2023-08-12,02:08,2,1,3
4,2023-08-12T01:57:00+10:00,2023-08-12,01:57,0,3,3
4,2023-08-12T01:59:00+10:00,2023-08-12,01:59,0,10,10
4,2023-08-12T02:01:00+10:00,2023-08-12,02:01,6,5,11
4,2023-08-12T02:05:00+10:00,2023-08-12,02:05,3,1,4
4,2023-08-12T02:07:00+10:00,2023-08-12,02:07,0,3,3
4,2023-08-12T02:09:00+10:00,2023-08-12,02:09,0,5,5
6,2023-08-12T01:56:00+10:00,2023-08-12,01:56,2,1,3
6,2023-08-12T01:58:00+10:00,2023-08-12,01:58,3,2,5
6,2023-08-12T01:59:00+10:00,2023-08-12,01:59,5,2,7
6,2023-08-12T02:04:00+10:00,2023-08-12,02:04,3,0,3
6,2023-08-12T02:06:00+10:00,2023-08-12,02:06,1,1,2
6,2023-08-12T02:08:00+10:00,2023-08-12,02:08,0,2,2
6,2023-08-12T02:09:00+10:00,2023-08-12,02:09,1,2,3
14,2023-08-12T01:57:00+10:00,2023-08-12,01:57,7,0,7
14,2023-08-12T02:00:00+10:00,2023-08-12,02:00,1,0,1
14,2023-08-12T02:04:00+10:00,2023-08-12,02:04,2,0,2
21,2023-08-12T02:00:00+10:00,2023-08-12,02:00,2,11,13
21,2023-08-12T02:03:00+10:00,2023-08-12,02:03,1,4,5
21,2023-08-12T02:07:00+10:00,2023-08-12,02:07,4,0,4
28,2023-08-12T01:57:00+10:00,2023-08-12,01:57,0,1,1
28,2023-08-12T01:58:00+10:00,2023-08-12,01:58,2,0,2
28,2023-08-12T02:01:00+10:00,2023-08-12,02:01,2,1,3
28,2023-08-12T02:06:00+10:00,2023-08-12,02:06,1,0,1
28,2023-08-12T02:09:00+10:00,2023-08-12,02:09,2,0,2
29,2023-08-12T02:08:00+10:00,2023-08-12,02:08,0,1,1
39,2023-08-12T02:00:00+10:00,2023-08-12,02:00,0,1,1
41,2023-08-12T01:55:00+10:00,2023-08-12,01:55,1,6,7
41,2023-08-12T01:58:00+10:00,2023-08-12,01:58,3,4,7
41,2023-08-12T01:59:00+10:00,2023-08-12,01:59,4,1,5
41,2023-08-12T02:02:00+10:00,2023-08-12,02:02,5,4,9
41,2023-08-12T02:04:00+10:00,2023-08-12,02:04,0,11,11
54,2023-08-12T02:01:00+10:00,2023-08-12,02:01,0,3,3
55,2023-08-12T02:00:00+10:00,2023-08-12,02:00,6,5,11
55,2023-08-12T02:01:00+10:00,2023-08-12,02:01,7,2,9
55,2023-08-12T02:02:00+10:00,2023-08-12,02:02,3,0,3
55,2023-08-12T02:05:00+10:00,2023-08-12,02:05,8,3,11
55,2023-08-12T02:06:00+10:00,2023-08-12,02:06,3,9,12
59,2023-08-12T02:00:00+10:00,2023-08-12,02:00,5,0,5
61,2023-08-12T01:56:00+10:00,2023-08-12,01:56,5,0,5
61,2023-08-12T01:59:00+10:00,2023-08-12,01:59,1,1,2
65,2023-08-12T01:58:00+10:00,2023-08-12,01:58,0,1,1
65,2023-08-12T01:59:00+10:00,2023-08-12,01:59,4,0,4
65,2023-08-12T02:04:00+10:00,2023-08-12,02:04,0,6,6
66,2023-08-12T01:56:00+10:00,2023-08-12,01:56,3,10,13
66,2023-08-12T01:57:00+10:00,2023-08-12,01:57,4,1,5
66,2023-08-12T02:04:00+10:00,2023-08-12,02:04,2,3,5
69,2023-08-12T01:56:00+10:00,2023-08-12,01:56,0,1,1
70,2023-08-12T02:01:00+10:00,2023-08-12,02:01,1,1,2
77,2023-08-12T01:56:00+10:00,2023-08-12,01:56,1,0,1
84,2023-08-12T02:00:00+10:00,2023-08-12,02:00,9,30,39
84,2023-08-12T02:05:00+10:00,2023-08-12,02:05,7,16,23
1,2023-08-12T02:00:00+10:00,2023-08-12,02:00,4,0,4
2,2023-08-12T02:09:00+10:00,2023-08-12,02:09,0,3,3
9,2023-08-12T02:01:00+10:00,2023-08-12,02:01,0,1,1
11,2023-08-12T02:00:00+10:00,2023-08-12,02:00,0,1,1
12,2023-08-12T01:59:00+10:00,2023-08-12,01:59,0,2,2
12,2023-08-12T02:06:00+10:00,2023-08-12,02:06,1,0,1
17,2023-08-12T02:02:00+10:00,2023-08-12,02:02,0,1,1
24,2023-08-12T01:57:00+10:00,2023-08-12,01:57,1,3,4
27,2023-08-12T01:55:00+10:00,2023-08-12,01:55,1,0,1
27,2023-08-12T02:08:00+10:00,2023-08-12,02:08,1,0,1
35,2023-08-12T01:58:00+10:00,2023-08-12,01:58,0,5,5
35,2023-08-12T02:04:00+10:00,2023-08-12,02:04,1,2,3
35,2023-08-12T02:09:00+10:00,2023-08-12,02:09,1,4,5
56,2023-08-12T02:01:00+10:00,2023-08-12,02:01,2,0,2
56,2023-08-12T02:04:00+10:00,2023-08-12,02:04,2,0,2
58,2023-08-12T01:56:00+10:00,2023-08-12,01:56,0,3,3
58,2023-08-12T02:02:00+10:00,2023-08-12,02:02,0,1,1
58,2023-08-12T02:05:00+10:00,2023-08-12,02:05,0,1,1
62,2023-08-12T01:56:00+10:00,2023-08-12,01:56,0,3,3
62,2023-08-12T01:59:00+10:00,2023-08-12,01:59,3,1,4
62,2023-08-12T02:01:00+10:00,2023-08-12,02:01,2,0,2
62,2023-08-12T02:02:00+10:00,2023-08-12,02:02,3,1,4
63,2023-08-12T02:00:00+10:00,2023-08-12,02:00,1,2,3
63,2023-08-12T02:01:00+10:00,2023-08-12,02:01,0,6,6
63,2023-08-12T02:07:00+10:00,2023-08-12,02:07,0,8,8
67,2023-08-12T01:57:00+10:00,2023-08-12,01:57,1,0,1
67,2023-08-12T02:05:00+10:00,2023-08-12,02:05,0,1,1
72,2023-08-12T02:00:00+10:00,2023-08-12,02:00,0,1,1
72,2023-08-12T02:01:00+10:00,2023-08-12,02:01,1,1,2
72,2023-08-12T02:02:00+10:00,2023-08-12,02:02,5,2,7
72,2023-08-12T02:04:00+10:00,2023-08-12,02:04,0,1,1
72,2023-08-12T02:09:00+10:00,2023-08-12,02:09,3,0,3
76,2023-08-12T01:57:00+10:00,2023-08-12,01:57,0,1,1
79,2023-08-12T01:55:00+10:00,2023-08-12,01:55,3,1,4
79,2023-08-12T01:58:00+10:00,2023-08-12,01:58,0,1,1
79,2023-08-12T01:59:00+10:00,2023-08-12,01:59,1,0,1
79,2023-08-12T02:02:00+10:00,2023-08-12,02:02,0,2,2
79,2023-08-12T02:03:00+10:00,2023-08-12,02:03,5,1,6
79,2023-08-12T02:08:00+10:00,2023-08-12,02:08,1,1,2
109,2023-08-12T02:00:00+10:00,2023-08-12,02:00,0,5,5
117,2023-08-12T01:55:00+10:00,2023-08-12,01:55,0,1,1
3,2023-08-11T23:44:00+10:00,2023-08-11,23:44,4,16,20
3,2023-08-11T23:50:00+10:00,2023-08-11,23:50,8,7,15
4,2023-08-11T23:40:00+10:00,2023-08-11,23:40,14,2,16
4,2023-08-11T23:43:00+10:00,2023-08-11,23:43,14,5,19
4,2023-08-11T23:44:00+10:00,2023-08-11,23:44,3,11,14
4,2023-08-11T23:46:00+10:00,2023-08-11,23:46,11,7,18
3,2023-08-12T02:11:00+10:00,2023-08-12,02:11,2,4,6
6,2023-08-11T23:42:00+10:00,2023-08-11,23:42,10,2,12
3,2023-08-12T02:23:00+10:00,2023-08-12,02:23,1,4,5
6,2023-08-11T23:43:00+10:00,2023-08-11,23:43,3,6,9
3,2023-08-12T02:24:00+10:00,2023-08-12,02:24,7,3,10
6,2023-08-11T23:45:00+10:00,2023-08-11,23:45,4,3,7
4,2023-08-12T02:10:00+10:00,2023-08-12,02:10,1,2,3
6,2023-08-11T23:48:00+10:00,2023-08-11,23:48,5,1,6
4,2023-08-12T02:11:00+10:00,2023-08-12,02:11,1,2,3
6,2023-08-11T23:50:00+10:00,2023-08-11,23:50,10,3,13
4,2023-08-12T02:12:00+10:00,2023-08-12,02:12,0,1,1
6,2023-08-11T23:54:00+10:00,2023-08-11,23:54,4,2,6
4,2023-08-12T02:13:00+10:00,2023-08-12,02:13,2,1,3
8,2023-08-11T23:41:00+10:00,2023-08-11,23:41,0,1,1
6,2023-08-12T02:11:00+10:00,2023-08-12,02:11,0,2,2
8,2023-08-11T23:46:00+10:00,2023-08-11,23:46,1,0,1
6,2023-08-12T02:12:00+10:00,2023-08-12,02:12,0,1,1
8,2023-08-11T23:53:00+10:00,2023-08-11,23:53,0,1,1
6,2023-08-12T02:18:00+10:00,2023-08-12,02:18,5,1,6
14,2023-08-11T23:41:00+10:00,2023-08-11,23:41,10,1,11
6,2023-08-12T02:19:00+10:00,2023-08-12,02:19,3,0,3
14,2023-08-11T23:44:00+10:00,2023-08-11,23:44,8,1,9
6,2023-08-12T02:21:00+10:00,2023-08-12,02:21,2,0,2
14,2023-08-11T23:45:00+10:00,2023-08-11,23:45,6,3,9
6,2023-08-12T02:24:00+10:00,2023-08-12,02:24,7,1,8
14,2023-08-11T23:46:00+10:00,2023-08-11,23:46,14,3,17
14,2023-08-12T02:11:00+10:00,2023-08-12,02:11,2,1,3
14,2023-08-11T23:48:00+10:00,2023-08-11,23:48,5,1,6
14,2023-08-12T02:13:00+10:00,2023-08-12,02:13,2,0,2
14,2023-08-11T23:49:00+10:00,2023-08-11,23:49,3,1,4
14,2023-08-12T02:15:00+10:00,2023-08-12,02:15,5,0,5
14,2023-08-11T23:54:00+10:00,2023-08-11,23:54,4,2,6
14,2023-08-12T02:20:00+10:00,2023-08-12,02:20,1,0,1
21,2023-08-11T23:42:00+10:00,2023-08-11,23:42,2,6,8
14,2023-08-12T02:21:00+10:00,2023-08-12,02:21,2,5,7
21,2023-08-11T23:43:00+10:00,2023-08-11,23:43,1,1,2
14,2023-08-12T02:22:00+10:00,2023-08-12,02:22,3,6,9
21,2023-08-11T23:51:00+10:00,2023-08-11,23:51,9,4,13
14,2023-08-12T02:23:00+10:00,2023-08-12,02:23,2,0,2
21,2023-08-11T23:52:00+10:00,2023-08-11,23:52,4,5,9
21,2023-08-12T02:14:00+10:00,2023-08-12,02:14,7,6,13
21,2023-08-11T23:54:00+10:00,2023-08-11,23:54,8,2,10
21,2023-08-12T02:15:00+10:00,2023-08-12,02:15,6,0,6
28,2023-08-11T23:41:00+10:00,2023-08-11,23:41,1,2,3
21,2023-08-12T02:16:00+10:00,2023-08-12,02:16,2,2,4
28,2023-08-11T23:47:00+10:00,2023-08-11,23:47,7,0,7
28,2023-08-12T02:17:00+10:00,2023-08-12,02:17,2,0,2
28,2023-08-11T23:49:00+10:00,2023-08-11,23:49,2,1,3
29,2023-08-12T02:20:00+10:00,2023-08-12,02:20,0,1,1
28,2023-08-11T23:51:00+10:00,2023-08-11,23:51,5,1,6
41,2023-08-12T02:12:00+10:00,2023-08-12,02:12,2,4,6
28,2023-08-11T23:53:00+10:00,2023-08-11,23:53,4,0,4
41,2023-08-12T02:14:00+10:00,2023-08-12,02:14,3,4,7
28,2023-08-11T23:54:00+10:00,2023-08-11,23:54,3,0,3
41,2023-08-12T02:16:00+10:00,2023-08-12,02:16,4,1,5
29,2023-08-11T23:49:00+10:00,2023-08-11,23:49,2,1,3
41,2023-08-12T02:18:00+10:00,2023-08-12,02:18,9,1,10
29,2023-08-11T23:50:00+10:00,2023-08-11,23:50,1,2,3
41,2023-08-12T02:22:00+10:00,2023-08-12,02:22,4,0,4
29,2023-08-11T23:51:00+10:00,2023-08-11,23:51,4,0,4
55,2023-08-12T02:10:00+10:00,2023-08-12,02:10,0,3,3
29,2023-08-11T23:53:00+10:00,2023-08-11,23:53,4,0,4
55,2023-08-12T02:12:00+10:00,2023-08-12,02:12,3,3,6
39,2023-08-11T23:41:00+10:00,2023-08-11,23:41,0,3,3
55,2023-08-12T02:20:00+10:00,2023-08-12,02:20,3,6,9
39,2023-08-11T23:47:00+10:00,2023-08-11,23:47,0,5,5
59,2023-08-12T02:15:00+10:00,2023-08-12,02:15,6,8,14
41,2023-08-11T23:49:00+10:00,2023-08-11,23:49,14,7,21
59,2023-08-12T02:20:00+10:00,2023-08-12,02:20,20,2,22
41,2023-08-11T23:54:00+10:00,2023-08-11,23:54,16,18,34
65,2023-08-12T02:12:00+10:00,2023-08-12,02:12,0,1,1
54,2023-08-11T23:40:00+10:00,2023-08-11,23:40,1,2,3
65,2023-08-12T02:15:00+10:00,2023-08-12,02:15,0,5,5
54,2023-08-11T23:41:00+10:00,2023-08-11,23:41,4,0,4
65,2023-08-12T02:18:00+10:00,2023-08-12,02:18,0,3,3
54,2023-08-11T23:42:00+10:00,2023-08-11,23:42,0,1,1
66,2023-08-12T02:11:00+10:00,2023-08-12,02:11,1,0,1
55,2023-08-11T23:40:00+10:00,2023-08-11,23:40,6,4,10
66,2023-08-12T02:21:00+10:00,2023-08-12,02:21,0,2,2
55,2023-08-11T23:42:00+10:00,2023-08-11,23:42,18,10,28
66,2023-08-12T02:22:00+10:00,2023-08-12,02:22,4,0,4
55,2023-08-11T23:44:00+10:00,2023-08-11,23:44,5,12,17
66,2023-08-12T02:23:00+10:00,2023-08-12,02:23,0,3,3
55,2023-08-11T23:46:00+10:00,2023-08-11,23:46,4,4,8
69,2023-08-12T02:20:00+10:00,2023-08-12,02:20,0,1,1
55,2023-08-11T23:48:00+10:00,2023-08-11,23:48,17,6,23
70,2023-08-12T02:17:00+10:00,2023-08-12,02:17,0,1,1
55,2023-08-11T23:49:00+10:00,2023-08-11,23:49,10,11,21
84,2023-08-12T02:10:00+10:00,2023-08-12,02:10,8,14,22
59,2023-08-11T23:45:00+10:00,2023-08-11,23:45,6,14,20
87,2023-08-12T02:13:00+10:00,2023-08-12,02:13,1,0,1
59,2023-08-11T23:50:00+10:00,2023-08-11,23:50,15,4,19
107,2023-08-12T02:20:00+10:00,2023-08-12,02:20,4,1,5
61,2023-08-11T23:45:00+10:00,2023-08-11,23:45,0,1,1
108,2023-08-12T02:10:00+10:00,2023-08-12,02:10,1,0,1
61,2023-08-11T23:46:00+10:00,2023-08-11,23:46,1,1,2
108,2023-08-12T02:20:00+10:00,2023-08-12,02:20,2,0,2
61,2023-08-11T23:54:00+10:00,2023-08-11,23:54,4,0,4
108,2023-08-12T02:21:00+10:00,2023-08-12,02:21,0,1,1
65,2023-08-11T23:50:00+10:00,2023-08-11,23:50,2,0,2
108,2023-08-12T02:23:00+10:00,2023-08-12,02:23,1,0,1
65,2023-08-11T23:52:00+10:00,2023-08-11,23:52,4,4,8
118,2023-08-12T02:10:00+10:00,2023-08-12,02:10,0,1,1
65,2023-08-11T23:53:00+10:00,2023-08-11,23:53,1,3,4
1,2023-08-12T02:17:00+10:00,2023-08-12,02:17,0,2,2
66,2023-08-11T23:40:00+10:00,2023-08-11,23:40,5,8,13
1,2023-08-12T02:18:00+10:00,2023-08-12,02:18,0,1,1
66,2023-08-11T23:48:00+10:00,2023-08-11,23:48,2,7,9
1,2023-08-12T02:21:00+10:00,2023-08-12,02:21,0,1,1
66,2023-08-11T23:49:00+10:00,2023-08-11,23:49,8,4,12
1,2023-08-12T02:22:00+10:00,2023-08-12,02:22,0,2,2
66,2023-08-11T23:50:00+10:00,2023-08-11,23:50,13,14,27
2,2023-08-12T02:22:00+10:00,2023-08-12,02:22,0,1,1
66,2023-08-11T23:51:00+10:00,2023-08-11,23:51,2,2,4
9,2023-08-12T02:12:00+10:00,2023-08-12,02:12,1,0,1
66,2023-08-11T23:52:00+10:00,2023-08-11,23:52,3,0,3
17,2023-08-12T02:21:00+10:00,2023-08-12,02:21,0,1,1
66,2023-08-11T23:53:00+10:00,2023-08-11,23:53,7,3,10
24,2023-08-12T02:10:00+10:00,2023-08-12,02:10,0,1,1
69,2023-08-11T23:49:00+10:00,2023-08-11,23:49,0,1,1
24,2023-08-12T02:21:00+10:00,2023-08-12,02:21,0,3,3
69,2023-08-11T23:51:00+10:00,2023-08-11,23:51,2,0,2
27,2023-08-12T02:12:00+10:00,2023-08-12,02:12,3,0,3
75,2023-08-11T23:40:00+10:00,2023-08-11,23:40,2,0,2
35,2023-08-12T02:13:00+10:00,2023-08-12,02:13,1,0,1
75,2023-08-11T23:48:00+10:00,2023-08-11,23:48,0,2,2
35,2023-08-12T02:17:00+10:00,2023-08-12,02:17,8,0,8
75,2023-08-11T23:50:00+10:00,2023-08-11,23:50,2,0,2
35,2023-08-12T02:18:00+10:00,2023-08-12,02:18,0,6,6
77,2023-08-11T23:41:00+10:00,2023-08-11,23:41,2,0,2
53,2023-08-12T02:12:00+10:00,2023-08-12,02:12,0,8,8
84,2023-08-11T23:40:00+10:00,2023-08-11,23:40,49,54,103
53,2023-08-12T02:22:00+10:00,2023-08-12,02:22,1,0,1
87,2023-08-11T23:53:00+10:00,2023-08-11,23:53,3,0,3
56,2023-08-12T02:15:00+10:00,2023-08-12,02:15,0,1,1
107,2023-08-11T23:50:00+10:00,2023-08-11,23:50,2,7,9
56,2023-08-12T02:21:00+10:00,2023-08-12,02:21,1,1,2
108,2023-08-11T23:53:00+10:00,2023-08-11,23:53,2,1,3
56,2023-08-12T02:23:00+10:00,2023-08-12,02:23,0,1,1
108,2023-08-11T23:54:00+10:00,2023-08-11,23:54,0,4,4
58,2023-08-12T02:10:00+10:00,2023-08-12,02:10,1,0,1
1,2023-08-11T23:42:00+10:00,2023-08-11,23:42,0,2,2
58,2023-08-12T02:14:00+10:00,2023-08-12,02:14,2,1,3
1,2023-08-11T23:48:00+10:00,2023-08-11,23:48,2,0,2
62,2023-08-12T02:10:00+10:00,2023-08-12,02:10,5,0,5
1,2023-08-11T23:54:00+10:00,2023-08-11,23:54,1,1,2
62,2023-08-12T02:11:00+10:00,2023-08-12,02:11,0,3,3
2,2023-08-11T23:42:00+10:00,2023-08-11,23:42,1,8,9
62,2023-08-12T02:12:00+10:00,2023-08-12,02:12,2,0,2
2,2023-08-11T23:43:00+10:00,2023-08-11,23:43,0,7,7
63,2023-08-12T02:19:00+10:00,2023-08-12,02:19,2,1,3
2,2023-08-11T23:44:00+10:00,2023-08-11,23:44,0,3,3
67,2023-08-12T02:10:00+10:00,2023-08-12,02:10,0,2,2
2,2023-08-11T23:51:00+10:00,2023-08-11,23:51,0,1,1
67,2023-08-12T02:13:00+10:00,2023-08-12,02:13,0,2,2
2,2023-08-11T23:54:00+10:00,2023-08-11,23:54,2,0,2
67,2023-08-12T02:24:00+10:00,2023-08-12,02:24,0,5,5
7,2023-08-11T23:45:00+10:00,2023-08-11,23:45,0,13,13
68,2023-08-12T02:21:00+10:00,2023-08-12,02:21,1,0,1
7,2023-08-11T23:50:00+10:00,2023-08-11,23:50,0,5,5
72,2023-08-12T02:13:00+10:00,2023-08-12,02:13,0,1,1
7,2023-08-11T23:51:00+10:00,2023-08-11,23:51,0,2,2
72,2023-08-12T02:15:00+10:00,2023-08-12,02:15,1,0,1
7,2023-08-11T23:52:00+10:00,2023-08-11,23:52,0,11,11
79,2023-08-12T02:11:00+10:00,2023-08-12,02:11,3,2,5
9,2023-08-11T23:41:00+10:00,2023-08-11,23:41,1,3,4
79,2023-08-12T02:12:00+10:00,2023-08-12,02:12,4,4,8
9,2023-08-11T23:42:00+10:00,2023-08-11,23:42,1,1,2
79,2023-08-12T02:14:00+10:00,2023-08-12,02:14,2,3,5
9,2023-08-11T23:43:00+10:00,2023-08-11,23:43,0,12,12
79,2023-08-12T02:16:00+10:00,2023-08-12,02:16,1,2,3
11,2023-08-11T23:44:00+10:00,2023-08-11,23:44,1,1,2
79,2023-08-12T02:18:00+10:00,2023-08-12,02:18,1,1,2
11,2023-08-11T23:50:00+10:00,2023-08-11,23:50,4,3,7
79,2023-08-12T02:19:00+10:00,2023-08-12,02:19,4,4,8
17,2023-08-11T23:42:00+10:00,2023-08-11,23:42,1,0,1
79,2023-08-12T02:22:00+10:00,2023-08-12,02:22,3,2,5
17,2023-08-11T23:45:00+10:00,2023-08-11,23:45,2,1,3
79,2023-08-12T02:24:00+10:00,2023-08-12,02:24,1,2,3
17,2023-08-11T23:46:00+10:00,2023-08-11,23:46,1,0,1
109,2023-08-12T02:20:00+10:00,2023-08-12,02:20,4,0,4
17,2023-08-11T23:47:00+10:00,2023-08-11,23:47,1,1,2
117,2023-08-12T02:10:00+10:00,2023-08-12,02:10,0,1,1
24,2023-08-11T23:40:00+10:00,2023-08-11,23:40,11,3,14
122,2023-08-12T02:24:00+10:00,2023-08-12,02:24,0,1,1
24,2023-08-11T23:41:00+10:00,2023-08-11,23:41,8,3,11
24,2023-08-11T23:42:00+10:00,2023-08-11,23:42,2,11,13
24,2023-08-11T23:49:00+10:00,2023-08-11,23:49,1,4,5
24,2023-08-11T23:51:00+10:00,2023-08-11,23:51,9,7,16
27,2023-08-11T23:43:00+10:00,2023-08-11,23:43,4,2,6
27,2023-08-11T23:54:00+10:00,2023-08-11,23:54,0,2,2
35,2023-08-11T23:40:00+10:00,2023-08-11,23:40,4,11,15
35,2023-08-11T23:41:00+10:00,2023-08-11,23:41,5,9,14
35,2023-08-11T23:44:00+10:00,2023-08-11,23:44,2,5,7
35,2023-08-11T23:47:00+10:00,2023-08-11,23:47,3,11,14
35,2023-08-11T23:53:00+10:00,2023-08-11,23:53,4,8,12
53,2023-08-11T23:45:00+10:00,2023-08-11,23:45,8,2,10
53,2023-08-11T23:46:00+10:00,2023-08-11,23:46,0,2,2
53,2023-08-11T23:54:00+10:00,2023-08-11,23:54,1,3,4
56,2023-08-11T23:40:00+10:00,2023-08-11,23:40,1,1,2
56,2023-08-11T23:44:00+10:00,2023-08-11,23:44,1,3,4
56,2023-08-11T23:46:00+10:00,2023-08-11,23:46,0,1,1
56,2023-08-11T23:51:00+10:00,2023-08-11,23:51,1,1,2
56,2023-08-11T23:53:00+10:00,2023-08-11,23:53,1,1,2
57,2023-08-11T23:53:00+10:00,2023-08-11,23:53,0,1,1
58,2023-08-11T23:42:00+10:00,2023-08-11,23:42,0,1,1
58,2023-08-11T23:43:00+10:00,2023-08-11,23:43,5,0,5
58,2023-08-11T23:44:00+10:00,2023-08-11,23:44,1,9,10
58,2023-08-11T23:46:00+10:00,2023-08-11,23:46,2,2,4
58,2023-08-11T23:54:00+10:00,2023-08-11,23:54,5,0,5
62,2023-08-11T23:42:00+10:00,2023-08-11,23:42,3,0,3
62,2023-08-11T23:45:00+10:00,2023-08-11,23:45,4,0,4
62,2023-08-11T23:46:00+10:00,2023-08-11,23:46,3,0,3
62,2023-08-11T23:48:00+10:00,2023-08-11,23:48,2,1,3
62,2023-08-11T23:54:00+10:00,2023-08-11,23:54,0,1,1
63,2023-08-11T23:40:00+10:00,2023-08-11,23:40,4,7,11
63,2023-08-11T23:46:00+10:00,2023-08-11,23:46,0,2,2
63,2023-08-11T23:50:00+10:00,2023-08-11,23:50,2,0,2
63,2023-08-11T23:53:00+10:00,2023-08-11,23:53,0,6,6
63,2023-08-11T23:54:00+10:00,2023-08-11,23:54,9,1,10
67,2023-08-11T23:41:00+10:00,2023-08-11,23:41,5,9,14
67,2023-08-11T23:45:00+10:00,2023-08-11,23:45,2,6,8
67,2023-08-11T23:47:00+10:00,2023-08-11,23:47,2,3,5
68,2023-08-11T23:43:00+10:00,2023-08-11,23:43,1,0,1
68,2023-08-11T23:47:00+10:00,2023-08-11,23:47,0,1,1
68,2023-08-11T23:49:00+10:00,2023-08-11,23:49,3,0,3
72,2023-08-11T23:43:00+10:00,2023-08-11,23:43,0,9,9
72,2023-08-11T23:44:00+10:00,2023-08-11,23:44,1,8,9
72,2023-08-11T23:46:00+10:00,2023-08-11,23:46,1,11,12
72,2023-08-11T23:48:00+10:00,2023-08-11,23:48,0,9,9
72,2023-08-11T23:49:00+10:00,2023-08-11,23:49,2,7,9
72,2023-08-11T23:52:00+10:00,2023-08-11,23:52,0,5,5
72,2023-08-11T23:53:00+10:00,2023-08-11,23:53,0,7,7
79,2023-08-11T23:40:00+10:00,2023-08-11,23:40,5,8,13
79,2023-08-11T23:44:00+10:00,2023-08-11,23:44,0,18,18
79,2023-08-11T23:45:00+10:00,2023-08-11,23:45,4,7,11
79,2023-08-11T23:48:00+10:00,2023-08-11,23:48,3,3,6
79,2023-08-11T23:52:00+10:00,2023-08-11,23:52,15,14,29
79,2023-08-11T23:53:00+10:00,2023-08-11,23:53,13,6,19
122,2023-08-11T23:43:00+10:00,2023-08-11,23:43,3,8,11
122,2023-08-11T23:46:00+10:00,2023-08-11,23:46,1,0,1
3,2023-08-12T02:28:00+10:00,2023-08-12,02:28,6,1,7
3,2023-08-12T02:35:00+10:00,2023-08-12,02:35,4,1,5
3,2023-08-12T02:37:00+10:00,2023-08-12,02:37,1,4,5
4,2023-08-12T02:31:00+10:00,2023-08-12,02:31,6,0,6
4,2023-08-12T02:36:00+10:00,2023-08-12,02:36,0,1,1
4,2023-08-12T02:37:00+10:00,2023-08-12,02:37,1,1,2
6,2023-08-12T02:25:00+10:00,2023-08-12,02:25,1,2,3
6,2023-08-12T02:31:00+10:00,2023-08-12,02:31,1,2,3
6,2023-08-12T02:32:00+10:00,2023-08-12,02:32,6,0,6
6,2023-08-12T02:34:00+10:00,2023-08-12,02:34,1,2,3
6,2023-08-12T02:37:00+10:00,2023-08-12,02:37,1,0,1
8,2023-08-12T02:27:00+10:00,2023-08-12,02:27,0,1,1
14,2023-08-12T02:26:00+10:00,2023-08-12,02:26,1,0,1
14,2023-08-12T02:36:00+10:00,2023-08-12,02:36,2,0,2
21,2023-08-12T02:29:00+10:00,2023-08-12,02:29,0,9,9
21,2023-08-12T02:30:00+10:00,2023-08-12,02:30,0,1,1
21,2023-08-12T02:32:00+10:00,2023-08-12,02:32,0,1,1
21,2023-08-12T02:35:00+10:00,2023-08-12,02:35,2,1,3
28,2023-08-12T02:25:00+10:00,2023-08-12,02:25,1,0,1
28,2023-08-12T02:29:00+10:00,2023-08-12,02:29,2,0,2
28,2023-08-12T02:31:00+10:00,2023-08-12,02:31,1,0,1
28,2023-08-12T02:37:00+10:00,2023-08-12,02:37,6,2,8
29,2023-08-12T02:38:00+10:00,2023-08-12,02:38,0,1,1
39,2023-08-12T02:32:00+10:00,2023-08-12,02:32,2,0,2
39,2023-08-12T02:37:00+10:00,2023-08-12,02:37,0,1,1
41,2023-08-12T02:25:00+10:00,2023-08-12,02:25,3,0,3
41,2023-08-12T02:26:00+10:00,2023-08-12,02:26,4,11,15
41,2023-08-12T02:29:00+10:00,2023-08-12,02:29,0,2,2
41,2023-08-12T02:33:00+10:00,2023-08-12,02:33,1,1,2
41,2023-08-12T02:35:00+10:00,2023-08-12,02:35,1,0,1
41,2023-08-12T02:38:00+10:00,2023-08-12,02:38,0,13,13
54,2023-08-12T02:30:00+10:00,2023-08-12,02:30,4,0,4
55,2023-08-12T02:27:00+10:00,2023-08-12,02:27,2,1,3
55,2023-08-12T02:31:00+10:00,2023-08-12,02:31,9,0,9
55,2023-08-12T02:33:00+10:00,2023-08-12,02:33,3,6,9
55,2023-08-12T02:39:00+10:00,2023-08-12,02:39,3,9,12
59,2023-08-12T02:25:00+10:00,2023-08-12,02:25,9,0,9
59,2023-08-12T02:35:00+10:00,2023-08-12,02:35,7,0,7
61,2023-08-12T02:32:00+10:00,2023-08-12,02:32,0,1,1
65,2023-08-12T02:26:00+10:00,2023-08-12,02:26,1,1,2
65,2023-08-12T02:28:00+10:00,2023-08-12,02:28,1,1,2
65,2023-08-12T02:31:00+10:00,2023-08-12,02:31,3,0,3
65,2023-08-12T02:32:00+10:00,2023-08-12,02:32,0,1,1
65,2023-08-12T02:35:00+10:00,2023-08-12,02:35,0,6,6
66,2023-08-12T02:26:00+10:00,2023-08-12,02:26,1,2,3
66,2023-08-12T02:30:00+10:00,2023-08-12,02:30,1,1,2
69,2023-08-12T02:37:00+10:00,2023-08-12,02:37,0,1,1
70,2023-08-12T02:31:00+10:00,2023-08-12,02:31,0,3,3
84,2023-08-12T02:35:00+10:00,2023-08-12,02:35,10,20,30
108,2023-08-12T02:25:00+10:00,2023-08-12,02:25,0,1,1
108,2023-08-12T02:26:00+10:00,2023-08-12,02:26,2,1,3
1,2023-08-12T02:26:00+10:00,2023-08-12,02:26,0,3,3
1,2023-08-12T02:27:00+10:00,2023-08-12,02:27,1,0,1
1,2023-08-12T02:28:00+10:00,2023-08-12,02:28,1,0,1
1,2023-08-12T02:32:00+10:00,2023-08-12,02:32,2,0,2
1,2023-08-12T02:38:00+10:00,2023-08-12,02:38,0,4,4
2,2023-08-12T02:28:00+10:00,2023-08-12,02:28,0,7,7
24,2023-08-12T02:27:00+10:00,2023-08-12,02:27,1,0,1
24,2023-08-12T02:37:00+10:00,2023-08-12,02:37,0,2,2
27,2023-08-12T02:34:00+10:00,2023-08-12,02:34,1,0,1
35,2023-08-12T02:30:00+10:00,2023-08-12,02:30,1,4,5
53,2023-08-12T02:38:00+10:00,2023-08-12,02:38,1,1,2
56,2023-08-12T02:26:00+10:00,2023-08-12,02:26,1,1,2
58,2023-08-12T02:29:00+10:00,2023-08-12,02:29,1,0,1
62,2023-08-12T02:25:00+10:00,2023-08-12,02:25,0,3,3
62,2023-08-12T02:32:00+10:00,2023-08-12,02:32,1,0,1
62,2023-08-12T02:33:00+10:00,2023-08-12,02:33,1,7,8
63,2023-08-12T02:26:00+10:00,2023-08-12,02:26,0,3,3
63,2023-08-12T02:31:00+10:00,2023-08-12,02:31,1,1,2
63,2023-08-12T02:34:00+10:00,2023-08-12,02:34,0,2,2
63,2023-08-12T02:39:00+10:00,2023-08-12,02:39,0,5,5
67,2023-08-12T02:28:00+10:00,2023-08-12,02:28,0,1,1
72,2023-08-12T02:30:00+10:00,2023-08-12,02:30,1,1,2
79,2023-08-12T02:36:00+10:00,2023-08-12,02:36,1,3,4
79,2023-08-12T02:39:00+10:00,2023-08-12,02:39,1,0,1
117,2023-08-12T02:25:00+10:00,2023-08-12,02:25,1,4,5
122,2023-08-12T02:37:00+10:00,2023-08-12,02:37,2,0,2
3,2023-08-12T02:41:00+10:00,2023-08-12,02:41,0,1,1
3,2023-08-12T02:43:00+10:00,2023-08-12,02:43,2,0,2
3,2023-08-12T02:45:00+10:00,2023-08-12,02:45,3,2,5
4,2023-08-12T02:40:00+10:00,2023-08-12,02:40,2,0,2
4,2023-08-12T02:41:00+10:00,2023-08-12,02:41,2,1,3
4,2023-08-12T02:44:00+10:00,2023-08-12,02:44,0,4,4
4,2023-08-12T02:54:00+10:00,2023-08-12,02:54,1,1,2
6,2023-08-12T02:43:00+10:00,2023-08-12,02:43,0,5,5
6,2023-08-12T02:46:00+10:00,2023-08-12,02:46,0,1,1
6,2023-08-12T02:49:00+10:00,2023-08-12,02:49,1,1,2
6,2023-08-12T02:51:00+10:00,2023-08-12,02:51,2,0,2
14,2023-08-12T02:53:00+10:00,2023-08-12,02:53,1,0,1
21,2023-08-12T02:43:00+10:00,2023-08-12,02:43,2,2,4
21,2023-08-12T02:45:00+10:00,2023-08-12,02:45,1,0,1
21,2023-08-12T02:50:00+10:00,2023-08-12,02:50,2,3,5
21,2023-08-12T02:51:00+10:00,2023-08-12,02:51,1,2,3
21,2023-08-12T02:53:00+10:00,2023-08-12,02:53,3,1,4
28,2023-08-12T02:46:00+10:00,2023-08-12,02:46,1,1,2
28,2023-08-12T02:48:00+10:00,2023-08-12,02:48,0,1,1
28,2023-08-12T02:52:00+10:00,2023-08-12,02:52,0,1,1
28,2023-08-12T02:53:00+10:00,2023-08-12,02:53,0,1,1
29,2023-08-12T02:40:00+10:00,2023-08-12,02:40,2,0,2
29,2023-08-12T02:42:00+10:00,2023-08-12,02:42,0,3,3
29,2023-08-12T02:43:00+10:00,2023-08-12,02:43,0,1,1
29,2023-08-12T02:45:00+10:00,2023-08-12,02:45,0,2,2
29,2023-08-12T02:48:00+10:00,2023-08-12,02:48,0,2,2
41,2023-08-12T02:41:00+10:00,2023-08-12,02:41,0,2,2
41,2023-08-12T02:43:00+10:00,2023-08-12,02:43,0,3,3
41,2023-08-12T02:44:00+10:00,2023-08-12,02:44,0,2,2
41,2023-08-12T02:50:00+10:00,2023-08-12,02:50,2,0,2
41,2023-08-12T02:51:00+10:00,2023-08-12,02:51,1,1,2
54,2023-08-12T02:42:00+10:00,2023-08-12,02:42,1,0,1
55,2023-08-12T02:41:00+10:00,2023-08-12,02:41,6,0,6
55,2023-08-12T02:46:00+10:00,2023-08-12,02:46,6,1,7
55,2023-08-12T02:50:00+10:00,2023-08-12,02:50,1,6,7
65,2023-08-12T02:40:00+10:00,2023-08-12,02:40,1,0,1
66,2023-08-12T02:47:00+10:00,2023-08-12,02:47,1,0,1
75,2023-08-12T02:44:00+10:00,2023-08-12,02:44,0,1,1
84,2023-08-12T02:40:00+10:00,2023-08-12,02:40,3,20,23
107,2023-08-12T02:50:00+10:00,2023-08-12,02:50,3,1,4
108,2023-08-12T02:51:00+10:00,2023-08-12,02:51,1,0,1
1,2023-08-12T02:44:00+10:00,2023-08-12,02:44,0,2,2
1,2023-08-12T02:50:00+10:00,2023-08-12,02:50,4,0,4
1,2023-08-12T02:51:00+10:00,2023-08-12,02:51,4,0,4
2,2023-08-12T02:46:00+10:00,2023-08-12,02:46,0,1,1
2,2023-08-12T02:47:00+10:00,2023-08-12,02:47,1,0,1
2,2023-08-12T02:49:00+10:00,2023-08-12,02:49,0,1,1
7,2023-08-12T02:43:00+10:00,2023-08-12,02:43,0,1,1
7,2023-08-12T02:46:00+10:00,2023-08-12,02:46,0,2,2
9,2023-08-12T02:41:00+10:00,2023-08-12,02:41,0,2,2
10,2023-08-12T02:51:00+10:00,2023-08-12,02:51,1,0,1
11,2023-08-12T02:45:00+10:00,2023-08-12,02:45,5,0,5
12,2023-08-12T02:44:00+10:00,2023-08-12,02:44,0,1,1
12,2023-08-12T02:47:00+10:00,2023-08-12,02:47,5,0,5
17,2023-08-12T02:40:00+10:00,2023-08-12,02:40,1,0,1
17,2023-08-12T02:44:00+10:00,2023-08-12,02:44,0,1,1
17,2023-08-12T02:49:00+10:00,2023-08-12,02:49,1,0,1
24,2023-08-12T02:40:00+10:00,2023-08-12,02:40,0,2,2
24,2023-08-12T02:44:00+10:00,2023-08-12,02:44,0,2,2
24,2023-08-12T02:46:00+10:00,2023-08-12,02:46,1,0,1
24,2023-08-12T02:50:00+10:00,2023-08-12,02:50,4,0,4
24,2023-08-12T02:51:00+10:00,2023-08-12,02:51,1,0,1
24,2023-08-12T02:52:00+10:00,2023-08-12,02:52,1,1,2
35,2023-08-12T02:41:00+10:00,2023-08-12,02:41,2,15,17
35,2023-08-12T02:43:00+10:00,2023-08-12,02:43,0,2,2
35,2023-08-12T02:44:00+10:00,2023-08-12,02:44,0,1,1
35,2023-08-12T02:47:00+10:00,2023-08-12,02:47,2,2,4
35,2023-08-12T02:52:00+10:00,2023-08-12,02:52,1,2,3
57,2023-08-12T02:52:00+10:00,2023-08-12,02:52,2,0,2
58,2023-08-12T02:40:00+10:00,2023-08-12,02:40,2,0,2
58,2023-08-12T02:41:00+10:00,2023-08-12,02:41,0,3,3
58,2023-08-12T02:44:00+10:00,2023-08-12,02:44,0,2,2
58,2023-08-12T02:50:00+10:00,2023-08-12,02:50,0,3,3
62,2023-08-12T02:49:00+10:00,2023-08-12,02:49,0,5,5
62,2023-08-12T02:50:00+10:00,2023-08-12,02:50,0,1,1
63,2023-08-12T02:41:00+10:00,2023-08-12,02:41,2,0,2
63,2023-08-12T02:43:00+10:00,2023-08-12,02:43,1,1,2
63,2023-08-12T02:47:00+10:00,2023-08-12,02:47,0,6,6
72,2023-08-12T02:45:00+10:00,2023-08-12,02:45,0,1,1
72,2023-08-12T02:46:00+10:00,2023-08-12,02:46,0,5,5
79,2023-08-12T02:49:00+10:00,2023-08-12,02:49,1,0,1
79,2023-08-12T02:50:00+10:00,2023-08-12,02:50,1,0,1
79,2023-08-12T02:51:00+10:00,2023-08-12,02:51,3,0,3
79,2023-08-12T02:53:00+10:00,2023-08-12,02:53,3,3,6
85,2023-08-12T02:47:00+10:00,2023-08-12,02:47,1,0,1
117,2023-08-12T02:45:00+10:00,2023-08-12,02:45,0,2,2
122,2023-08-12T02:49:00+10:00,2023-08-12,02:49,1,0,1
122,2023-08-12T02:50:00+10:00,2023-08-12,02:50,1,0,1
3,2023-08-12T02:57:00+10:00,2023-08-12,02:57,1,3,4
3,2023-08-12T03:02:00+10:00,2023-08-12,03:02,1,1,2
3,2023-08-12T03:04:00+10:00,2023-08-12,03:04,2,1,3
4,2023-08-12T02:56:00+10:00,2023-08-12,02:56,1,1,2
4,2023-08-12T02:58:00+10:00,2023-08-12,02:58,0,2,2
4,2023-08-12T02:59:00+10:00,2023-08-12,02:59,2,2,4
4,2023-08-12T03:01:00+10:00,2023-08-12,03:01,1,5,6
4,2023-08-12T03:02:00+10:00,2023-08-12,03:02,0,2,2
4,2023-08-12T03:06:00+10:00,2023-08-12,03:06,0,2,2
6,2023-08-12T02:55:00+10:00,2023-08-12,02:55,3,0,3
6,2023-08-12T02:57:00+10:00,2023-08-12,02:57,1,1,2
6,2023-08-12T02:58:00+10:00,2023-08-12,02:58,1,0,1
6,2023-08-12T03:02:00+10:00,2023-08-12,03:02,1,3,4
6,2023-08-12T03:08:00+10:00,2023-08-12,03:08,1,1,2
6,2023-08-12T03:09:00+10:00,2023-08-12,03:09,0,2,2
14,2023-08-12T02:59:00+10:00,2023-08-12,02:59,1,0,1
14,2023-08-12T03:02:00+10:00,2023-08-12,03:02,3,0,3
14,2023-08-12T03:04:00+10:00,2023-08-12,03:04,2,0,2
14,2023-08-12T03:06:00+10:00,2023-08-12,03:06,1,0,1
14,2023-08-12T03:09:00+10:00,2023-08-12,03:09,8,0,8
21,2023-08-12T02:55:00+10:00,2023-08-12,02:55,2,9,11
21,2023-08-12T02:58:00+10:00,2023-08-12,02:58,1,2,3
21,2023-08-12T02:59:00+10:00,2023-08-12,02:59,0,2,2
21,2023-08-12T03:02:00+10:00,2023-08-12,03:02,3,1,4
21,2023-08-12T03:08:00+10:00,2023-08-12,03:08,9,0,9
28,2023-08-12T02:56:00+10:00,2023-08-12,02:56,0,1,1
28,2023-08-12T03:09:00+10:00,2023-08-12,03:09,0,1,1
41,2023-08-12T03:03:00+10:00,2023-08-12,03:03,1,7,8
41,2023-08-12T03:06:00+10:00,2023-08-12,03:06,0,2,2
41,2023-08-12T03:08:00+10:00,2023-08-12,03:08,1,7,8
54,2023-08-12T03:05:00+10:00,2023-08-12,03:05,1,0,1
55,2023-08-12T02:56:00+10:00,2023-08-12,02:56,5,8,13
55,2023-08-12T02:57:00+10:00,2023-08-12,02:57,0,1,1
55,2023-08-12T03:04:00+10:00,2023-08-12,03:04,9,0,9
55,2023-08-12T03:07:00+10:00,2023-08-12,03:07,3,3,6
55,2023-08-12T03:09:00+10:00,2023-08-12,03:09,1,1,2
61,2023-08-12T03:08:00+10:00,2023-08-12,03:08,4,0,4
65,2023-08-12T02:56:00+10:00,2023-08-12,02:56,0,11,11
65,2023-08-12T03:03:00+10:00,2023-08-12,03:03,1,1,2
65,2023-08-12T03:05:00+10:00,2023-08-12,03:05,0,3,3
66,2023-08-12T02:55:00+10:00,2023-08-12,02:55,1,0,1
66,2023-08-12T03:01:00+10:00,2023-08-12,03:01,5,0,5
66,2023-08-12T03:05:00+10:00,2023-08-12,03:05,2,1,3
75,2023-08-12T03:05:00+10:00,2023-08-12,03:05,0,1,1
77,2023-08-12T03:09:00+10:00,2023-08-12,03:09,2,0,2
84,2023-08-12T02:55:00+10:00,2023-08-12,02:55,2,11,13
84,2023-08-12T03:05:00+10:00,2023-08-12,03:05,3,10,13
87,2023-08-12T02:57:00+10:00,2023-08-12,02:57,0,1,1
87,2023-08-12T03:04:00+10:00,2023-08-12,03:04,1,0,1
107,2023-08-12T02:55:00+10:00,2023-08-12,02:55,3,0,3
108,2023-08-12T03:09:00+10:00,2023-08-12,03:09,0,3,3
1,2023-08-12T03:07:00+10:00,2023-08-12,03:07,0,1,1
2,2023-08-12T02:56:00+10:00,2023-08-12,02:56,1,2,3
2,2023-08-12T03:02:00+10:00,2023-08-12,03:02,0,2,2
9,2023-08-12T02:55:00+10:00,2023-08-12,02:55,0,2,2
24,2023-08-12T02:55:00+10:00,2023-08-12,02:55,0,1,1
3,2023-08-11T23:56:00+10:00,2023-08-11,23:56,2,9,11
24,2023-08-12T02:59:00+10:00,2023-08-12,02:59,2,0,2
4,2023-08-11T23:55:00+10:00,2023-08-11,23:55,11,18,29
24,2023-08-12T03:04:00+10:00,2023-08-12,03:04,2,0,2
4,2023-08-11T23:56:00+10:00,2023-08-11,23:56,34,7,41
27,2023-08-12T03:02:00+10:00,2023-08-12,03:02,0,2,2
4,2023-08-11T23:58:00+10:00,2023-08-11,23:58,13,31,44
35,2023-08-12T02:59:00+10:00,2023-08-12,02:59,1,1,2
4,2023-08-11T23:59:00+10:00,2023-08-11,23:59,9,10,19
35,2023-08-12T03:00:00+10:00,2023-08-12,03:00,2,2,4
4,2023-08-12T00:05:00+10:00,2023-08-12,00:05,3,3,6
35,2023-08-12T03:04:00+10:00,2023-08-12,03:04,0,2,2
4,2023-08-12T00:06:00+10:00,2023-08-12,00:06,3,3,6
35,2023-08-12T03:08:00+10:00,2023-08-12,03:08,1,0,1
6,2023-08-11T23:55:00+10:00,2023-08-11,23:55,7,3,10
56,2023-08-12T02:58:00+10:00,2023-08-12,02:58,0,1,1
6,2023-08-12T00:01:00+10:00,2023-08-12,00:01,6,3,9
56,2023-08-12T03:01:00+10:00,2023-08-12,03:01,0,4,4
6,2023-08-12T00:03:00+10:00,2023-08-12,00:03,8,2,10
56,2023-08-12T03:02:00+10:00,2023-08-12,03:02,2,0,2
6,2023-08-12T00:09:00+10:00,2023-08-12,00:09,8,4,12
56,2023-08-12T03:07:00+10:00,2023-08-12,03:07,3,0,3
8,2023-08-11T23:59:00+10:00,2023-08-11,23:59,0,1,1
57,2023-08-12T02:59:00+10:00,2023-08-12,02:59,1,0,1
14,2023-08-11T23:56:00+10:00,2023-08-11,23:56,9,8,17
58,2023-08-12T02:55:00+10:00,2023-08-12,02:55,0,2,2
14,2023-08-11T23:57:00+10:00,2023-08-11,23:57,6,0,6
58,2023-08-12T03:05:00+10:00,2023-08-12,03:05,0,2,2
14,2023-08-11T23:58:00+10:00,2023-08-11,23:58,3,0,3
62,2023-08-12T02:58:00+10:00,2023-08-12,02:58,3,1,4
14,2023-08-12T00:02:00+10:00,2023-08-12,00:02,4,1,5
62,2023-08-12T03:01:00+10:00,2023-08-12,03:01,1,0,1
14,2023-08-12T00:09:00+10:00,2023-08-12,00:09,7,1,8
62,2023-08-12T03:06:00+10:00,2023-08-12,03:06,0,1,1
21,2023-08-11T23:55:00+10:00,2023-08-11,23:55,6,2,8
62,2023-08-12T03:08:00+10:00,2023-08-12,03:08,1,0,1
21,2023-08-11T23:58:00+10:00,2023-08-11,23:58,0,7,7
63,2023-08-12T02:55:00+10:00,2023-08-12,02:55,0,4,4
21,2023-08-12T00:02:00+10:00,2023-08-12,00:02,6,6,12
63,2023-08-12T03:01:00+10:00,2023-08-12,03:01,0,3,3
21,2023-08-12T00:04:00+10:00,2023-08-12,00:04,0,11,11
63,2023-08-12T03:03:00+10:00,2023-08-12,03:03,0,7,7
21,2023-08-12T00:05:00+10:00,2023-08-12,00:05,7,8,15
63,2023-08-12T03:05:00+10:00,2023-08-12,03:05,0,1,1
21,2023-08-12T00:09:00+10:00,2023-08-12,00:09,4,8,12
67,2023-08-12T02:57:00+10:00,2023-08-12,02:57,2,0,2
28,2023-08-12T00:02:00+10:00,2023-08-12,00:02,2,0,2
67,2023-08-12T02:59:00+10:00,2023-08-12,02:59,1,0,1
28,2023-08-12T00:04:00+10:00,2023-08-12,00:04,0,1,1
67,2023-08-12T03:01:00+10:00,2023-08-12,03:01,0,2,2
29,2023-08-12T00:02:00+10:00,2023-08-12,00:02,0,1,1
79,2023-08-12T03:05:00+10:00,2023-08-12,03:05,3,1,4
29,2023-08-12T00:05:00+10:00,2023-08-12,00:05,0,4,4
109,2023-08-12T03:00:00+10:00,2023-08-12,03:00,1,2,3
29,2023-08-12T00:08:00+10:00,2023-08-12,00:08,4,1,5
41,2023-08-12T00:03:00+10:00,2023-08-12,00:03,7,11,18
41,2023-08-12T00:05:00+10:00,2023-08-12,00:05,8,9,17
54,2023-08-11T23:56:00+10:00,2023-08-11,23:56,6,0,6
54,2023-08-12T00:02:00+10:00,2023-08-12,00:02,1,0,1
54,2023-08-12T00:05:00+10:00,2023-08-12,00:05,2,1,3
54,2023-08-12T00:07:00+10:00,2023-08-12,00:07,4,2,6
54,2023-08-12T00:09:00+10:00,2023-08-12,00:09,2,0,2
55,2023-08-11T23:56:00+10:00,2023-08-11,23:56,14,7,21
55,2023-08-12T00:01:00+10:00,2023-08-12,00:01,1,9,10
55,2023-08-12T00:03:00+10:00,2023-08-12,00:03,11,2,13
55,2023-08-12T00:04:00+10:00,2023-08-12,00:04,15,4,19
55,2023-08-12T00:08:00+10:00,2023-08-12,00:08,7,1,8
59,2023-08-11T23:55:00+10:00,2023-08-11,23:55,20,6,26
3,2023-08-12T03:10:00+10:00,2023-08-12,03:10,1,2,3
59,2023-08-12T00:05:00+10:00,2023-08-12,00:05,13,7,20
3,2023-08-12T03:11:00+10:00,2023-08-12,03:11,6,6,12
61,2023-08-11T23:59:00+10:00,2023-08-11,23:59,2,1,3
3,2023-08-12T03:17:00+10:00,2023-08-12,03:17,9,2,11
61,2023-08-12T00:00:00+10:00,2023-08-12,00:00,0,3,3
3,2023-08-12T03:21:00+10:00,2023-08-12,03:21,14,5,19
61,2023-08-12T00:03:00+10:00,2023-08-12,00:03,2,0,2
3,2023-08-12T03:22:00+10:00,2023-08-12,03:22,2,3,5
61,2023-08-12T00:04:00+10:00,2023-08-12,00:04,7,0,7
3,2023-08-12T03:24:00+10:00,2023-08-12,03:24,1,2,3
61,2023-08-12T00:05:00+10:00,2023-08-12,00:05,0,2,2
4,2023-08-12T03:13:00+10:00,2023-08-12,03:13,0,1,1
61,2023-08-12T00:07:00+10:00,2023-08-12,00:07,1,3,4
4,2023-08-12T03:14:00+10:00,2023-08-12,03:14,2,0,2
65,2023-08-11T23:55:00+10:00,2023-08-11,23:55,0,2,2
4,2023-08-12T03:17:00+10:00,2023-08-12,03:17,3,1,4
65,2023-08-11T23:56:00+10:00,2023-08-11,23:56,0,4,4
4,2023-08-12T03:20:00+10:00,2023-08-12,03:20,3,1,4
65,2023-08-11T23:58:00+10:00,2023-08-11,23:58,1,7,8
4,2023-08-12T03:22:00+10:00,2023-08-12,03:22,2,2,4
65,2023-08-12T00:02:00+10:00,2023-08-12,00:02,0,6,6
6,2023-08-12T03:11:00+10:00,2023-08-12,03:11,0,1,1
65,2023-08-12T00:03:00+10:00,2023-08-12,00:03,5,2,7
6,2023-08-12T03:19:00+10:00,2023-08-12,03:19,3,0,3
65,2023-08-12T00:04:00+10:00,2023-08-12,00:04,1,9,10
14,2023-08-12T03:10:00+10:00,2023-08-12,03:10,2,0,2
66,2023-08-11T23:55:00+10:00,2023-08-11,23:55,2,3,5
14,2023-08-12T03:12:00+10:00,2023-08-12,03:12,0,1,1
66,2023-08-11T23:59:00+10:00,2023-08-11,23:59,6,0,6
14,2023-08-12T03:15:00+10:00,2023-08-12,03:15,1,0,1
69,2023-08-12T00:02:00+10:00,2023-08-12,00:02,2,0,2
14,2023-08-12T03:18:00+10:00,2023-08-12,03:18,1,0,1
69,2023-08-12T00:06:00+10:00,2023-08-12,00:06,2,1,3
14,2023-08-12T03:23:00+10:00,2023-08-12,03:23,1,3,4
70,2023-08-12T00:01:00+10:00,2023-08-12,00:01,0,2,2
21,2023-08-12T03:10:00+10:00,2023-08-12,03:10,8,2,10
70,2023-08-12T00:06:00+10:00,2023-08-12,00:06,0,1,1
21,2023-08-12T03:12:00+10:00,2023-08-12,03:12,0,3,3
75,2023-08-11T23:57:00+10:00,2023-08-11,23:57,0,1,1
21,2023-08-12T03:16:00+10:00,2023-08-12,03:16,2,0,2
75,2023-08-11T23:58:00+10:00,2023-08-11,23:58,2,0,2
29,2023-08-12T03:11:00+10:00,2023-08-12,03:11,0,1,1
75,2023-08-12T00:00:00+10:00,2023-08-12,00:00,2,0,2
29,2023-08-12T03:21:00+10:00,2023-08-12,03:21,1,0,1
75,2023-08-12T00:04:00+10:00,2023-08-12,00:04,0,1,1
41,2023-08-12T03:11:00+10:00,2023-08-12,03:11,3,0,3
75,2023-08-12T00:07:00+10:00,2023-08-12,00:07,1,0,1
41,2023-08-12T03:16:00+10:00,2023-08-12,03:16,3,2,5
77,2023-08-11T23:55:00+10:00,2023-08-11,23:55,3,2,5
41,2023-08-12T03:24:00+10:00,2023-08-12,03:24,0,4,4
77,2023-08-12T00:02:00+10:00,2023-08-12,00:02,0,1,1
54,2023-08-12T03:13:00+10:00,2023-08-12,03:13,1,0,1
77,2023-08-12T00:04:00+10:00,2023-08-12,00:04,2,0,2
55,2023-08-12T03:10:00+10:00,2023-08-12,03:10,5,0,5
77,2023-08-12T00:08:00+10:00,2023-08-12,00:08,1,0,1
55,2023-08-12T03:16:00+10:00,2023-08-12,03:16,1,2,3
78,2023-08-12T00:01:00+10:00,2023-08-12,00:01,0,1,1
55,2023-08-12T03:17:00+10:00,2023-08-12,03:17,1,4,5
107,2023-08-12T00:00:00+10:00,2023-08-12,00:00,4,3,7
55,2023-08-12T03:18:00+10:00,2023-08-12,03:18,2,0,2
108,2023-08-12T00:00:00+10:00,2023-08-12,00:00,1,0,1
55,2023-08-12T03:21:00+10:00,2023-08-12,03:21,1,1,2
108,2023-08-12T00:05:00+10:00,2023-08-12,00:05,2,2,4
55,2023-08-12T03:22:00+10:00,2023-08-12,03:22,3,1,4
108,2023-08-12T00:06:00+10:00,2023-08-12,00:06,2,0,2
55,2023-08-12T03:24:00+10:00,2023-08-12,03:24,3,0,3
108,2023-08-12T00:08:00+10:00,2023-08-12,00:08,2,1,3
59,2023-08-12T03:10:00+10:00,2023-08-12,03:10,6,1,7
1,2023-08-11T23:55:00+10:00,2023-08-11,23:55,3,6,9
59,2023-08-12T03:15:00+10:00,2023-08-12,03:15,12,6,18
1,2023-08-11T23:56:00+10:00,2023-08-11,23:56,0,3,3
61,2023-08-12T03:22:00+10:00,2023-08-12,03:22,1,0,1
1,2023-08-11T23:59:00+10:00,2023-08-11,23:59,1,0,1
65,2023-08-12T03:16:00+10:00,2023-08-12,03:16,0,2,2
1,2023-08-12T00:06:00+10:00,2023-08-12,00:06,2,1,3
65,2023-08-12T03:20:00+10:00,2023-08-12,03:20,0,1,1
2,2023-08-11T23:59:00+10:00,2023-08-11,23:59,1,0,1
66,2023-08-12T03:14:00+10:00,2023-08-12,03:14,0,1,1
2,2023-08-12T00:03:00+10:00,2023-08-12,00:03,0,5,5
66,2023-08-12T03:16:00+10:00,2023-08-12,03:16,1,0,1
2,2023-08-12T00:04:00+10:00,2023-08-12,00:04,0,5,5
66,2023-08-12T03:18:00+10:00,2023-08-12,03:18,1,0,1
2,2023-08-12T00:05:00+10:00,2023-08-12,00:05,0,6,6
66,2023-08-12T03:24:00+10:00,2023-08-12,03:24,1,0,1
2,2023-08-12T00:09:00+10:00,2023-08-12,00:09,0,3,3
84,2023-08-12T03:10:00+10:00,2023-08-12,03:10,10,12,22
7,2023-08-12T00:01:00+10:00,2023-08-12,00:01,0,4,4
84,2023-08-12T03:20:00+10:00,2023-08-12,03:20,7,6,13
9,2023-08-12T00:05:00+10:00,2023-08-12,00:05,1,0,1
87,2023-08-12T03:19:00+10:00,2023-08-12,03:19,0,1,1
11,2023-08-12T00:00:00+10:00,2023-08-12,00:00,5,3,8
107,2023-08-12T03:20:00+10:00,2023-08-12,03:20,3,0,3
11,2023-08-12T00:05:00+10:00,2023-08-12,00:05,0,3,3
108,2023-08-12T03:21:00+10:00,2023-08-12,03:21,1,0,1
12,2023-08-12T00:02:00+10:00,2023-08-12,00:02,2,2,4
1,2023-08-12T03:10:00+10:00,2023-08-12,03:10,0,1,1
12,2023-08-12T00:07:00+10:00,2023-08-12,00:07,1,0,1
1,2023-08-12T03:13:00+10:00,2023-08-12,03:13,0,2,2
12,2023-08-12T00:09:00+10:00,2023-08-12,00:09,1,0,1
1,2023-08-12T03:14:00+10:00,2023-08-12,03:14,0,1,1
17,2023-08-11T23:55:00+10:00,2023-08-11,23:55,1,0,1
1,2023-08-12T03:24:00+10:00,2023-08-12,03:24,0,1,1
17,2023-08-11T23:57:00+10:00,2023-08-11,23:57,2,0,2
2,2023-08-12T03:19:00+10:00,2023-08-12,03:19,0,4,4
17,2023-08-11T23:59:00+10:00,2023-08-11,23:59,1,3,4
2,2023-08-12T03:23:00+10:00,2023-08-12,03:23,0,1,1
17,2023-08-12T00:07:00+10:00,2023-08-12,00:07,2,0,2
2,2023-08-12T03:24:00+10:00,2023-08-12,03:24,2,2,4
17,2023-08-12T00:09:00+10:00,2023-08-12,00:09,1,0,1
11,2023-08-12T03:15:00+10:00,2023-08-12,03:15,1,0,1
18,2023-08-12T00:00:00+10:00,2023-08-12,00:00,0,1,1
12,2023-08-12T03:16:00+10:00,2023-08-12,03:16,0,1,1
24,2023-08-12T00:05:00+10:00,2023-08-12,00:05,3,11,14
12,2023-08-12T03:20:00+10:00,2023-08-12,03:20,1,1,2
27,2023-08-11T23:58:00+10:00,2023-08-11,23:58,6,0,6
17,2023-08-12T03:12:00+10:00,2023-08-12,03:12,0,1,1
27,2023-08-12T00:01:00+10:00,2023-08-12,00:01,5,0,5
24,2023-08-12T03:13:00+10:00,2023-08-12,03:13,3,1,4
27,2023-08-12T00:06:00+10:00,2023-08-12,00:06,1,0,1
24,2023-08-12T03:14:00+10:00,2023-08-12,03:14,0,5,5
27,2023-08-12T00:07:00+10:00,2023-08-12,00:07,1,0,1
24,2023-08-12T03:16:00+10:00,2023-08-12,03:16,0,3,3
35,2023-08-11T23:55:00+10:00,2023-08-11,23:55,3,12,15
24,2023-08-12T03:21:00+10:00,2023-08-12,03:21,1,0,1
35,2023-08-11T23:56:00+10:00,2023-08-11,23:56,4,9,13
27,2023-08-12T03:24:00+10:00,2023-08-12,03:24,1,0,1
35,2023-08-12T00:00:00+10:00,2023-08-12,00:00,4,8,12
35,2023-08-12T03:14:00+10:00,2023-08-12,03:14,0,2,2
35,2023-08-12T00:02:00+10:00,2023-08-12,00:02,17,7,24
35,2023-08-12T03:20:00+10:00,2023-08-12,03:20,7,1,8
35,2023-08-12T00:03:00+10:00,2023-08-12,00:03,7,16,23
35,2023-08-12T03:21:00+10:00,2023-08-12,03:21,2,2,4
35,2023-08-12T00:06:00+10:00,2023-08-12,00:06,2,11,13
35,2023-08-12T03:23:00+10:00,2023-08-12,03:23,7,0,7
35,2023-08-12T00:07:00+10:00,2023-08-12,00:07,9,6,15
35,2023-08-12T03:24:00+10:00,2023-08-12,03:24,4,0,4
53,2023-08-11T23:58:00+10:00,2023-08-11,23:58,1,2,3
53,2023-08-12T03:11:00+10:00,2023-08-12,03:11,1,0,1
53,2023-08-11T23:59:00+10:00,2023-08-11,23:59,3,1,4
56,2023-08-12T03:20:00+10:00,2023-08-12,03:20,1,0,1
53,2023-08-12T00:00:00+10:00,2023-08-12,00:00,3,0,3
56,2023-08-12T03:23:00+10:00,2023-08-12,03:23,2,0,2
53,2023-08-12T00:01:00+10:00,2023-08-12,00:01,3,0,3
58,2023-08-12T03:11:00+10:00,2023-08-12,03:11,0,1,1
53,2023-08-12T00:07:00+10:00,2023-08-12,00:07,0,2,2
58,2023-08-12T03:12:00+10:00,2023-08-12,03:12,0,1,1
56,2023-08-12T00:00:00+10:00,2023-08-12,00:00,0,2,2
58,2023-08-12T03:15:00+10:00,2023-08-12,03:15,1,4,5
56,2023-08-12T00:05:00+10:00,2023-08-12,00:05,3,1,4
58,2023-08-12T03:21:00+10:00,2023-08-12,03:21,0,5,5
57,2023-08-12T00:08:00+10:00,2023-08-12,00:08,2,0,2
58,2023-08-12T03:22:00+10:00,2023-08-12,03:22,1,0,1
58,2023-08-11T23:58:00+10:00,2023-08-11,23:58,1,6,7
62,2023-08-12T03:11:00+10:00,2023-08-12,03:11,2,6,8
58,2023-08-11T23:59:00+10:00,2023-08-11,23:59,7,0,7
62,2023-08-12T03:23:00+10:00,2023-08-12,03:23,1,1,2
58,2023-08-12T00:04:00+10:00,2023-08-12,00:04,6,0,6
63,2023-08-12T03:11:00+10:00,2023-08-12,03:11,0,9,9
58,2023-08-12T00:05:00+10:00,2023-08-12,00:05,6,2,8
63,2023-08-12T03:12:00+10:00,2023-08-12,03:12,0,6,6
58,2023-08-12T00:07:00+10:00,2023-08-12,00:07,6,6,12
63,2023-08-12T03:13:00+10:00,2023-08-12,03:13,4,1,5
62,2023-08-11T23:59:00+10:00,2023-08-11,23:59,3,2,5
63,2023-08-12T03:16:00+10:00,2023-08-12,03:16,2,0,2
62,2023-08-12T00:00:00+10:00,2023-08-12,00:00,0,3,3
63,2023-08-12T03:20:00+10:00,2023-08-12,03:20,1,2,3
62,2023-08-12T00:02:00+10:00,2023-08-12,00:02,4,0,4
63,2023-08-12T03:22:00+10:00,2023-08-12,03:22,0,6,6
62,2023-08-12T00:06:00+10:00,2023-08-12,00:06,0,2,2
67,2023-08-12T03:10:00+10:00,2023-08-12,03:10,0,2,2
63,2023-08-11T23:55:00+10:00,2023-08-11,23:55,4,3,7
67,2023-08-12T03:13:00+10:00,2023-08-12,03:13,1,3,4
63,2023-08-12T00:01:00+10:00,2023-08-12,00:01,1,4,5
79,2023-08-12T03:16:00+10:00,2023-08-12,03:16,1,4,5
63,2023-08-12T00:03:00+10:00,2023-08-12,00:03,5,14,19
79,2023-08-12T03:17:00+10:00,2023-08-12,03:17,6,2,8
63,2023-08-12T00:04:00+10:00,2023-08-12,00:04,9,4,13
79,2023-08-12T03:21:00+10:00,2023-08-12,03:21,1,0,1
63,2023-08-12T00:08:00+10:00,2023-08-12,00:08,3,4,7
79,2023-08-12T03:22:00+10:00,2023-08-12,03:22,1,2,3
67,2023-08-11T23:57:00+10:00,2023-08-11,23:57,0,7,7
79,2023-08-12T03:24:00+10:00,2023-08-12,03:24,0,1,1
67,2023-08-11T23:58:00+10:00,2023-08-11,23:58,0,1,1
109,2023-08-12T03:20:00+10:00,2023-08-12,03:20,1,0,1
67,2023-08-12T00:00:00+10:00,2023-08-12,00:00,1,5,6
67,2023-08-12T00:02:00+10:00,2023-08-12,00:02,2,6,8
68,2023-08-11T23:58:00+10:00,2023-08-11,23:58,2,1,3
68,2023-08-12T00:01:00+10:00,2023-08-12,00:01,0,1,1
72,2023-08-11T23:55:00+10:00,2023-08-11,23:55,0,4,4
72,2023-08-12T00:00:00+10:00,2023-08-12,00:00,6,7,13
72,2023-08-12T00:02:00+10:00,2023-08-12,00:02,3,2,5
72,2023-08-12T00:05:00+10:00,2023-08-12,00:05,0,2,2
76,2023-08-12T00:00:00+10:00,2023-08-12,00:00,2,0,2
79,2023-08-11T23:55:00+10:00,2023-08-11,23:55,5,7,12
79,2023-08-11T23:56:00+10:00,2023-08-11,23:56,6,10,16
79,2023-08-11T23:59:00+10:00,2023-08-11,23:59,0,7,7
79,2023-08-12T00:01:00+10:00,2023-08-12,00:01,7,4,11
79,2023-08-12T00:02:00+10:00,2023-08-12,00:02,4,1,5
79,2023-08-12T00:04:00+10:00,2023-08-12,00:04,0,7,7
79,2023-08-12T00:09:00+10:00,2023-08-12,00:09,0,9,9
109,2023-08-11T23:55:00+10:00,2023-08-11,23:55,1,1,2
109,2023-08-12T00:00:00+10:00,2023-08-12,00:00,0,1,1
122,2023-08-11T23:56:00+10:00,2023-08-11,23:56,0,1,1
122,2023-08-12T00:03:00+10:00,2023-08-12,00:03,0,2,2
4,2023-08-12T03:35:00+10:00,2023-08-12,03:35,2,2,4
6,2023-08-12T03:25:00+10:00,2023-08-12,03:25,8,0,8
14,2023-08-12T03:35:00+10:00,2023-08-12,03:35,1,0,1
14,2023-08-12T03:39:00+10:00,2023-08-12,03:39,0,1,1
21,2023-08-12T03:29:00+10:00,2023-08-12,03:29,0,2,2
21,2023-08-12T03:31:00+10:00,2023-08-12,03:31,4,0,4
21,2023-08-12T03:34:00+10:00,2023-08-12,03:34,0,1,1
21,2023-08-12T03:36:00+10:00,2023-08-12,03:36,5,0,5
21,2023-08-12T03:38:00+10:00,2023-08-12,03:38,1,0,1
21,2023-08-12T03:39:00+10:00,2023-08-12,03:39,2,0,2
28,2023-08-12T03:33:00+10:00,2023-08-12,03:33,1,0,1
29,2023-08-12T03:26:00+10:00,2023-08-12,03:26,0,1,1
41,2023-08-12T03:31:00+10:00,2023-08-12,03:31,0,4,4
41,2023-08-12T03:34:00+10:00,2023-08-12,03:34,7,2,9
41,2023-08-12T03:37:00+10:00,2023-08-12,03:37,4,1,5
41,2023-08-12T03:38:00+10:00,2023-08-12,03:38,1,3,4
54,2023-08-12T03:31:00+10:00,2023-08-12,03:31,1,0,1
55,2023-08-12T03:28:00+10:00,2023-08-12,03:28,1,0,1
55,2023-08-12T03:30:00+10:00,2023-08-12,03:30,1,0,1
55,2023-08-12T03:32:00+10:00,2023-08-12,03:32,0,1,1
55,2023-08-12T03:37:00+10:00,2023-08-12,03:37,1,0,1
59,2023-08-12T03:35:00+10:00,2023-08-12,03:35,9,0,9
65,2023-08-12T03:27:00+10:00,2023-08-12,03:27,0,2,2
66,2023-08-12T03:34:00+10:00,2023-08-12,03:34,2,0,2
77,2023-08-12T03:30:00+10:00,2023-08-12,03:30,1,0,1
84,2023-08-12T03:30:00+10:00,2023-08-12,03:30,3,12,15
108,2023-08-12T03:27:00+10:00,2023-08-12,03:27,0,1,1
108,2023-08-12T03:34:00+10:00,2023-08-12,03:34,1,0,1
1,2023-08-12T03:32:00+10:00,2023-08-12,03:32,0,3,3
2,2023-08-12T03:25:00+10:00,2023-08-12,03:25,0,1,1
2,2023-08-12T03:26:00+10:00,2023-08-12,03:26,0,1,1
2,2023-08-12T03:30:00+10:00,2023-08-12,03:30,2,0,2
2,2023-08-12T03:36:00+10:00,2023-08-12,03:36,0,2,2
2,2023-08-12T03:37:00+10:00,2023-08-12,03:37,3,0,3
17,2023-08-12T03:31:00+10:00,2023-08-12,03:31,1,0,1
24,2023-08-12T03:26:00+10:00,2023-08-12,03:26,3,0,3
24,2023-08-12T03:36:00+10:00,2023-08-12,03:36,1,0,1
27,2023-08-12T03:26:00+10:00,2023-08-12,03:26,1,0,1
27,2023-08-12T03:29:00+10:00,2023-08-12,03:29,0,1,1
35,2023-08-12T03:29:00+10:00,2023-08-12,03:29,0,3,3
35,2023-08-12T03:38:00+10:00,2023-08-12,03:38,0,1,1
53,2023-08-12T03:29:00+10:00,2023-08-12,03:29,1,0,1
53,2023-08-12T03:31:00+10:00,2023-08-12,03:31,0,4,4
56,2023-08-12T03:28:00+10:00,2023-08-12,03:28,4,0,4
56,2023-08-12T03:30:00+10:00,2023-08-12,03:30,1,0,1
56,2023-08-12T03:33:00+10:00,2023-08-12,03:33,1,3,4
56,2023-08-12T03:35:00+10:00,2023-08-12,03:35,1,0,1
58,2023-08-12T03:36:00+10:00,2023-08-12,03:36,1,0,1
58,2023-08-12T03:37:00+10:00,2023-08-12,03:37,1,0,1
62,2023-08-12T03:28:00+10:00,2023-08-12,03:28,2,0,2
62,2023-08-12T03:29:00+10:00,2023-08-12,03:29,1,0,1
62,2023-08-12T03:30:00+10:00,2023-08-12,03:30,7,2,9
62,2023-08-12T03:33:00+10:00,2023-08-12,03:33,0,4,4
63,2023-08-12T03:25:00+10:00,2023-08-12,03:25,0,1,1
63,2023-08-12T03:28:00+10:00,2023-08-12,03:28,1,3,4
63,2023-08-12T03:34:00+10:00,2023-08-12,03:34,0,2,2
67,2023-08-12T03:26:00+10:00,2023-08-12,03:26,1,0,1
67,2023-08-12T03:38:00+10:00,2023-08-12,03:38,6,0,6
72,2023-08-12T03:36:00+10:00,2023-08-12,03:36,1,1,2
72,2023-08-12T03:37:00+10:00,2023-08-12,03:37,0,2,2
79,2023-08-12T03:26:00+10:00,2023-08-12,03:26,1,1,2
79,2023-08-12T03:31:00+10:00,2023-08-12,03:31,3,0,3
85,2023-08-12T03:32:00+10:00,2023-08-12,03:32,0,1,1
109,2023-08-12T03:35:00+10:00,2023-08-12,03:35,0,4,4
117,2023-08-12T03:25:00+10:00,2023-08-12,03:25,0,1,1
117,2023-08-12T03:30:00+10:00,2023-08-12,03:30,1,0,1
117,2023-08-12T03:35:00+10:00,2023-08-12,03:35,5,1,6
3,2023-08-12T03:40:00+10:00,2023-08-12,03:40,2,5,7
3,2023-08-12T03:46:00+10:00,2023-08-12,03:46,2,2,4
3,2023-08-12T03:47:00+10:00,2023-08-12,03:47,1,0,1
3,2023-08-12T03:53:00+10:00,2023-08-12,03:53,10,2,12
4,2023-08-12T03:48:00+10:00,2023-08-12,03:48,1,2,3
6,2023-08-12T03:40:00+10:00,2023-08-12,03:40,1,0,1
6,2023-08-12T03:41:00+10:00,2023-08-12,03:41,1,0,1
6,2023-08-12T03:45:00+10:00,2023-08-12,03:45,0,1,1
6,2023-08-12T03:46:00+10:00,2023-08-12,03:46,1,2,3
6,2023-08-12T03:50:00+10:00,2023-08-12,03:50,0,1,1
14,2023-08-12T03:40:00+10:00,2023-08-12,03:40,2,0,2
14,2023-08-12T03:41:00+10:00,2023-08-12,03:41,0,2,2
21,2023-08-12T03:41:00+10:00,2023-08-12,03:41,0,2,2
21,2023-08-12T03:42:00+10:00,2023-08-12,03:42,2,0,2
21,2023-08-12T03:48:00+10:00,2023-08-12,03:48,0,4,4
21,2023-08-12T03:53:00+10:00,2023-08-12,03:53,0,1,1
21,2023-08-12T03:54:00+10:00,2023-08-12,03:54,0,1,1
28,2023-08-12T03:48:00+10:00,2023-08-12,03:48,1,0,1
29,2023-08-12T03:41:00+10:00,2023-08-12,03:41,1,0,1
41,2023-08-12T03:43:00+10:00,2023-08-12,03:43,5,3,8
41,2023-08-12T03:44:00+10:00,2023-08-12,03:44,2,8,10
41,2023-08-12T03:46:00+10:00,2023-08-12,03:46,5,4,9
41,2023-08-12T03:48:00+10:00,2023-08-12,03:48,8,5,13
41,2023-08-12T03:52:00+10:00,2023-08-12,03:52,1,10,11
54,2023-08-12T03:40:00+10:00,2023-08-12,03:40,2,0,2
54,2023-08-12T03:50:00+10:00,2023-08-12,03:50,3,0,3
55,2023-08-12T03:40:00+10:00,2023-08-12,03:40,1,1,2
55,2023-08-12T03:43:00+10:00,2023-08-12,03:43,5,0,5
55,2023-08-12T03:52:00+10:00,2023-08-12,03:52,1,1,2
61,2023-08-12T03:44:00+10:00,2023-08-12,03:44,2,2,4
61,2023-08-12T03:46:00+10:00,2023-08-12,03:46,4,0,4
65,2023-08-12T03:48:00+10:00,2023-08-12,03:48,0,2,2
65,2023-08-12T03:49:00+10:00,2023-08-12,03:49,0,3,3
65,2023-08-12T03:51:00+10:00,2023-08-12,03:51,0,2,2
66,2023-08-12T03:48:00+10:00,2023-08-12,03:48,2,2,4
66,2023-08-12T03:50:00+10:00,2023-08-12,03:50,1,0,1
66,2023-08-12T03:52:00+10:00,2023-08-12,03:52,0,2,2
69,2023-08-12T03:44:00+10:00,2023-08-12,03:44,1,0,1
70,2023-08-12T03:46:00+10:00,2023-08-12,03:46,0,1,1
84,2023-08-12T03:40:00+10:00,2023-08-12,03:40,2,9,11
107,2023-08-12T03:50:00+10:00,2023-08-12,03:50,0,1,1
108,2023-08-12T03:44:00+10:00,2023-08-12,03:44,1,0,1
108,2023-08-12T03:53:00+10:00,2023-08-12,03:53,1,0,1
2,2023-08-12T03:53:00+10:00,2023-08-12,03:53,0,1,1
7,2023-08-12T03:44:00+10:00,2023-08-12,03:44,0,1,1
12,2023-08-12T03:42:00+10:00,2023-08-12,03:42,1,0,1
17,2023-08-12T03:48:00+10:00,2023-08-12,03:48,0,1,1
35,2023-08-12T03:45:00+10:00,2023-08-12,03:45,0,1,1
35,2023-08-12T03:47:00+10:00,2023-08-12,03:47,0,1,1
53,2023-08-12T03:43:00+10:00,2023-08-12,03:43,3,0,3
56,2023-08-12T03:40:00+10:00,2023-08-12,03:40,0,1,1
56,2023-08-12T03:41:00+10:00,2023-08-12,03:41,1,0,1
56,2023-08-12T03:45:00+10:00,2023-08-12,03:45,7,0,7
56,2023-08-12T03:47:00+10:00,2023-08-12,03:47,2,0,2
56,2023-08-12T03:52:00+10:00,2023-08-12,03:52,2,0,2
62,2023-08-12T03:41:00+10:00,2023-08-12,03:41,3,0,3
62,2023-08-12T03:44:00+10:00,2023-08-12,03:44,0,1,1
62,2023-08-12T03:54:00+10:00,2023-08-12,03:54,3,1,4
63,2023-08-12T03:45:00+10:00,2023-08-12,03:45,1,0,1
63,2023-08-12T03:46:00+10:00,2023-08-12,03:46,0,2,2
72,2023-08-12T03:53:00+10:00,2023-08-12,03:53,1,0,1
72,2023-08-12T03:54:00+10:00,2023-08-12,03:54,0,1,1
79,2023-08-12T03:42:00+10:00,2023-08-12,03:42,1,0,1
79,2023-08-12T03:44:00+10:00,2023-08-12,03:44,1,1,2
79,2023-08-12T03:48:00+10:00,2023-08-12,03:48,1,0,1
79,2023-08-12T03:51:00+10:00,2023-08-12,03:51,3,1,4
79,2023-08-12T03:53:00+10:00,2023-08-12,03:53,2,2,4
109,2023-08-12T03:45:00+10:00,2023-08-12,03:45,3,0,3
117,2023-08-12T03:40:00+10:00,2023-08-12,03:40,0,1,1
3,2023-08-12T03:59:00+10:00,2023-08-12,03:59,4,1,5
3,2023-08-12T04:03:00+10:00,2023-08-12,04:03,3,0,3
3,2023-08-12T04:04:00+10:00,2023-08-12,04:04,1,0,1
3,2023-08-12T04:08:00+10:00,2023-08-12,04:08,0,7,7
3,2023-08-12T04:09:00+10:00,2023-08-12,04:09,2,0,2
4,2023-08-12T03:57:00+10:00,2023-08-12,03:57,2,3,5
4,2023-08-12T03:59:00+10:00,2023-08-12,03:59,1,0,1
4,2023-08-12T04:03:00+10:00,2023-08-12,04:03,1,3,4
4,2023-08-12T04:06:00+10:00,2023-08-12,04:06,0,2,2
4,2023-08-12T04:08:00+10:00,2023-08-12,04:08,1,0,1
6,2023-08-12T04:00:00+10:00,2023-08-12,04:00,3,1,4
6,2023-08-12T04:02:00+10:00,2023-08-12,04:02,0,1,1
6,2023-08-12T04:03:00+10:00,2023-08-12,04:03,1,0,1
14,2023-08-12T04:00:00+10:00,2023-08-12,04:00,0,1,1
14,2023-08-12T04:06:00+10:00,2023-08-12,04:06,1,0,1
21,2023-08-12T03:58:00+10:00,2023-08-12,03:58,4,0,4
21,2023-08-12T04:01:00+10:00,2023-08-12,04:01,0,4,4
21,2023-08-12T04:04:00+10:00,2023-08-12,04:04,1,0,1
21,2023-08-12T04:05:00+10:00,2023-08-12,04:05,0,1,1
21,2023-08-12T04:09:00+10:00,2023-08-12,04:09,4,0,4
28,2023-08-12T04:03:00+10:00,2023-08-12,04:03,0,1,1
29,2023-08-12T03:57:00+10:00,2023-08-12,03:57,0,1,1
41,2023-08-12T03:55:00+10:00,2023-08-12,03:55,2,0,2
41,2023-08-12T03:56:00+10:00,2023-08-12,03:56,3,3,6
41,2023-08-12T03:57:00+10:00,2023-08-12,03:57,2,1,3
41,2023-08-12T03:58:00+10:00,2023-08-12,03:58,0,2,2
41,2023-08-12T04:03:00+10:00,2023-08-12,04:03,0,1,1
41,2023-08-12T04:06:00+10:00,2023-08-12,04:06,1,6,7
55,2023-08-12T03:57:00+10:00,2023-08-12,03:57,5,0,5
55,2023-08-12T03:58:00+10:00,2023-08-12,03:58,4,4,8
55,2023-08-12T04:00:00+10:00,2023-08-12,04:00,0,2,2
55,2023-08-12T04:01:00+10:00,2023-08-12,04:01,1,0,1
55,2023-08-12T04:03:00+10:00,2023-08-12,04:03,1,1,2
61,2023-08-12T04:00:00+10:00,2023-08-12,04:00,0,1,1
61,2023-08-12T04:02:00+10:00,2023-08-12,04:02,1,0,1
65,2023-08-12T03:59:00+10:00,2023-08-12,03:59,0,2,2
66,2023-08-12T03:56:00+10:00,2023-08-12,03:56,4,0,4
66,2023-08-12T04:00:00+10:00,2023-08-12,04:00,2,0,2
66,2023-08-12T04:06:00+10:00,2023-08-12,04:06,2,0,2
66,2023-08-12T04:09:00+10:00,2023-08-12,04:09,1,1,2
69,2023-08-12T04:08:00+10:00,2023-08-12,04:08,1,0,1
84,2023-08-12T03:55:00+10:00,2023-08-12,03:55,6,4,10
108,2023-08-12T04:09:00+10:00,2023-08-12,04:09,1,0,1
1,2023-08-12T04:07:00+10:00,2023-08-12,04:07,0,2,2
2,2023-08-12T04:02:00+10:00,2023-08-12,04:02,1,1,2
9,2023-08-12T03:58:00+10:00,2023-08-12,03:58,1,0,1
12,2023-08-12T04:02:00+10:00,2023-08-12,04:02,1,0,1
24,2023-08-12T03:56:00+10:00,2023-08-12,03:56,0,1,1
24,2023-08-12T04:00:00+10:00,2023-08-12,04:00,0,2,2
24,2023-08-12T04:01:00+10:00,2023-08-12,04:01,2,1,3
24,2023-08-12T04:02:00+10:00,2023-08-12,04:02,3,0,3
35,2023-08-12T03:56:00+10:00,2023-08-12,03:56,0,1,1
35,2023-08-12T03:58:00+10:00,2023-08-12,03:58,1,0,1
35,2023-08-12T04:01:00+10:00,2023-08-12,04:01,4,0,4
35,2023-08-12T04:08:00+10:00,2023-08-12,04:08,0,1,1
35,2023-08-12T04:09:00+10:00,2023-08-12,04:09,1,1,2
53,2023-08-12T04:01:00+10:00,2023-08-12,04:01,2,0,2
56,2023-08-12T04:05:00+10:00,2023-08-12,04:05,5,0,5
56,2023-08-12T04:08:00+10:00,2023-08-12,04:08,1,0,1
56,2023-08-12T04:09:00+10:00,2023-08-12,04:09,1,0,1
58,2023-08-12T04:05:00+10:00,2023-08-12,04:05,0,1,1
58,2023-08-12T04:07:00+10:00,2023-08-12,04:07,2,0,2
62,2023-08-12T03:55:00+10:00,2023-08-12,03:55,0,2,2
62,2023-08-12T03:56:00+10:00,2023-08-12,03:56,5,1,6
62,2023-08-12T03:59:00+10:00,2023-08-12,03:59,5,0,5
62,2023-08-12T04:00:00+10:00,2023-08-12,04:00,4,0,4
62,2023-08-12T04:01:00+10:00,2023-08-12,04:01,1,1,2
62,2023-08-12T04:04:00+10:00,2023-08-12,04:04,1,0,1
62,2023-08-12T04:07:00+10:00,2023-08-12,04:07,1,0,1
62,2023-08-12T04:08:00+10:00,2023-08-12,04:08,6,2,8
62,2023-08-12T04:09:00+10:00,2023-08-12,04:09,3,0,3
63,2023-08-12T04:03:00+10:00,2023-08-12,04:03,1,0,1
63,2023-08-12T04:05:00+10:00,2023-08-12,04:05,0,1,1
67,2023-08-12T04:03:00+10:00,2023-08-12,04:03,2,0,2
79,2023-08-12T04:02:00+10:00,2023-08-12,04:02,0,2,2
79,2023-08-12T04:08:00+10:00,2023-08-12,04:08,2,0,2
85,2023-08-12T04:00:00+10:00,2023-08-12,04:00,0,1,1
117,2023-08-12T04:05:00+10:00,2023-08-12,04:05,3,0,3
3,2023-08-12T00:17:00+10:00,2023-08-12,00:17,5,9,14
3,2023-08-12T00:24:00+10:00,2023-08-12,00:24,6,17,23
4,2023-08-12T00:10:00+10:00,2023-08-12,00:10,1,10,11
4,2023-08-12T00:11:00+10:00,2023-08-12,00:11,6,12,18
4,2023-08-12T00:12:00+10:00,2023-08-12,00:12,5,9,14
4,2023-08-12T00:15:00+10:00,2023-08-12,00:15,10,9,19
4,2023-08-12T00:21:00+10:00,2023-08-12,00:21,7,3,10
4,2023-08-12T00:24:00+10:00,2023-08-12,00:24,3,6,9
6,2023-08-12T00:10:00+10:00,2023-08-12,00:10,4,5,9
6,2023-08-12T00:15:00+10:00,2023-08-12,00:15,6,6,12
6,2023-08-12T00:19:00+10:00,2023-08-12,00:19,5,4,9
6,2023-08-12T00:20:00+10:00,2023-08-12,00:20,2,0,2
8,2023-08-12T00:12:00+10:00,2023-08-12,00:12,0,3,3
8,2023-08-12T00:15:00+10:00,2023-08-12,00:15,0,2,2
8,2023-08-12T00:18:00+10:00,2023-08-12,00:18,2,1,3
14,2023-08-12T00:13:00+10:00,2023-08-12,00:13,4,0,4
14,2023-08-12T00:15:00+10:00,2023-08-12,00:15,2,4,6
14,2023-08-12T00:19:00+10:00,2023-08-12,00:19,3,2,5
14,2023-08-12T00:20:00+10:00,2023-08-12,00:20,0,3,3
14,2023-08-12T00:23:00+10:00,2023-08-12,00:23,3,1,4
21,2023-08-12T00:10:00+10:00,2023-08-12,00:10,0,7,7
21,2023-08-12T00:11:00+10:00,2023-08-12,00:11,3,5,8
21,2023-08-12T00:12:00+10:00,2023-08-12,00:12,10,18,28
21,2023-08-12T00:13:00+10:00,2023-08-12,00:13,5,14,19
21,2023-08-12T00:14:00+10:00,2023-08-12,00:14,5,1,6
21,2023-08-12T00:15:00+10:00,2023-08-12,00:15,5,2,7
21,2023-08-12T00:16:00+10:00,2023-08-12,00:16,2,2,4
21,2023-08-12T00:21:00+10:00,2023-08-12,00:21,6,7,13
21,2023-08-12T00:23:00+10:00,2023-08-12,00:23,8,8,16
28,2023-08-12T00:20:00+10:00,2023-08-12,00:20,1,0,1
28,2023-08-12T00:21:00+10:00,2023-08-12,00:21,4,0,4
29,2023-08-12T00:12:00+10:00,2023-08-12,00:12,3,0,3
39,2023-08-12T00:24:00+10:00,2023-08-12,00:24,1,1,2
41,2023-08-12T00:10:00+10:00,2023-08-12,00:10,6,13,19
41,2023-08-12T00:11:00+10:00,2023-08-12,00:11,5,18,23
41,2023-08-12T00:12:00+10:00,2023-08-12,00:12,8,19,27
41,2023-08-12T00:13:00+10:00,2023-08-12,00:13,5,4,9
41,2023-08-12T00:16:00+10:00,2023-08-12,00:16,14,9,23
41,2023-08-12T00:22:00+10:00,2023-08-12,00:22,2,5,7
41,2023-08-12T00:23:00+10:00,2023-08-12,00:23,4,11,15
41,2023-08-12T00:24:00+10:00,2023-08-12,00:24,9,5,14
54,2023-08-12T00:11:00+10:00,2023-08-12,00:11,2,3,5
54,2023-08-12T00:15:00+10:00,2023-08-12,00:15,2,2,4
55,2023-08-12T00:10:00+10:00,2023-08-12,00:10,13,6,19
55,2023-08-12T00:13:00+10:00,2023-08-12,00:13,6,6,12
55,2023-08-12T00:16:00+10:00,2023-08-12,00:16,6,7,13
55,2023-08-12T00:19:00+10:00,2023-08-12,00:19,1,4,5
55,2023-08-12T00:24:00+10:00,2023-08-12,00:24,15,1,16
59,2023-08-12T00:15:00+10:00,2023-08-12,00:15,20,9,29
59,2023-08-12T00:20:00+10:00,2023-08-12,00:20,4,6,10
61,2023-08-12T00:10:00+10:00,2023-08-12,00:10,0,1,1
61,2023-08-12T00:11:00+10:00,2023-08-12,00:11,0,4,4
61,2023-08-12T00:12:00+10:00,2023-08-12,00:12,2,0,2
61,2023-08-12T00:13:00+10:00,2023-08-12,00:13,5,0,5
61,2023-08-12T00:18:00+10:00,2023-08-12,00:18,1,0,1
65,2023-08-12T00:12:00+10:00,2023-08-12,00:12,0,2,2
65,2023-08-12T00:13:00+10:00,2023-08-12,00:13,0,3,3
65,2023-08-12T00:15:00+10:00,2023-08-12,00:15,0,7,7
65,2023-08-12T00:16:00+10:00,2023-08-12,00:16,7,5,12
65,2023-08-12T00:18:00+10:00,2023-08-12,00:18,3,3,6
65,2023-08-12T00:22:00+10:00,2023-08-12,00:22,0,8,8
66,2023-08-12T00:12:00+10:00,2023-08-12,00:12,1,3,4
66,2023-08-12T00:13:00+10:00,2023-08-12,00:13,9,6,15
66,2023-08-12T00:16:00+10:00,2023-08-12,00:16,4,1,5
66,2023-08-12T00:17:00+10:00,2023-08-12,00:17,3,0,3
66,2023-08-12T00:23:00+10:00,2023-08-12,00:23,0,7,7
69,2023-08-12T00:12:00+10:00,2023-08-12,00:12,1,0,1
70,2023-08-12T00:10:00+10:00,2023-08-12,00:10,1,0,1
70,2023-08-12T00:24:00+10:00,2023-08-12,00:24,2,0,2
75,2023-08-12T00:12:00+10:00,2023-08-12,00:12,2,2,4
78,2023-08-12T00:14:00+10:00,2023-08-12,00:14,0,1,1
87,2023-08-12T00:10:00+10:00,2023-08-12,00:10,0,1,1
87,2023-08-12T00:22:00+10:00,2023-08-12,00:22,1,0,1
107,2023-08-12T00:20:00+10:00,2023-08-12,00:20,2,5,7
108,2023-08-12T00:11:00+10:00,2023-08-12,00:11,2,2,4
108,2023-08-12T00:13:00+10:00,2023-08-12,00:13,0,1,1
1,2023-08-12T00:10:00+10:00,2023-08-12,00:10,2,2,4
1,2023-08-12T00:12:00+10:00,2023-08-12,00:12,0,4,4
1,2023-08-12T00:20:00+10:00,2023-08-12,00:20,0,1,1
1,2023-08-12T00:24:00+10:00,2023-08-12,00:24,5,0,5
2,2023-08-12T00:14:00+10:00,2023-08-12,00:14,0,1,1
2,2023-08-12T00:16:00+10:00,2023-08-12,00:16,0,1,1
2,2023-08-12T00:17:00+10:00,2023-08-12,00:17,2,0,2
2,2023-08-12T00:18:00+10:00,2023-08-12,00:18,2,7,9
2,2023-08-12T00:22:00+10:00,2023-08-12,00:22,1,0,1
2,2023-08-12T00:23:00+10:00,2023-08-12,00:23,2,0,2
7,2023-08-12T00:14:00+10:00,2023-08-12,00:14,0,4,4
7,2023-08-12T00:16:00+10:00,2023-08-12,00:16,1,0,1
7,2023-08-12T00:18:00+10:00,2023-08-12,00:18,0,1,1
9,2023-08-12T00:22:00+10:00,2023-08-12,00:22,0,2,2
9,2023-08-12T00:24:00+10:00,2023-08-12,00:24,0,1,1
10,2023-08-12T00:20:00+10:00,2023-08-12,00:20,2,0,2
10,2023-08-12T00:22:00+10:00,2023-08-12,00:22,0,1,1
10,2023-08-12T00:23:00+10:00,2023-08-12,00:23,3,0,3
11,2023-08-12T00:10:00+10:00,2023-08-12,00:10,4,0,4
11,2023-08-12T00:19:00+10:00,2023-08-12,00:19,0,2,2
12,2023-08-12T00:10:00+10:00,2023-08-12,00:10,1,0,1
17,2023-08-12T00:11:00+10:00,2023-08-12,00:11,2,2,4
17,2023-08-12T00:13:00+10:00,2023-08-12,00:13,3,0,3
17,2023-08-12T00:14:00+10:00,2023-08-12,00:14,0,2,2
17,2023-08-12T00:23:00+10:00,2023-08-12,00:23,1,0,1
24,2023-08-12T00:11:00+10:00,2023-08-12,00:11,0,1,1
24,2023-08-12T00:14:00+10:00,2023-08-12,00:14,3,9,12
24,2023-08-12T00:20:00+10:00,2023-08-12,00:20,1,0,1
24,2023-08-12T00:22:00+10:00,2023-08-12,00:22,6,10,16
27,2023-08-12T00:11:00+10:00,2023-08-12,00:11,3,0,3
27,2023-08-12T00:15:00+10:00,2023-08-12,00:15,2,0,2
27,2023-08-12T00:16:00+10:00,2023-08-12,00:16,1,0,1
27,2023-08-12T00:21:00+10:00,2023-08-12,00:21,2,0,2
35,2023-08-12T00:11:00+10:00,2023-08-12,00:11,3,9,12
35,2023-08-12T00:14:00+10:00,2023-08-12,00:14,4,5,9
35,2023-08-12T00:20:00+10:00,2023-08-12,00:20,5,3,8
35,2023-08-12T00:21:00+10:00,2023-08-12,00:21,5,3,8
53,2023-08-12T00:13:00+10:00,2023-08-12,00:13,0,8,8
56,2023-08-12T00:16:00+10:00,2023-08-12,00:16,1,0,1
56,2023-08-12T00:18:00+10:00,2023-08-12,00:18,4,1,5
56,2023-08-12T00:21:00+10:00,2023-08-12,00:21,1,1,2
58,2023-08-12T00:11:00+10:00,2023-08-12,00:11,2,4,6
58,2023-08-12T00:12:00+10:00,2023-08-12,00:12,1,0,1
58,2023-08-12T00:13:00+10:00,2023-08-12,00:13,2,3,5
58,2023-08-12T00:18:00+10:00,2023-08-12,00:18,5,3,8
62,2023-08-12T00:11:00+10:00,2023-08-12,00:11,0,1,1
62,2023-08-12T00:15:00+10:00,2023-08-12,00:15,5,0,5
62,2023-08-12T00:19:00+10:00,2023-08-12,00:19,0,1,1
62,2023-08-12T00:21:00+10:00,2023-08-12,00:21,1,0,1
63,2023-08-12T00:10:00+10:00,2023-08-12,00:10,0,2,2
63,2023-08-12T00:12:00+10:00,2023-08-12,00:12,1,4,5
63,2023-08-12T00:13:00+10:00,2023-08-12,00:13,0,2,2
63,2023-08-12T00:17:00+10:00,2023-08-12,00:17,0,7,7
63,2023-08-12T00:24:00+10:00,2023-08-12,00:24,4,5,9
67,2023-08-12T00:11:00+10:00,2023-08-12,00:11,0,3,3
67,2023-08-12T00:15:00+10:00,2023-08-12,00:15,1,2,3
67,2023-08-12T00:22:00+10:00,2023-08-12,00:22,2,0,2
67,2023-08-12T00:23:00+10:00,2023-08-12,00:23,0,1,1
72,2023-08-12T00:15:00+10:00,2023-08-12,00:15,2,1,3
72,2023-08-12T00:22:00+10:00,2023-08-12,00:22,4,1,5
72,2023-08-12T00:24:00+10:00,2023-08-12,00:24,1,2,3
79,2023-08-12T00:11:00+10:00,2023-08-12,00:11,3,3,6
79,2023-08-12T00:12:00+10:00,2023-08-12,00:12,7,7,14
79,2023-08-12T00:19:00+10:00,2023-08-12,00:19,1,9,10
79,2023-08-12T00:21:00+10:00,2023-08-12,00:21,2,7,9
79,2023-08-12T00:23:00+10:00,2023-08-12,00:23,2,1,3
79,2023-08-12T00:24:00+10:00,2023-08-12,00:24,0,3,3
109,2023-08-12T00:20:00+10:00,2023-08-12,00:20,6,3,9
117,2023-08-12T00:10:00+10:00,2023-08-12,00:10,2,11,13
117,2023-08-12T00:20:00+10:00,2023-08-12,00:20,3,2,5
122,2023-08-12T00:18:00+10:00,2023-08-12,00:18,0,1,1
3,2023-08-12T00:46:00+10:00,2023-08-12,00:46,5,2,7
3,2023-08-12T00:47:00+10:00,2023-08-12,00:47,13,11,24
3,2023-08-12T00:48:00+10:00,2023-08-12,00:48,10,11,21
3,2023-08-12T00:49:00+10:00,2023-08-12,00:49,7,12,19
3,2023-08-12T00:50:00+10:00,2023-08-12,00:50,4,4,8
3,2023-08-12T00:52:00+10:00,2023-08-12,00:52,4,12,16
3,2023-08-12T00:53:00+10:00,2023-08-12,00:53,12,4,16
3,2023-08-12T00:54:00+10:00,2023-08-12,00:54,6,4,10
4,2023-08-12T00:44:00+10:00,2023-08-12,00:44,11,7,18
4,2023-08-12T00:45:00+10:00,2023-08-12,00:45,1,4,5
4,2023-08-12T00:46:00+10:00,2023-08-12,00:46,3,4,7
4,2023-08-12T00:53:00+10:00,2023-08-12,00:53,2,7,9
6,2023-08-12T00:42:00+10:00,2023-08-12,00:42,3,2,5
6,2023-08-12T00:50:00+10:00,2023-08-12,00:50,1,0,1
6,2023-08-12T00:52:00+10:00,2023-08-12,00:52,1,4,5
6,2023-08-12T00:54:00+10:00,2023-08-12,00:54,5,5,10
8,2023-08-12T00:44:00+10:00,2023-08-12,00:44,0,1,1
14,2023-08-12T00:41:00+10:00,2023-08-12,00:41,1,1,2
14,2023-08-12T00:46:00+10:00,2023-08-12,00:46,1,2,3
14,2023-08-12T00:51:00+10:00,2023-08-12,00:51,11,1,12
14,2023-08-12T00:53:00+10:00,2023-08-12,00:53,1,0,1
21,2023-08-12T00:40:00+10:00,2023-08-12,00:40,3,5,8
21,2023-08-12T00:41:00+10:00,2023-08-12,00:41,3,5,8
21,2023-08-12T00:42:00+10:00,2023-08-12,00:42,0,10,10
21,2023-08-12T00:44:00+10:00,2023-08-12,00:44,2,3,5
28,2023-08-12T00:52:00+10:00,2023-08-12,00:52,3,0,3
28,2023-08-12T00:53:00+10:00,2023-08-12,00:53,0,1,1
29,2023-08-12T00:49:00+10:00,2023-08-12,00:49,0,1,1
29,2023-08-12T00:50:00+10:00,2023-08-12,00:50,0,1,1
29,2023-08-12T00:54:00+10:00,2023-08-12,00:54,1,1,2
41,2023-08-12T00:43:00+10:00,2023-08-12,00:43,0,6,6
41,2023-08-12T00:45:00+10:00,2023-08-12,00:45,8,5,13
41,2023-08-12T00:48:00+10:00,2023-08-12,00:48,9,1,10
41,2023-08-12T00:52:00+10:00,2023-08-12,00:52,16,1,17
54,2023-08-12T00:49:00+10:00,2023-08-12,00:49,1,0,1
55,2023-08-12T00:44:00+10:00,2023-08-12,00:44,5,2,7
55,2023-08-12T00:46:00+10:00,2023-08-12,00:46,8,4,12
55,2023-08-12T00:50:00+10:00,2023-08-12,00:50,5,2,7
55,2023-08-12T00:51:00+10:00,2023-08-12,00:51,2,0,2
61,2023-08-12T00:42:00+10:00,2023-08-12,00:42,0,1,1
61,2023-08-12T00:47:00+10:00,2023-08-12,00:47,1,0,1
61,2023-08-12T00:52:00+10:00,2023-08-12,00:52,0,1,1
65,2023-08-12T00:40:00+10:00,2023-08-12,00:40,2,0,2
65,2023-08-12T00:41:00+10:00,2023-08-12,00:41,0,6,6
65,2023-08-12T00:45:00+10:00,2023-08-12,00:45,0,2,2
65,2023-08-12T00:50:00+10:00,2023-08-12,00:50,0,1,1
66,2023-08-12T00:41:00+10:00,2023-08-12,00:41,8,3,11
66,2023-08-12T00:50:00+10:00,2023-08-12,00:50,1,4,5
66,2023-08-12T00:53:00+10:00,2023-08-12,00:53,2,0,2
66,2023-08-12T00:54:00+10:00,2023-08-12,00:54,4,2,6
70,2023-08-12T00:53:00+10:00,2023-08-12,00:53,0,3,3
78,2023-08-12T00:44:00+10:00,2023-08-12,00:44,0,1,1
78,2023-08-12T00:53:00+10:00,2023-08-12,00:53,1,0,1
84,2023-08-12T00:40:00+10:00,2023-08-12,00:40,17,17,34
84,2023-08-12T00:50:00+10:00,2023-08-12,00:50,8,24,32
87,2023-08-12T00:45:00+10:00,2023-08-12,00:45,1,2,3
87,2023-08-12T00:52:00+10:00,2023-08-12,00:52,1,0,1
108,2023-08-12T00:48:00+10:00,2023-08-12,00:48,4,0,4
108,2023-08-12T00:53:00+10:00,2023-08-12,00:53,2,1,3
1,2023-08-12T00:40:00+10:00,2023-08-12,00:40,1,3,4
1,2023-08-12T00:43:00+10:00,2023-08-12,00:43,1,6,7
2,2023-08-12T00:45:00+10:00,2023-08-12,00:45,2,2,4
2,2023-08-12T00:51:00+10:00,2023-08-12,00:51,1,0,1
7,2023-08-12T00:51:00+10:00,2023-08-12,00:51,0,1,1
9,2023-08-12T00:52:00+10:00,2023-08-12,00:52,3,0,3
10,2023-08-12T00:50:00+10:00,2023-08-12,00:50,0,1,1
11,2023-08-12T00:43:00+10:00,2023-08-12,00:43,0,3,3
12,2023-08-12T00:40:00+10:00,2023-08-12,00:40,0,2,2
17,2023-08-12T00:44:00+10:00,2023-08-12,00:44,0,1,1
17,2023-08-12T00:48:00+10:00,2023-08-12,00:48,1,0,1
17,2023-08-12T00:51:00+10:00,2023-08-12,00:51,1,0,1
17,2023-08-12T00:52:00+10:00,2023-08-12,00:52,0,5,5
18,2023-08-12T00:45:00+10:00,2023-08-12,00:45,0,1,1
24,2023-08-12T00:44:00+10:00,2023-08-12,00:44,1,0,1
24,2023-08-12T00:48:00+10:00,2023-08-12,00:48,4,2,6
24,2023-08-12T00:51:00+10:00,2023-08-12,00:51,1,4,5
35,2023-08-12T00:40:00+10:00,2023-08-12,00:40,1,3,4
35,2023-08-12T00:44:00+10:00,2023-08-12,00:44,0,5,5
35,2023-08-12T00:47:00+10:00,2023-08-12,00:47,12,7,19
35,2023-08-12T00:48:00+10:00,2023-08-12,00:48,2,2,4
35,2023-08-12T00:50:00+10:00,2023-08-12,00:50,7,7,14
35,2023-08-12T00:51:00+10:00,2023-08-12,00:51,3,2,5
35,2023-08-12T00:52:00+10:00,2023-08-12,00:52,0,1,1
35,2023-08-12T00:54:00+10:00,2023-08-12,00:54,3,6,9
53,2023-08-12T00:44:00+10:00,2023-08-12,00:44,0,3,3
53,2023-08-12T00:49:00+10:00,2023-08-12,00:49,2,0,2
53,2023-08-12T00:51:00+10:00,2023-08-12,00:51,0,2,2
53,2023-08-12T00:53:00+10:00,2023-08-12,00:53,1,0,1
56,2023-08-12T00:45:00+10:00,2023-08-12,00:45,1,0,1
56,2023-08-12T00:47:00+10:00,2023-08-12,00:47,4,0,4
56,2023-08-12T00:48:00+10:00,2023-08-12,00:48,0,1,1
56,2023-08-12T00:51:00+10:00,2023-08-12,00:51,3,6,9
56,2023-08-12T00:52:00+10:00,2023-08-12,00:52,3,1,4
58,2023-08-12T00:43:00+10:00,2023-08-12,00:43,0,3,3
58,2023-08-12T00:52:00+10:00,2023-08-12,00:52,1,0,1
58,2023-08-12T00:54:00+10:00,2023-08-12,00:54,1,1,2
62,2023-08-12T00:41:00+10:00,2023-08-12,00:41,2,1,3
62,2023-08-12T00:43:00+10:00,2023-08-12,00:43,2,1,3
62,2023-08-12T00:53:00+10:00,2023-08-12,00:53,1,0,1
63,2023-08-12T00:40:00+10:00,2023-08-12,00:40,1,5,6
63,2023-08-12T00:41:00+10:00,2023-08-12,00:41,2,2,4
63,2023-08-12T00:42:00+10:00,2023-08-12,00:42,3,2,5
63,2023-08-12T00:54:00+10:00,2023-08-12,00:54,0,5,5
67,2023-08-12T00:44:00+10:00,2023-08-12,00:44,6,3,9
67,2023-08-12T00:49:00+10:00,2023-08-12,00:49,1,1,2
67,2023-08-12T00:54:00+10:00,2023-08-12,00:54,0,2,2
72,2023-08-12T00:54:00+10:00,2023-08-12,00:54,0,10,10
79,2023-08-12T00:44:00+10:00,2023-08-12,00:44,2,9,11
79,2023-08-12T00:48:00+10:00,2023-08-12,00:48,5,6,11
79,2023-08-12T00:51:00+10:00,2023-08-12,00:51,3,2,5
85,2023-08-12T00:47:00+10:00,2023-08-12,00:47,1,0,1
85,2023-08-12T00:52:00+10:00,2023-08-12,00:52,1,0,1
109,2023-08-12T00:40:00+10:00,2023-08-12,00:40,0,6,6
109,2023-08-12T00:45:00+10:00,2023-08-12,00:45,0,4,4
122,2023-08-12T00:46:00+10:00,2023-08-12,00:46,0,1,1
122,2023-08-12T00:54:00+10:00,2023-08-12,00:54,3,2,5
3,2023-08-12T00:28:00+10:00,2023-08-12,00:28,7,12,19
3,2023-08-12T00:34:00+10:00,2023-08-12,00:34,5,6,11
3,2023-08-12T00:38:00+10:00,2023-08-12,00:38,11,10,21
4,2023-08-12T00:25:00+10:00,2023-08-12,00:25,1,2,3
4,2023-08-12T00:26:00+10:00,2023-08-12,00:26,5,4,9
4,2023-08-12T00:29:00+10:00,2023-08-12,00:29,4,7,11
4,2023-08-12T00:30:00+10:00,2023-08-12,00:30,4,5,9
4,2023-08-12T00:34:00+10:00,2023-08-12,00:34,0,2,2
4,2023-08-12T00:35:00+10:00,2023-08-12,00:35,0,6,6
4,2023-08-12T00:37:00+10:00,2023-08-12,00:37,2,2,4
4,2023-08-12T00:38:00+10:00,2023-08-12,00:38,3,3,6
6,2023-08-12T00:30:00+10:00,2023-08-12,00:30,9,1,10
6,2023-08-12T00:31:00+10:00,2023-08-12,00:31,9,6,15
6,2023-08-12T00:35:00+10:00,2023-08-12,00:35,2,5,7
6,2023-08-12T00:39:00+10:00,2023-08-12,00:39,4,1,5
8,2023-08-12T00:31:00+10:00,2023-08-12,00:31,0,1,1
14,2023-08-12T00:27:00+10:00,2023-08-12,00:27,9,0,9
14,2023-08-12T00:29:00+10:00,2023-08-12,00:29,3,0,3
14,2023-08-12T00:32:00+10:00,2023-08-12,00:32,2,0,2
14,2023-08-12T00:33:00+10:00,2023-08-12,00:33,2,0,2
21,2023-08-12T00:25:00+10:00,2023-08-12,00:25,4,9,13
21,2023-08-12T00:30:00+10:00,2023-08-12,00:30,6,4,10
21,2023-08-12T00:32:00+10:00,2023-08-12,00:32,9,4,13
21,2023-08-12T00:33:00+10:00,2023-08-12,00:33,6,4,10
21,2023-08-12T00:34:00+10:00,2023-08-12,00:34,1,16,17
21,2023-08-12T00:36:00+10:00,2023-08-12,00:36,2,2,4
28,2023-08-12T00:35:00+10:00,2023-08-12,00:35,3,0,3
29,2023-08-12T00:34:00+10:00,2023-08-12,00:34,0,1,1
41,2023-08-12T00:25:00+10:00,2023-08-12,00:25,11,1,12
41,2023-08-12T00:31:00+10:00,2023-08-12,00:31,2,7,9
41,2023-08-12T00:32:00+10:00,2023-08-12,00:32,1,3,4
41,2023-08-12T00:34:00+10:00,2023-08-12,00:34,5,10,15
41,2023-08-12T00:36:00+10:00,2023-08-12,00:36,2,14,16
41,2023-08-12T00:37:00+10:00,2023-08-12,00:37,2,2,4
41,2023-08-12T00:38:00+10:00,2023-08-12,00:38,9,4,13
41,2023-08-12T00:39:00+10:00,2023-08-12,00:39,2,9,11
54,2023-08-12T00:30:00+10:00,2023-08-12,00:30,0,2,2
55,2023-08-12T00:28:00+10:00,2023-08-12,00:28,4,3,7
55,2023-08-12T00:29:00+10:00,2023-08-12,00:29,7,2,9
55,2023-08-12T00:32:00+10:00,2023-08-12,00:32,4,11,15
55,2023-08-12T00:39:00+10:00,2023-08-12,00:39,6,3,9
59,2023-08-12T00:30:00+10:00,2023-08-12,00:30,16,1,17
59,2023-08-12T00:35:00+10:00,2023-08-12,00:35,12,2,14
61,2023-08-12T00:29:00+10:00,2023-08-12,00:29,1,0,1
61,2023-08-12T00:32:00+10:00,2023-08-12,00:32,0,1,1
61,2023-08-12T00:34:00+10:00,2023-08-12,00:34,0,1,1
61,2023-08-12T00:37:00+10:00,2023-08-12,00:37,1,0,1
61,2023-08-12T00:38:00+10:00,2023-08-12,00:38,1,4,5
65,2023-08-12T00:25:00+10:00,2023-08-12,00:25,1,5,6
65,2023-08-12T00:27:00+10:00,2023-08-12,00:27,0,4,4
65,2023-08-12T00:30:00+10:00,2023-08-12,00:30,5,2,7
65,2023-08-12T00:36:00+10:00,2023-08-12,00:36,0,8,8
66,2023-08-12T00:27:00+10:00,2023-08-12,00:27,8,2,10
66,2023-08-12T00:28:00+10:00,2023-08-12,00:28,10,3,13
66,2023-08-12T00:29:00+10:00,2023-08-12,00:29,0,6,6
66,2023-08-12T00:31:00+10:00,2023-08-12,00:31,0,6,6
66,2023-08-12T00:38:00+10:00,2023-08-12,00:38,9,0,9
66,2023-08-12T00:39:00+10:00,2023-08-12,00:39,0,1,1
69,2023-08-12T00:35:00+10:00,2023-08-12,00:35,0,2,2
70,2023-08-12T00:25:00+10:00,2023-08-12,00:25,0,3,3
75,2023-08-12T00:25:00+10:00,2023-08-12,00:25,2,0,2
75,2023-08-12T00:31:00+10:00,2023-08-12,00:31,2,0,2
75,2023-08-12T00:37:00+10:00,2023-08-12,00:37,0,2,2
78,2023-08-12T00:26:00+10:00,2023-08-12,00:26,0,1,1
84,2023-08-12T00:35:00+10:00,2023-08-12,00:35,40,37,77
87,2023-08-12T00:28:00+10:00,2023-08-12,00:28,1,0,1
108,2023-08-12T00:25:00+10:00,2023-08-12,00:25,0,1,1
108,2023-08-12T00:33:00+10:00,2023-08-12,00:33,2,1,3
108,2023-08-12T00:35:00+10:00,2023-08-12,00:35,5,3,8
1,2023-08-12T00:30:00+10:00,2023-08-12,00:30,5,1,6
1,2023-08-12T00:35:00+10:00,2023-08-12,00:35,2,0,2
1,2023-08-12T00:38:00+10:00,2023-08-12,00:38,1,0,1
2,2023-08-12T00:27:00+10:00,2023-08-12,00:27,0,1,1
2,2023-08-12T00:30:00+10:00,2023-08-12,00:30,1,2,3
2,2023-08-12T00:39:00+10:00,2023-08-12,00:39,0,2,2
7,2023-08-12T00:36:00+10:00,2023-08-12,00:36,0,3,3
7,2023-08-12T00:39:00+10:00,2023-08-12,00:39,0,1,1
9,2023-08-12T00:25:00+10:00,2023-08-12,00:25,0,1,1
9,2023-08-12T00:26:00+10:00,2023-08-12,00:26,0,1,1
9,2023-08-12T00:29:00+10:00,2023-08-12,00:29,2,0,2
11,2023-08-12T00:25:00+10:00,2023-08-12,00:25,1,0,1
11,2023-08-12T00:31:00+10:00,2023-08-12,00:31,1,0,1
12,2023-08-12T00:31:00+10:00,2023-08-12,00:31,1,0,1
17,2023-08-12T00:28:00+10:00,2023-08-12,00:28,2,0,2
17,2023-08-12T00:29:00+10:00,2023-08-12,00:29,0,3,3
17,2023-08-12T00:30:00+10:00,2023-08-12,00:30,1,2,3
17,2023-08-12T00:37:00+10:00,2023-08-12,00:37,4,0,4
18,2023-08-12T00:38:00+10:00,2023-08-12,00:38,0,2,2
24,2023-08-12T00:25:00+10:00,2023-08-12,00:25,1,1,2
24,2023-08-12T00:26:00+10:00,2023-08-12,00:26,1,11,12
24,2023-08-12T00:27:00+10:00,2023-08-12,00:27,4,6,10
24,2023-08-12T00:28:00+10:00,2023-08-12,00:28,3,0,3
24,2023-08-12T00:31:00+10:00,2023-08-12,00:31,6,8,14
24,2023-08-12T00:33:00+10:00,2023-08-12,00:33,1,0,1
24,2023-08-12T00:35:00+10:00,2023-08-12,00:35,4,0,4
24,2023-08-12T00:37:00+10:00,2023-08-12,00:37,7,1,8
24,2023-08-12T00:39:00+10:00,2023-08-12,00:39,5,1,6
27,2023-08-12T00:25:00+10:00,2023-08-12,00:25,0,2,2
27,2023-08-12T00:31:00+10:00,2023-08-12,00:31,3,0,3
35,2023-08-12T00:25:00+10:00,2023-08-12,00:25,11,7,18
35,2023-08-12T00:27:00+10:00,2023-08-12,00:27,5,6,11
35,2023-08-12T00:33:00+10:00,2023-08-12,00:33,2,5,7
35,2023-08-12T00:36:00+10:00,2023-08-12,00:36,4,0,4
53,2023-08-12T00:27:00+10:00,2023-08-12,00:27,0,2,2
53,2023-08-12T00:28:00+10:00,2023-08-12,00:28,0,2,2
53,2023-08-12T00:36:00+10:00,2023-08-12,00:36,0,2,2
56,2023-08-12T00:26:00+10:00,2023-08-12,00:26,0,5,5
57,2023-08-12T00:28:00+10:00,2023-08-12,00:28,2,0,2
57,2023-08-12T00:38:00+10:00,2023-08-12,00:38,0,2,2
58,2023-08-12T00:25:00+10:00,2023-08-12,00:25,7,1,8
58,2023-08-12T00:27:00+10:00,2023-08-12,00:27,1,3,4
58,2023-08-12T00:28:00+10:00,2023-08-12,00:28,2,9,11
58,2023-08-12T00:32:00+10:00,2023-08-12,00:32,0,1,1
58,2023-08-12T00:33:00+10:00,2023-08-12,00:33,4,2,6
58,2023-08-12T00:36:00+10:00,2023-08-12,00:36,2,0,2
58,2023-08-12T00:38:00+10:00,2023-08-12,00:38,1,0,1
58,2023-08-12T00:39:00+10:00,2023-08-12,00:39,2,0,2
63,2023-08-12T00:29:00+10:00,2023-08-12,00:29,4,0,4
63,2023-08-12T00:33:00+10:00,2023-08-12,00:33,3,7,10
67,2023-08-12T00:25:00+10:00,2023-08-12,00:25,1,0,1
67,2023-08-12T00:27:00+10:00,2023-08-12,00:27,1,5,6
67,2023-08-12T00:31:00+10:00,2023-08-12,00:31,0,5,5
67,2023-08-12T00:34:00+10:00,2023-08-12,00:34,0,4,4
67,2023-08-12T00:36:00+10:00,2023-08-12,00:36,0,4,4
67,2023-08-12T00:39:00+10:00,2023-08-12,00:39,1,1,2
72,2023-08-12T00:25:00+10:00,2023-08-12,00:25,0,3,3
72,2023-08-12T00:27:00+10:00,2023-08-12,00:27,0,3,3
72,2023-08-12T00:29:00+10:00,2023-08-12,00:29,0,2,2
72,2023-08-12T00:30:00+10:00,2023-08-12,00:30,1,2,3
72,2023-08-12T00:32:00+10:00,2023-08-12,00:32,1,0,1
72,2023-08-12T00:35:00+10:00,2023-08-12,00:35,0,1,1
76,2023-08-12T00:27:00+10:00,2023-08-12,00:27,0,4,4
76,2023-08-12T00:30:00+10:00,2023-08-12,00:30,1,0,1
79,2023-08-12T00:27:00+10:00,2023-08-12,00:27,1,10,11
79,2023-08-12T00:28:00+10:00,2023-08-12,00:28,0,3,3
79,2023-08-12T00:30:00+10:00,2023-08-12,00:30,3,0,3
85,2023-08-12T00:28:00+10:00,2023-08-12,00:28,0,1,1
122,2023-08-12T00:37:00+10:00,2023-08-12,00:37,0,1,1
3,2023-08-12T00:58:00+10:00,2023-08-12,00:58,5,3,8
3,2023-08-12T01:01:00+10:00,2023-08-12,01:01,6,4,10
3,2023-08-12T01:04:00+10:00,2023-08-12,01:04,13,4,17
3,2023-08-12T01:08:00+10:00,2023-08-12,01:08,13,7,20
3,2023-08-12T01:09:00+10:00,2023-08-12,01:09,13,3,16
4,2023-08-12T00:56:00+10:00,2023-08-12,00:56,2,11,13
4,2023-08-12T00:57:00+10:00,2023-08-12,00:57,7,8,15
4,2023-08-12T01:02:00+10:00,2023-08-12,01:02,1,2,3
4,2023-08-12T01:05:00+10:00,2023-08-12,01:05,4,6,10
4,2023-08-12T01:07:00+10:00,2023-08-12,01:07,3,7,10
4,2023-08-12T01:08:00+10:00,2023-08-12,01:08,5,8,13
6,2023-08-12T00:55:00+10:00,2023-08-12,00:55,4,1,5
6,2023-08-12T00:56:00+10:00,2023-08-12,00:56,3,0,3
6,2023-08-12T00:58:00+10:00,2023-08-12,00:58,1,0,1
6,2023-08-12T01:03:00+10:00,2023-08-12,01:03,2,3,5
6,2023-08-12T01:04:00+10:00,2023-08-12,01:04,1,1,2
6,2023-08-12T01:05:00+10:00,2023-08-12,01:05,1,1,2
6,2023-08-12T01:06:00+10:00,2023-08-12,01:06,1,1,2
6,2023-08-12T01:09:00+10:00,2023-08-12,01:09,1,2,3
8,2023-08-12T00:55:00+10:00,2023-08-12,00:55,0,3,3
8,2023-08-12T01:09:00+10:00,2023-08-12,01:09,1,0,1
14,2023-08-12T01:00:00+10:00,2023-08-12,01:00,1,0,1
14,2023-08-12T01:05:00+10:00,2023-08-12,01:05,1,0,1
14,2023-08-12T01:07:00+10:00,2023-08-12,01:07,2,0,2
21,2023-08-12T01:03:00+10:00,2023-08-12,01:03,5,3,8
21,2023-08-12T01:06:00+10:00,2023-08-12,01:06,0,1,1
21,2023-08-12T01:08:00+10:00,2023-08-12,01:08,0,1,1
21,2023-08-12T01:09:00+10:00,2023-08-12,01:09,2,3,5
28,2023-08-12T00:55:00+10:00,2023-08-12,00:55,1,0,1
28,2023-08-12T00:59:00+10:00,2023-08-12,00:59,1,0,1
28,2023-08-12T01:03:00+10:00,2023-08-12,01:03,2,0,2
29,2023-08-12T00:58:00+10:00,2023-08-12,00:58,0,1,1
29,2023-08-12T00:59:00+10:00,2023-08-12,00:59,0,1,1
29,2023-08-12T01:00:00+10:00,2023-08-12,01:00,1,2,3
29,2023-08-12T01:03:00+10:00,2023-08-12,01:03,3,4,7
29,2023-08-12T01:09:00+10:00,2023-08-12,01:09,0,2,2
39,2023-08-12T00:56:00+10:00,2023-08-12,00:56,1,0,1
39,2023-08-12T01:00:00+10:00,2023-08-12,01:00,1,0,1
41,2023-08-12T00:57:00+10:00,2023-08-12,00:57,7,4,11
41,2023-08-12T01:00:00+10:00,2023-08-12,01:00,4,1,5
41,2023-08-12T01:05:00+10:00,2023-08-12,01:05,0,4,4
41,2023-08-12T01:06:00+10:00,2023-08-12,01:06,0,4,4
54,2023-08-12T00:59:00+10:00,2023-08-12,00:59,3,2,5
54,2023-08-12T01:07:00+10:00,2023-08-12,01:07,0,1,1
55,2023-08-12T00:56:00+10:00,2023-08-12,00:56,2,3,5
55,2023-08-12T01:00:00+10:00,2023-08-12,01:00,1,1,2
55,2023-08-12T01:02:00+10:00,2023-08-12,01:02,6,7,13
55,2023-08-12T01:03:00+10:00,2023-08-12,01:03,4,7,11
55,2023-08-12T01:08:00+10:00,2023-08-12,01:08,2,9,11
59,2023-08-12T01:00:00+10:00,2023-08-12,01:00,10,9,19
61,2023-08-12T00:58:00+10:00,2023-08-12,00:58,1,2,3
61,2023-08-12T01:06:00+10:00,2023-08-12,01:06,3,1,4
61,2023-08-12T01:09:00+10:00,2023-08-12,01:09,4,2,6
65,2023-08-12T00:56:00+10:00,2023-08-12,00:56,10,2,12
65,2023-08-12T01:03:00+10:00,2023-08-12,01:03,0,6,6
65,2023-08-12T01:05:00+10:00,2023-08-12,01:05,1,0,1
65,2023-08-12T01:06:00+10:00,2023-08-12,01:06,0,3,3
66,2023-08-12T00:59:00+10:00,2023-08-12,00:59,7,0,7
66,2023-08-12T01:00:00+10:00,2023-08-12,01:00,8,1,9
66,2023-08-12T01:01:00+10:00,2023-08-12,01:01,3,3,6
66,2023-08-12T01:02:00+10:00,2023-08-12,01:02,1,5,6
66,2023-08-12T01:03:00+10:00,2023-08-12,01:03,0,1,1
66,2023-08-12T01:06:00+10:00,2023-08-12,01:06,10,1,11
69,2023-08-12T01:07:00+10:00,2023-08-12,01:07,3,0,3
75,2023-08-12T01:05:00+10:00,2023-08-12,01:05,0,1,1
77,2023-08-12T01:01:00+10:00,2023-08-12,01:01,0,2,2
84,2023-08-12T00:55:00+10:00,2023-08-12,00:55,8,10,18
84,2023-08-12T01:00:00+10:00,2023-08-12,01:00,14,18,32
84,2023-08-12T01:05:00+10:00,2023-08-12,01:05,7,33,40
118,2023-08-12T01:05:00+10:00,2023-08-12,01:05,3,0,3
1,2023-08-12T00:56:00+10:00,2023-08-12,00:56,0,2,2
1,2023-08-12T01:03:00+10:00,2023-08-12,01:03,0,4,4
2,2023-08-12T00:56:00+10:00,2023-08-12,00:56,1,3,4
2,2023-08-12T01:01:00+10:00,2023-08-12,01:01,2,3,5
9,2023-08-12T01:02:00+10:00,2023-08-12,01:02,0,3,3
11,2023-08-12T00:55:00+10:00,2023-08-12,00:55,1,1,2
12,2023-08-12T01:06:00+10:00,2023-08-12,01:06,1,0,1
12,2023-08-12T01:09:00+10:00,2023-08-12,01:09,6,0,6
17,2023-08-12T01:00:00+10:00,2023-08-12,01:00,1,0,1
17,2023-08-12T01:01:00+10:00,2023-08-12,01:01,1,1,2
17,2023-08-12T01:03:00+10:00,2023-08-12,01:03,1,1,2
24,2023-08-12T00:55:00+10:00,2023-08-12,00:55,1,7,8
24,2023-08-12T00:56:00+10:00,2023-08-12,00:56,6,1,7
24,2023-08-12T00:57:00+10:00,2023-08-12,00:57,2,0,2
24,2023-08-12T01:07:00+10:00,2023-08-12,01:07,0,1,1
24,2023-08-12T01:08:00+10:00,2023-08-12,01:08,3,1,4
27,2023-08-12T00:55:00+10:00,2023-08-12,00:55,2,0,2
27,2023-08-12T01:05:00+10:00,2023-08-12,01:05,1,0,1
27,2023-08-12T01:06:00+10:00,2023-08-12,01:06,2,0,2
35,2023-08-12T00:58:00+10:00,2023-08-12,00:58,0,1,1
35,2023-08-12T00:59:00+10:00,2023-08-12,00:59,4,4,8
35,2023-08-12T01:00:00+10:00,2023-08-12,01:00,3,0,3
35,2023-08-12T01:02:00+10:00,2023-08-12,01:02,1,6,7
35,2023-08-12T01:04:00+10:00,2023-08-12,01:04,0,4,4
35,2023-08-12T01:06:00+10:00,2023-08-12,01:06,1,2,3
35,2023-08-12T01:08:00+10:00,2023-08-12,01:08,1,2,3
53,2023-08-12T01:08:00+10:00,2023-08-12,01:08,0,3,3
56,2023-08-12T00:55:00+10:00,2023-08-12,00:55,0,2,2
56,2023-08-12T00:58:00+10:00,2023-08-12,00:58,1,0,1
56,2023-08-12T01:06:00+10:00,2023-08-12,01:06,1,0,1
56,2023-08-12T01:09:00+10:00,2023-08-12,01:09,2,0,2
58,2023-08-12T00:55:00+10:00,2023-08-12,00:55,0,11,11
58,2023-08-12T01:08:00+10:00,2023-08-12,01:08,2,0,2
58,2023-08-12T01:09:00+10:00,2023-08-12,01:09,0,2,2
62,2023-08-12T00:55:00+10:00,2023-08-12,00:55,5,0,5
62,2023-08-12T00:57:00+10:00,2023-08-12,00:57,0,2,2
62,2023-08-12T01:03:00+10:00,2023-08-12,01:03,2,0,2
62,2023-08-12T01:06:00+10:00,2023-08-12,01:06,4,0,4
62,2023-08-12T01:09:00+10:00,2023-08-12,01:09,0,1,1
63,2023-08-12T00:56:00+10:00,2023-08-12,00:56,1,2,3
63,2023-08-12T00:57:00+10:00,2023-08-12,00:57,0,5,5
63,2023-08-12T01:02:00+10:00,2023-08-12,01:02,0,10,10
63,2023-08-12T01:06:00+10:00,2023-08-12,01:06,0,3,3
67,2023-08-12T00:57:00+10:00,2023-08-12,00:57,0,9,9
67,2023-08-12T00:58:00+10:00,2023-08-12,00:58,1,0,1
67,2023-08-12T01:03:00+10:00,2023-08-12,01:03,0,3,3
67,2023-08-12T01:04:00+10:00,2023-08-12,01:04,0,2,2
68,2023-08-12T00:59:00+10:00,2023-08-12,00:59,1,0,1
72,2023-08-12T00:55:00+10:00,2023-08-12,00:55,0,5,5
72,2023-08-12T00:56:00+10:00,2023-08-12,00:56,0,1,1
72,2023-08-12T01:01:00+10:00,2023-08-12,01:01,1,1,2
72,2023-08-12T01:08:00+10:00,2023-08-12,01:08,0,2,2
72,2023-08-12T01:09:00+10:00,2023-08-12,01:09,0,1,1
79,2023-08-12T00:55:00+10:00,2023-08-12,00:55,3,5,8
79,2023-08-12T01:00:00+10:00,2023-08-12,01:00,0,13,13
79,2023-08-12T01:04:00+10:00,2023-08-12,01:04,2,3,5
79,2023-08-12T01:06:00+10:00,2023-08-12,01:06,4,5,9
109,2023-08-12T00:55:00+10:00,2023-08-12,00:55,6,7,13
109,2023-08-12T01:00:00+10:00,2023-08-12,01:00,2,1,3
117,2023-08-12T01:00:00+10:00,2023-08-12,01:00,4,1,5
3,2023-08-12T01:10:00+10:00,2023-08-12,01:10,2,3,5
3,2023-08-12T01:13:00+10:00,2023-08-12,01:13,6,2,8
3,2023-08-12T01:15:00+10:00,2023-08-12,01:15,9,12,21
3,2023-08-12T01:17:00+10:00,2023-08-12,01:17,5,5,10
4,2023-08-12T01:11:00+10:00,2023-08-12,01:11,1,0,1
4,2023-08-12T01:14:00+10:00,2023-08-12,01:14,3,1,4
4,2023-08-12T01:16:00+10:00,2023-08-12,01:16,4,2,6
4,2023-08-12T01:17:00+10:00,2023-08-12,01:17,4,4,8
4,2023-08-12T01:23:00+10:00,2023-08-12,01:23,1,0,1
4,2023-08-12T01:24:00+10:00,2023-08-12,01:24,1,0,1
6,2023-08-12T01:14:00+10:00,2023-08-12,01:14,3,2,5
6,2023-08-12T01:16:00+10:00,2023-08-12,01:16,4,1,5
6,2023-08-12T01:20:00+10:00,2023-08-12,01:20,0,2,2
6,2023-08-12T01:22:00+10:00,2023-08-12,01:22,2,0,2
6,2023-08-12T01:23:00+10:00,2023-08-12,01:23,1,0,1
8,2023-08-12T01:23:00+10:00,2023-08-12,01:23,0,1,1
14,2023-08-12T01:10:00+10:00,2023-08-12,01:10,0,1,1
14,2023-08-12T01:11:00+10:00,2023-08-12,01:11,2,0,2
14,2023-08-12T01:14:00+10:00,2023-08-12,01:14,2,0,2
14,2023-08-12T01:20:00+10:00,2023-08-12,01:20,5,0,5
14,2023-08-12T01:23:00+10:00,2023-08-12,01:23,12,0,12
21,2023-08-12T01:12:00+10:00,2023-08-12,01:12,3,1,4
28,2023-08-12T01:20:00+10:00,2023-08-12,01:20,1,0,1
29,2023-08-12T01:15:00+10:00,2023-08-12,01:15,1,0,1
29,2023-08-12T01:19:00+10:00,2023-08-12,01:19,0,2,2
29,2023-08-12T01:23:00+10:00,2023-08-12,01:23,0,2,2
39,2023-08-12T01:22:00+10:00,2023-08-12,01:22,1,0,1
41,2023-08-12T01:10:00+10:00,2023-08-12,01:10,7,11,18
41,2023-08-12T01:18:00+10:00,2023-08-12,01:18,4,9,13
41,2023-08-12T01:20:00+10:00,2023-08-12,01:20,8,15,23
41,2023-08-12T01:21:00+10:00,2023-08-12,01:21,3,7,10
41,2023-08-12T01:22:00+10:00,2023-08-12,01:22,6,10,16
41,2023-08-12T01:23:00+10:00,2023-08-12,01:23,6,7,13
41,2023-08-12T01:24:00+10:00,2023-08-12,01:24,11,3,14
54,2023-08-12T01:10:00+10:00,2023-08-12,01:10,1,0,1
54,2023-08-12T01:14:00+10:00,2023-08-12,01:14,0,3,3
54,2023-08-12T01:18:00+10:00,2023-08-12,01:18,7,0,7
55,2023-08-12T01:10:00+10:00,2023-08-12,01:10,6,2,8
55,2023-08-12T01:13:00+10:00,2023-08-12,01:13,7,7,14
55,2023-08-12T01:15:00+10:00,2023-08-12,01:15,2,0,2
55,2023-08-12T01:18:00+10:00,2023-08-12,01:18,3,4,7
55,2023-08-12T01:20:00+10:00,2023-08-12,01:20,2,7,9
55,2023-08-12T01:22:00+10:00,2023-08-12,01:22,2,4,6
59,2023-08-12T01:10:00+10:00,2023-08-12,01:10,10,0,10
61,2023-08-12T01:13:00+10:00,2023-08-12,01:13,2,1,3
61,2023-08-12T01:20:00+10:00,2023-08-12,01:20,4,0,4
61,2023-08-12T01:23:00+10:00,2023-08-12,01:23,0,3,3
65,2023-08-12T01:11:00+10:00,2023-08-12,01:11,0,5,5
65,2023-08-12T01:12:00+10:00,2023-08-12,01:12,2,2,4
65,2023-08-12T01:20:00+10:00,2023-08-12,01:20,2,0,2
66,2023-08-12T01:16:00+10:00,2023-08-12,01:16,6,4,10
66,2023-08-12T01:21:00+10:00,2023-08-12,01:21,1,3,4
66,2023-08-12T01:23:00+10:00,2023-08-12,01:23,7,4,11
77,2023-08-12T01:24:00+10:00,2023-08-12,01:24,1,0,1
84,2023-08-12T01:15:00+10:00,2023-08-12,01:15,17,25,42
84,2023-08-12T01:20:00+10:00,2023-08-12,01:20,7,14,21
87,2023-08-12T01:23:00+10:00,2023-08-12,01:23,1,0,1
107,2023-08-12T01:10:00+10:00,2023-08-12,01:10,6,1,7
107,2023-08-12T01:20:00+10:00,2023-08-12,01:20,2,1,3
108,2023-08-12T01:10:00+10:00,2023-08-12,01:10,1,1,2
108,2023-08-12T01:19:00+10:00,2023-08-12,01:19,0,1,1
108,2023-08-12T01:22:00+10:00,2023-08-12,01:22,0,2,2
1,2023-08-12T01:14:00+10:00,2023-08-12,01:14,2,0,2
1,2023-08-12T01:15:00+10:00,2023-08-12,01:15,0,4,4
1,2023-08-12T01:16:00+10:00,2023-08-12,01:16,0,2,2
1,2023-08-12T01:18:00+10:00,2023-08-12,01:18,1,0,1
1,2023-08-12T01:19:00+10:00,2023-08-12,01:19,0,1,1
1,2023-08-12T01:20:00+10:00,2023-08-12,01:20,0,2,2
1,2023-08-12T01:24:00+10:00,2023-08-12,01:24,1,0,1
2,2023-08-12T01:17:00+10:00,2023-08-12,01:17,0,4,4
7,2023-08-12T01:15:00+10:00,2023-08-12,01:15,0,1,1
9,2023-08-12T01:16:00+10:00,2023-08-12,01:16,1,2,3
10,2023-08-12T01:18:00+10:00,2023-08-12,01:18,2,0,2
12,2023-08-12T01:19:00+10:00,2023-08-12,01:19,1,0,1
17,2023-08-12T01:11:00+10:00,2023-08-12,01:11,0,1,1
24,2023-08-12T01:18:00+10:00,2023-08-12,01:18,1,0,1
24,2023-08-12T01:19:00+10:00,2023-08-12,01:19,1,6,7
24,2023-08-12T01:21:00+10:00,2023-08-12,01:21,5,1,6
24,2023-08-12T01:22:00+10:00,2023-08-12,01:22,1,4,5
27,2023-08-12T01:17:00+10:00,2023-08-12,01:17,1,0,1
27,2023-08-12T01:20:00+10:00,2023-08-12,01:20,0,1,1
35,2023-08-12T01:10:00+10:00,2023-08-12,01:10,1,4,5
35,2023-08-12T01:21:00+10:00,2023-08-12,01:21,1,2,3
35,2023-08-12T01:23:00+10:00,2023-08-12,01:23,3,7,10
53,2023-08-12T01:11:00+10:00,2023-08-12,01:11,1,8,9
53,2023-08-12T01:12:00+10:00,2023-08-12,01:12,0,3,3
53,2023-08-12T01:16:00+10:00,2023-08-12,01:16,0,1,1
53,2023-08-12T01:18:00+10:00,2023-08-12,01:18,1,1,2
53,2023-08-12T01:22:00+10:00,2023-08-12,01:22,0,5,5
53,2023-08-12T01:23:00+10:00,2023-08-12,01:23,0,4,4
56,2023-08-12T01:10:00+10:00,2023-08-12,01:10,0,2,2
56,2023-08-12T01:13:00+10:00,2023-08-12,01:13,1,1,2
56,2023-08-12T01:15:00+10:00,2023-08-12,01:15,1,7,8
56,2023-08-12T01:16:00+10:00,2023-08-12,01:16,1,1,2
56,2023-08-12T01:18:00+10:00,2023-08-12,01:18,3,0,3
57,2023-08-12T01:12:00+10:00,2023-08-12,01:12,0,1,1
57,2023-08-12T01:24:00+10:00,2023-08-12,01:24,1,1,2
58,2023-08-12T01:15:00+10:00,2023-08-12,01:15,1,1,2
58,2023-08-12T01:17:00+10:00,2023-08-12,01:17,1,1,2
58,2023-08-12T01:19:00+10:00,2023-08-12,01:19,0,1,1
58,2023-08-12T01:20:00+10:00,2023-08-12,01:20,2,0,2
58,2023-08-12T01:21:00+10:00,2023-08-12,01:21,3,2,5
58,2023-08-12T01:22:00+10:00,2023-08-12,01:22,0,2,2
62,2023-08-12T01:13:00+10:00,2023-08-12,01:13,0,1,1
62,2023-08-12T01:14:00+10:00,2023-08-12,01:14,1,0,1
63,2023-08-12T01:11:00+10:00,2023-08-12,01:11,5,5,10
63,2023-08-12T01:12:00+10:00,2023-08-12,01:12,7,1,8
63,2023-08-12T01:13:00+10:00,2023-08-12,01:13,10,3,13
63,2023-08-12T01:16:00+10:00,2023-08-12,01:16,2,1,3
63,2023-08-12T01:22:00+10:00,2023-08-12,01:22,1,4,5
67,2023-08-12T01:18:00+10:00,2023-08-12,01:18,2,3,5
67,2023-08-12T01:21:00+10:00,2023-08-12,01:21,2,2,4
67,2023-08-12T01:24:00+10:00,2023-08-12,01:24,0,1,1
72,2023-08-12T01:19:00+10:00,2023-08-12,01:19,2,1,3
72,2023-08-12T01:21:00+10:00,2023-08-12,01:21,1,0,1
79,2023-08-12T01:11:00+10:00,2023-08-12,01:11,1,1,2
79,2023-08-12T01:13:00+10:00,2023-08-12,01:13,4,3,7
79,2023-08-12T01:14:00+10:00,2023-08-12,01:14,0,3,3
79,2023-08-12T01:20:00+10:00,2023-08-12,01:20,0,2,2
79,2023-08-12T01:21:00+10:00,2023-08-12,01:21,1,6,7
79,2023-08-12T01:23:00+10:00,2023-08-12,01:23,1,8,9
85,2023-08-12T01:23:00+10:00,2023-08-12,01:23,1,0,1
85,2023-08-12T01:24:00+10:00,2023-08-12,01:24,0,1,1
109,2023-08-12T01:10:00+10:00,2023-08-12,01:10,1,0,1
109,2023-08-12T01:20:00+10:00,2023-08-12,01:20,0,8,8
117,2023-08-12T01:20:00+10:00,2023-08-12,01:20,3,3,6
3,2023-08-12T01:25:00+10:00,2023-08-12,01:25,2,7,9
3,2023-08-12T01:26:00+10:00,2023-08-12,01:26,1,14,15
3,2023-08-12T01:29:00+10:00,2023-08-12,01:29,6,6,12
3,2023-08-12T01:32:00+10:00,2023-08-12,01:32,7,3,10
3,2023-08-12T01:38:00+10:00,2023-08-12,01:38,2,1,3
4,2023-08-12T01:35:00+10:00,2023-08-12,01:35,0,4,4
4,2023-08-12T01:38:00+10:00,2023-08-12,01:38,1,1,2
4,2023-08-12T01:39:00+10:00,2023-08-12,01:39,0,5,5
6,2023-08-12T01:25:00+10:00,2023-08-12,01:25,3,0,3
6,2023-08-12T01:33:00+10:00,2023-08-12,01:33,10,2,12
6,2023-08-12T01:37:00+10:00,2023-08-12,01:37,1,0,1
6,2023-08-12T01:38:00+10:00,2023-08-12,01:38,0,2,2
8,2023-08-12T01:31:00+10:00,2023-08-12,01:31,0,1,1
14,2023-08-12T01:27:00+10:00,2023-08-12,01:27,4,1,5
14,2023-08-12T01:28:00+10:00,2023-08-12,01:28,7,1,8
14,2023-08-12T01:38:00+10:00,2023-08-12,01:38,6,1,7
21,2023-08-12T01:26:00+10:00,2023-08-12,01:26,1,0,1
21,2023-08-12T01:28:00+10:00,2023-08-12,01:28,2,2,4
21,2023-08-12T01:34:00+10:00,2023-08-12,01:34,9,1,10
21,2023-08-12T01:39:00+10:00,2023-08-12,01:39,0,1,1
28,2023-08-12T01:25:00+10:00,2023-08-12,01:25,3,0,3
28,2023-08-12T01:26:00+10:00,2023-08-12,01:26,1,0,1
28,2023-08-12T01:38:00+10:00,2023-08-12,01:38,3,3,6
29,2023-08-12T01:26:00+10:00,2023-08-12,01:26,0,3,3
29,2023-08-12T01:37:00+10:00,2023-08-12,01:37,0,3,3
29,2023-08-12T01:38:00+10:00,2023-08-12,01:38,0,1,1
39,2023-08-12T01:30:00+10:00,2023-08-12,01:30,1,0,1
39,2023-08-12T01:31:00+10:00,2023-08-12,01:31,0,2,2
41,2023-08-12T01:32:00+10:00,2023-08-12,01:32,7,4,11
41,2023-08-12T01:35:00+10:00,2023-08-12,01:35,4,1,5
41,2023-08-12T01:36:00+10:00,2023-08-12,01:36,6,10,16
41,2023-08-12T01:38:00+10:00,2023-08-12,01:38,10,1,11
54,2023-08-12T01:34:00+10:00,2023-08-12,01:34,0,1,1
54,2023-08-12T01:39:00+10:00,2023-08-12,01:39,1,0,1
55,2023-08-12T01:25:00+10:00,2023-08-12,01:25,1,3,4
55,2023-08-12T01:26:00+10:00,2023-08-12,01:26,3,5,8
55,2023-08-12T01:28:00+10:00,2023-08-12,01:28,2,0,2
55,2023-08-12T01:36:00+10:00,2023-08-12,01:36,7,6,13
61,2023-08-12T01:32:00+10:00,2023-08-12,01:32,0,3,3
61,2023-08-12T01:33:00+10:00,2023-08-12,01:33,0,3,3
61,2023-08-12T01:34:00+10:00,2023-08-12,01:34,2,0,2
61,2023-08-12T01:35:00+10:00,2023-08-12,01:35,0,1,1
65,2023-08-12T01:25:00+10:00,2023-08-12,01:25,2,1,3
65,2023-08-12T01:26:00+10:00,2023-08-12,01:26,2,3,5
65,2023-08-12T01:28:00+10:00,2023-08-12,01:28,0,3,3
65,2023-08-12T01:33:00+10:00,2023-08-12,01:33,5,0,5
65,2023-08-12T01:37:00+10:00,2023-08-12,01:37,0,4,4
66,2023-08-12T01:26:00+10:00,2023-08-12,01:26,3,0,3
66,2023-08-12T01:29:00+10:00,2023-08-12,01:29,0,3,3
70,2023-08-12T01:26:00+10:00,2023-08-12,01:26,0,1,1
70,2023-08-12T01:37:00+10:00,2023-08-12,01:37,1,0,1
77,2023-08-12T01:33:00+10:00,2023-08-12,01:33,1,0,1
78,2023-08-12T01:32:00+10:00,2023-08-12,01:32,0,1,1
84,2023-08-12T01:35:00+10:00,2023-08-12,01:35,18,17,35
107,2023-08-12T01:35:00+10:00,2023-08-12,01:35,1,1,2
108,2023-08-12T01:27:00+10:00,2023-08-12,01:27,1,0,1
1,2023-08-12T01:25:00+10:00,2023-08-12,01:25,1,0,1
1,2023-08-12T01:28:00+10:00,2023-08-12,01:28,0,4,4
1,2023-08-12T01:29:00+10:00,2023-08-12,01:29,0,1,1
1,2023-08-12T01:31:00+10:00,2023-08-12,01:31,3,0,3
2,2023-08-12T01:27:00+10:00,2023-08-12,01:27,2,0,2
2,2023-08-12T01:39:00+10:00,2023-08-12,01:39,0,6,6
7,2023-08-12T01:39:00+10:00,2023-08-12,01:39,0,1,1
9,2023-08-12T01:32:00+10:00,2023-08-12,01:32,0,3,3
10,2023-08-12T01:25:00+10:00,2023-08-12,01:25,0,4,4
17,2023-08-12T01:27:00+10:00,2023-08-12,01:27,1,1,2
18,2023-08-12T01:32:00+10:00,2023-08-12,01:32,1,0,1
24,2023-08-12T01:39:00+10:00,2023-08-12,01:39,0,1,1
27,2023-08-12T01:35:00+10:00,2023-08-12,01:35,2,0,2
35,2023-08-12T01:33:00+10:00,2023-08-12,01:33,1,0,1
35,2023-08-12T01:35:00+10:00,2023-08-12,01:35,4,3,7
35,2023-08-12T01:38:00+10:00,2023-08-12,01:38,0,1,1
53,2023-08-12T01:30:00+10:00,2023-08-12,01:30,1,1,2
53,2023-08-12T01:33:00+10:00,2023-08-12,01:33,1,2,3
53,2023-08-12T01:34:00+10:00,2023-08-12,01:34,0,2,2
53,2023-08-12T01:37:00+10:00,2023-08-12,01:37,0,3,3
53,2023-08-12T01:39:00+10:00,2023-08-12,01:39,0,2,2
56,2023-08-12T01:29:00+10:00,2023-08-12,01:29,4,0,4
56,2023-08-12T01:32:00+10:00,2023-08-12,01:32,1,0,1
56,2023-08-12T01:33:00+10:00,2023-08-12,01:33,0,1,1
56,2023-08-12T01:37:00+10:00,2023-08-12,01:37,0,2,2
56,2023-08-12T01:39:00+10:00,2023-08-12,01:39,4,2,6
58,2023-08-12T01:28:00+10:00,2023-08-12,01:28,1,1,2
58,2023-08-12T01:30:00+10:00,2023-08-12,01:30,0,1,1
58,2023-08-12T01:32:00+10:00,2023-08-12,01:32,0,3,3
62,2023-08-12T01:28:00+10:00,2023-08-12,01:28,2,1,3
62,2023-08-12T01:33:00+10:00,2023-08-12,01:33,1,0,1
62,2023-08-12T01:37:00+10:00,2023-08-12,01:37,1,1,2
63,2023-08-12T01:25:00+10:00,2023-08-12,01:25,6,1,7
63,2023-08-12T01:27:00+10:00,2023-08-12,01:27,1,1,2
63,2023-08-12T01:31:00+10:00,2023-08-12,01:31,0,3,3
63,2023-08-12T01:32:00+10:00,2023-08-12,01:32,1,0,1
63,2023-08-12T01:33:00+10:00,2023-08-12,01:33,2,0,2
63,2023-08-12T01:34:00+10:00,2023-08-12,01:34,1,0,1
67,2023-08-12T01:30:00+10:00,2023-08-12,01:30,0,3,3
67,2023-08-12T01:32:00+10:00,2023-08-12,01:32,0,2,2
67,2023-08-12T01:33:00+10:00,2023-08-12,01:33,0,2,2
72,2023-08-12T01:25:00+10:00,2023-08-12,01:25,6,0,6
72,2023-08-12T01:26:00+10:00,2023-08-12,01:26,1,1,2
72,2023-08-12T01:30:00+10:00,2023-08-12,01:30,3,3,6
72,2023-08-12T01:33:00+10:00,2023-08-12,01:33,2,2,4
72,2023-08-12T01:34:00+10:00,2023-08-12,01:34,1,0,1
72,2023-08-12T01:35:00+10:00,2023-08-12,01:35,5,0,5
72,2023-08-12T01:37:00+10:00,2023-08-12,01:37,3,5,8
79,2023-08-12T01:27:00+10:00,2023-08-12,01:27,2,3,5
79,2023-08-12T01:30:00+10:00,2023-08-12,01:30,2,2,4
79,2023-08-12T01:31:00+10:00,2023-08-12,01:31,2,6,8
79,2023-08-12T01:35:00+10:00,2023-08-12,01:35,5,3,8
79,2023-08-12T01:36:00+10:00,2023-08-12,01:36,5,4,9
79,2023-08-12T01:38:00+10:00,2023-08-12,01:38,0,2,2
85,2023-08-12T01:30:00+10:00,2023-08-12,01:30,0,1,1
109,2023-08-12T01:30:00+10:00,2023-08-12,01:30,0,3,3
109,2023-08-12T01:35:00+10:00,2023-08-12,01:35,1,2,3
122,2023-08-12T01:25:00+10:00,2023-08-12,01:25,1,0,1
122,2023-08-12T01:28:00+10:00,2023-08-12,01:28,0,1,1
3,2023-08-12T01:42:00+10:00,2023-08-12,01:42,0,7,7
3,2023-08-12T01:46:00+10:00,2023-08-12,01:46,1,4,5
3,2023-08-12T01:50:00+10:00,2023-08-12,01:50,11,3,14
3,2023-08-12T01:51:00+10:00,2023-08-12,01:51,6,8,14
3,2023-08-12T01:53:00+10:00,2023-08-12,01:53,6,7,13
3,2023-08-12T01:54:00+10:00,2023-08-12,01:54,4,8,12
4,2023-08-12T01:42:00+10:00,2023-08-12,01:42,0,3,3
4,2023-08-12T01:44:00+10:00,2023-08-12,01:44,3,4,7
4,2023-08-12T01:45:00+10:00,2023-08-12,01:45,3,8,11
4,2023-08-12T01:47:00+10:00,2023-08-12,01:47,5,0,5
4,2023-08-12T01:49:00+10:00,2023-08-12,01:49,2,6,8
4,2023-08-12T01:51:00+10:00,2023-08-12,01:51,1,2,3
6,2023-08-12T01:43:00+10:00,2023-08-12,01:43,5,0,5
6,2023-08-12T01:44:00+10:00,2023-08-12,01:44,0,2,2
6,2023-08-12T01:51:00+10:00,2023-08-12,01:51,0,1,1
6,2023-08-12T01:54:00+10:00,2023-08-12,01:54,2,0,2
14,2023-08-12T01:40:00+10:00,2023-08-12,01:40,3,0,3
14,2023-08-12T01:47:00+10:00,2023-08-12,01:47,4,0,4
14,2023-08-12T01:48:00+10:00,2023-08-12,01:48,0,1,1
14,2023-08-12T01:49:00+10:00,2023-08-12,01:49,6,0,6
14,2023-08-12T01:53:00+10:00,2023-08-12,01:53,2,0,2
21,2023-08-12T01:40:00+10:00,2023-08-12,01:40,5,3,8
21,2023-08-12T01:42:00+10:00,2023-08-12,01:42,1,2,3
21,2023-08-12T01:46:00+10:00,2023-08-12,01:46,3,0,3
21,2023-08-12T01:49:00+10:00,2023-08-12,01:49,4,0,4
21,2023-08-12T01:50:00+10:00,2023-08-12,01:50,0,14,14
21,2023-08-12T01:52:00+10:00,2023-08-12,01:52,5,3,8
28,2023-08-12T01:48:00+10:00,2023-08-12,01:48,0,1,1
28,2023-08-12T01:51:00+10:00,2023-08-12,01:51,0,1,1
29,2023-08-12T01:41:00+10:00,2023-08-12,01:41,0,4,4
29,2023-08-12T01:43:00+10:00,2023-08-12,01:43,0,2,2
29,2023-08-12T01:46:00+10:00,2023-08-12,01:46,1,1,2
29,2023-08-12T01:50:00+10:00,2023-08-12,01:50,0,2,2
39,2023-08-12T01:54:00+10:00,2023-08-12,01:54,1,0,1
41,2023-08-12T01:42:00+10:00,2023-08-12,01:42,4,1,5
41,2023-08-12T01:44:00+10:00,2023-08-12,01:44,5,1,6
41,2023-08-12T01:46:00+10:00,2023-08-12,01:46,1,4,5
41,2023-08-12T01:48:00+10:00,2023-08-12,01:48,0,2,2
41,2023-08-12T01:49:00+10:00,2023-08-12,01:49,0,13,13
41,2023-08-12T01:51:00+10:00,2023-08-12,01:51,1,2,3
41,2023-08-12T01:54:00+10:00,2023-08-12,01:54,0,7,7
54,2023-08-12T01:40:00+10:00,2023-08-12,01:40,0,1,1
54,2023-08-12T01:48:00+10:00,2023-08-12,01:48,0,5,5
55,2023-08-12T01:41:00+10:00,2023-08-12,01:41,10,1,11
55,2023-08-12T01:42:00+10:00,2023-08-12,01:42,11,5,16
55,2023-08-12T01:43:00+10:00,2023-08-12,01:43,4,3,7
55,2023-08-12T01:51:00+10:00,2023-08-12,01:51,2,2,4
55,2023-08-12T01:54:00+10:00,2023-08-12,01:54,1,10,11
59,2023-08-12T01:45:00+10:00,2023-08-12,01:45,7,4,11
61,2023-08-12T01:42:00+10:00,2023-08-12,01:42,3,0,3
65,2023-08-12T01:47:00+10:00,2023-08-12,01:47,0,11,11
66,2023-08-12T01:41:00+10:00,2023-08-12,01:41,2,0,2
66,2023-08-12T01:42:00+10:00,2023-08-12,01:42,2,3,5
66,2023-08-12T01:47:00+10:00,2023-08-12,01:47,0,2,2
66,2023-08-12T01:48:00+10:00,2023-08-12,01:48,4,0,4
66,2023-08-12T01:51:00+10:00,2023-08-12,01:51,1,1,2
69,2023-08-12T01:46:00+10:00,2023-08-12,01:46,1,1,2
69,2023-08-12T01:52:00+10:00,2023-08-12,01:52,1,0,1
84,2023-08-12T01:40:00+10:00,2023-08-12,01:40,10,21,31
84,2023-08-12T01:45:00+10:00,2023-08-12,01:45,13,11,24
84,2023-08-12T01:50:00+10:00,2023-08-12,01:50,16,16,32
87,2023-08-12T01:46:00+10:00,2023-08-12,01:46,1,0,1
107,2023-08-12T01:40:00+10:00,2023-08-12,01:40,0,1,1
108,2023-08-12T01:46:00+10:00,2023-08-12,01:46,1,1,2
108,2023-08-12T01:49:00+10:00,2023-08-12,01:49,0,2,2
108,2023-08-12T01:51:00+10:00,2023-08-12,01:51,1,0,1
108,2023-08-12T01:52:00+10:00,2023-08-12,01:52,2,0,2
1,2023-08-12T01:42:00+10:00,2023-08-12,01:42,1,0,1
1,2023-08-12T01:43:00+10:00,2023-08-12,01:43,0,1,1
1,2023-08-12T01:53:00+10:00,2023-08-12,01:53,0,2,2
2,2023-08-12T01:47:00+10:00,2023-08-12,01:47,0,2,2
2,2023-08-12T01:50:00+10:00,2023-08-12,01:50,1,0,1
9,2023-08-12T01:48:00+10:00,2023-08-12,01:48,0,1,1
9,2023-08-12T01:52:00+10:00,2023-08-12,01:52,0,1,1
17,2023-08-12T01:40:00+10:00,2023-08-12,01:40,1,0,1
17,2023-08-12T01:45:00+10:00,2023-08-12,01:45,0,2,2
17,2023-08-12T01:53:00+10:00,2023-08-12,01:53,0,1,1
24,2023-08-12T01:44:00+10:00,2023-08-12,01:44,2,0,2
24,2023-08-12T01:46:00+10:00,2023-08-12,01:46,0,1,1
24,2023-08-12T01:47:00+10:00,2023-08-12,01:47,3,0,3
24,2023-08-12T01:52:00+10:00,2023-08-12,01:52,2,0,2
35,2023-08-12T01:41:00+10:00,2023-08-12,01:41,1,4,5
35,2023-08-12T01:45:00+10:00,2023-08-12,01:45,1,0,1
53,2023-08-12T01:52:00+10:00,2023-08-12,01:52,0,2,2
56,2023-08-12T01:40:00+10:00,2023-08-12,01:40,0,3,3
56,2023-08-12T01:41:00+10:00,2023-08-12,01:41,0,4,4
56,2023-08-12T01:42:00+10:00,2023-08-12,01:42,1,0,1
56,2023-08-12T01:45:00+10:00,2023-08-12,01:45,0,2,2
56,2023-08-12T01:49:00+10:00,2023-08-12,01:49,0,1,1
58,2023-08-12T01:46:00+10:00,2023-08-12,01:46,2,0,2
58,2023-08-12T01:50:00+10:00,2023-08-12,01:50,0,1,1
62,2023-08-12T01:40:00+10:00,2023-08-12,01:40,2,1,3
62,2023-08-12T01:41:00+10:00,2023-08-12,01:41,0,2,2
62,2023-08-12T01:46:00+10:00,2023-08-12,01:46,3,1,4
62,2023-08-12T01:51:00+10:00,2023-08-12,01:51,2,3,5
62,2023-08-12T01:53:00+10:00,2023-08-12,01:53,0,2,2
63,2023-08-12T01:48:00+10:00,2023-08-12,01:48,4,0,4
63,2023-08-12T01:50:00+10:00,2023-08-12,01:50,0,3,3
63,2023-08-12T01:53:00+10:00,2023-08-12,01:53,0,2,2
63,2023-08-12T01:54:00+10:00,2023-08-12,01:54,4,0,4
67,2023-08-12T01:40:00+10:00,2023-08-12,01:40,0,6,6
67,2023-08-12T01:44:00+10:00,2023-08-12,01:44,1,0,1
67,2023-08-12T01:49:00+10:00,2023-08-12,01:49,0,1,1
68,2023-08-12T01:52:00+10:00,2023-08-12,01:52,0,1,1
72,2023-08-12T01:40:00+10:00,2023-08-12,01:40,1,1,2
72,2023-08-12T01:51:00+10:00,2023-08-12,01:51,0,2,2
72,2023-08-12T01:52:00+10:00,2023-08-12,01:52,0,1,1
72,2023-08-12T01:54:00+10:00,2023-08-12,01:54,2,0,2
76,2023-08-12T01:49:00+10:00,2023-08-12,01:49,0,1,1
79,2023-08-12T01:42:00+10:00,2023-08-12,01:42,2,6,8
79,2023-08-12T01:44:00+10:00,2023-08-12,01:44,3,0,3
79,2023-08-12T01:47:00+10:00,2023-08-12,01:47,1,4,5
79,2023-08-12T01:48:00+10:00,2023-08-12,01:48,1,1,2
79,2023-08-12T01:49:00+10:00,2023-08-12,01:49,3,5,8
79,2023-08-12T01:52:00+10:00,2023-08-12,01:52,1,2,3
79,2023-08-12T01:53:00+10:00,2023-08-12,01:53,3,5,8
85,2023-08-12T01:51:00+10:00,2023-08-12,01:51,1,0,1
3,2023-08-12T01:57:00+10:00,2023-08-12,01:57,3,0,3
3,2023-08-12T01:59:00+10:00,2023-08-12,01:59,2,6,8
3,2023-08-12T02:04:00+10:00,2023-08-12,02:04,1,4,5
3,2023-08-12T02:05:00+10:00,2023-08-12,02:05,13,1,14
3,2023-08-12T02:06:00+10:00,2023-08-12,02:06,1,5,6
4,2023-08-12T01:55:00+10:00,2023-08-12,01:55,4,3,7
4,2023-08-12T02:02:00+10:00,2023-08-12,02:02,4,12,16
4,2023-08-12T02:03:00+10:00,2023-08-12,02:03,4,3,7
4,2023-08-12T02:04:00+10:00,2023-08-12,02:04,2,0,2
6,2023-08-12T01:55:00+10:00,2023-08-12,01:55,0,3,3
6,2023-08-12T02:03:00+10:00,2023-08-12,02:03,4,5,9
6,2023-08-12T02:05:00+10:00,2023-08-12,02:05,2,0,2
6,2023-08-12T02:07:00+10:00,2023-08-12,02:07,2,0,2
8,2023-08-12T01:58:00+10:00,2023-08-12,01:58,0,2,2
14,2023-08-12T01:55:00+10:00,2023-08-12,01:55,2,0,2
14,2023-08-12T01:59:00+10:00,2023-08-12,01:59,3,0,3
14,2023-08-12T02:06:00+10:00,2023-08-12,02:06,1,0,1
14,2023-08-12T02:08:00+10:00,2023-08-12,02:08,1,0,1
21,2023-08-12T01:56:00+10:00,2023-08-12,01:56,2,5,7
21,2023-08-12T01:58:00+10:00,2023-08-12,01:58,0,4,4
21,2023-08-12T01:59:00+10:00,2023-08-12,01:59,8,2,10
21,2023-08-12T02:01:00+10:00,2023-08-12,02:01,2,2,4
21,2023-08-12T02:02:00+10:00,2023-08-12,02:02,1,9,10
21,2023-08-12T02:04:00+10:00,2023-08-12,02:04,4,0,4
21,2023-08-12T02:08:00+10:00,2023-08-12,02:08,0,4,4
28,2023-08-12T02:02:00+10:00,2023-08-12,02:02,0,1,1
28,2023-08-12T02:04:00+10:00,2023-08-12,02:04,1,0,1
28,2023-08-12T02:05:00+10:00,2023-08-12,02:05,1,0,1
29,2023-08-12T02:07:00+10:00,2023-08-12,02:07,2,4,6
39,2023-08-12T02:09:00+10:00,2023-08-12,02:09,0,2,2
41,2023-08-12T01:56:00+10:00,2023-08-12,01:56,3,4,7
41,2023-08-12T01:57:00+10:00,2023-08-12,01:57,4,4,8
41,2023-08-12T02:00:00+10:00,2023-08-12,02:00,6,2,8
41,2023-08-12T02:01:00+10:00,2023-08-12,02:01,1,3,4
41,2023-08-12T02:03:00+10:00,2023-08-12,02:03,1,7,8
41,2023-08-12T02:05:00+10:00,2023-08-12,02:05,1,4,5
41,2023-08-12T02:08:00+10:00,2023-08-12,02:08,1,2,3
54,2023-08-12T01:59:00+10:00,2023-08-12,01:59,3,0,3
54,2023-08-12T02:03:00+10:00,2023-08-12,02:03,8,0,8
55,2023-08-12T01:56:00+10:00,2023-08-12,01:56,1,1,2
55,2023-08-12T01:57:00+10:00,2023-08-12,01:57,2,6,8
55,2023-08-12T01:58:00+10:00,2023-08-12,01:58,6,0,6
55,2023-08-12T02:03:00+10:00,2023-08-12,02:03,1,3,4
55,2023-08-12T02:07:00+10:00,2023-08-12,02:07,5,2,7
55,2023-08-12T02:08:00+10:00,2023-08-12,02:08,3,1,4
55,2023-08-12T02:09:00+10:00,2023-08-12,02:09,2,1,3
61,2023-08-12T02:00:00+10:00,2023-08-12,02:00,1,0,1
61,2023-08-12T02:06:00+10:00,2023-08-12,02:06,2,0,2
65,2023-08-12T02:00:00+10:00,2023-08-12,02:00,0,4,4
65,2023-08-12T02:02:00+10:00,2023-08-12,02:02,0,1,1
65,2023-08-12T02:05:00+10:00,2023-08-12,02:05,0,2,2
65,2023-08-12T02:06:00+10:00,2023-08-12,02:06,0,2,2
65,2023-08-12T02:09:00+10:00,2023-08-12,02:09,0,1,1
66,2023-08-12T01:59:00+10:00,2023-08-12,01:59,2,0,2
66,2023-08-12T02:03:00+10:00,2023-08-12,02:03,3,3,6
78,2023-08-12T01:59:00+10:00,2023-08-12,01:59,0,1,1
107,2023-08-12T01:55:00+10:00,2023-08-12,01:55,3,0,3
107,2023-08-12T02:05:00+10:00,2023-08-12,02:05,0,1,1
108,2023-08-12T01:58:00+10:00,2023-08-12,01:58,0,1,1
108,2023-08-12T02:07:00+10:00,2023-08-12,02:07,0,1,1
1,2023-08-12T01:55:00+10:00,2023-08-12,01:55,0,1,1
7,2023-08-12T01:59:00+10:00,2023-08-12,01:59,0,2,2
17,2023-08-12T02:03:00+10:00,2023-08-12,02:03,1,0,1
18,2023-08-12T01:57:00+10:00,2023-08-12,01:57,0,1,1
24,2023-08-12T02:00:00+10:00,2023-08-12,02:00,2,2,4
24,2023-08-12T02:04:00+10:00,2023-08-12,02:04,1,0,1
24,2023-08-12T02:05:00+10:00,2023-08-12,02:05,0,3,3
27,2023-08-12T02:07:00+10:00,2023-08-12,02:07,2,0,2
35,2023-08-12T01:55:00+10:00,2023-08-12,01:55,2,2,4
35,2023-08-12T01:56:00+10:00,2023-08-12,01:56,3,0,3
35,2023-08-12T01:59:00+10:00,2023-08-12,01:59,2,4,6
35,2023-08-12T02:00:00+10:00,2023-08-12,02:00,2,1,3
35,2023-08-12T02:01:00+10:00,2023-08-12,02:01,2,1,3
35,2023-08-12T02:02:00+10:00,2023-08-12,02:02,4,1,5
35,2023-08-12T02:03:00+10:00,2023-08-12,02:03,4,0,4
53,2023-08-12T01:59:00+10:00,2023-08-12,01:59,1,0,1
53,2023-08-12T02:00:00+10:00,2023-08-12,02:00,2,0,2
53,2023-08-12T02:09:00+10:00,2023-08-12,02:09,0,2,2
56,2023-08-12T01:56:00+10:00,2023-08-12,01:56,2,0,2
56,2023-08-12T01:58:00+10:00,2023-08-12,01:58,0,2,2
56,2023-08-12T02:00:00+10:00,2023-08-12,02:00,3,1,4
56,2023-08-12T02:08:00+10:00,2023-08-12,02:08,2,0,2
56,2023-08-12T02:09:00+10:00,2023-08-12,02:09,0,1,1
58,2023-08-12T01:55:00+10:00,2023-08-12,01:55,5,3,8
62,2023-08-12T01:58:00+10:00,2023-08-12,01:58,0,5,5
62,2023-08-12T02:00:00+10:00,2023-08-12,02:00,2,0,2
62,2023-08-12T02:07:00+10:00,2023-08-12,02:07,2,1,3
63,2023-08-12T01:56:00+10:00,2023-08-12,01:56,0,2,2
63,2023-08-12T02:03:00+10:00,2023-08-12,02:03,0,3,3
63,2023-08-12T02:04:00+10:00,2023-08-12,02:04,2,1,3
63,2023-08-12T02:05:00+10:00,2023-08-12,02:05,2,0,2
63,2023-08-12T02:08:00+10:00,2023-08-12,02:08,0,2,2
67,2023-08-12T02:07:00+10:00,2023-08-12,02:07,2,1,3
72,2023-08-12T01:55:00+10:00,2023-08-12,01:55,0,1,1
72,2023-08-12T01:59:00+10:00,2023-08-12,01:59,1,0,1
72,2023-08-12T02:05:00+10:00,2023-08-12,02:05,0,1,1
72,2023-08-12T02:08:00+10:00,2023-08-12,02:08,0,1,1
79,2023-08-12T01:57:00+10:00,2023-08-12,01:57,0,7,7
79,2023-08-12T02:01:00+10:00,2023-08-12,02:01,7,1,8
79,2023-08-12T02:06:00+10:00,2023-08-12,02:06,0,2,2
109,2023-08-12T02:05:00+10:00,2023-08-12,02:05,0,8,8
117,2023-08-12T02:00:00+10:00,2023-08-12,02:00,6,6,12
122,2023-08-12T01:57:00+10:00,2023-08-12,01:57,1,0,1
3,2023-08-12T02:13:00+10:00,2023-08-12,02:13,5,2,7
3,2023-08-12T02:14:00+10:00,2023-08-12,02:14,2,0,2
3,2023-08-12T02:15:00+10:00,2023-08-12,02:15,8,7,15
3,2023-08-12T02:16:00+10:00,2023-08-12,02:16,0,1,1
3,2023-08-12T02:18:00+10:00,2023-08-12,02:18,10,1,11
3,2023-08-12T02:20:00+10:00,2023-08-12,02:20,2,4,6
4,2023-08-12T02:15:00+10:00,2023-08-12,02:15,6,0,6
4,2023-08-12T02:20:00+10:00,2023-08-12,02:20,1,2,3
4,2023-08-12T02:21:00+10:00,2023-08-12,02:21,9,7,16
6,2023-08-12T02:13:00+10:00,2023-08-12,02:13,2,0,2
6,2023-08-12T02:14:00+10:00,2023-08-12,02:14,0,1,1
6,2023-08-12T02:16:00+10:00,2023-08-12,02:16,2,1,3
6,2023-08-12T02:22:00+10:00,2023-08-12,02:22,1,2,3
6,2023-08-12T02:23:00+10:00,2023-08-12,02:23,2,1,3
14,2023-08-12T02:17:00+10:00,2023-08-12,02:17,1,0,1
21,2023-08-12T02:10:00+10:00,2023-08-12,02:10,5,0,5
21,2023-08-12T02:12:00+10:00,2023-08-12,02:12,0,4,4
21,2023-08-12T02:19:00+10:00,2023-08-12,02:19,0,4,4
21,2023-08-12T02:22:00+10:00,2023-08-12,02:22,3,4,7
21,2023-08-12T02:23:00+10:00,2023-08-12,02:23,4,0,4
28,2023-08-12T02:21:00+10:00,2023-08-12,02:21,3,0,3
28,2023-08-12T02:22:00+10:00,2023-08-12,02:22,0,1,1
41,2023-08-12T02:11:00+10:00,2023-08-12,02:11,0,1,1
41,2023-08-12T02:13:00+10:00,2023-08-12,02:13,0,4,4
41,2023-08-12T02:19:00+10:00,2023-08-12,02:19,2,2,4
41,2023-08-12T02:21:00+10:00,2023-08-12,02:21,0,1,1
41,2023-08-12T02:23:00+10:00,2023-08-12,02:23,4,3,7
54,2023-08-12T02:15:00+10:00,2023-08-12,02:15,1,0,1
54,2023-08-12T02:17:00+10:00,2023-08-12,02:17,0,2,2
54,2023-08-12T02:20:00+10:00,2023-08-12,02:20,0,1,1
55,2023-08-12T02:11:00+10:00,2023-08-12,02:11,1,4,5
55,2023-08-12T02:16:00+10:00,2023-08-12,02:16,3,5,8
55,2023-08-12T02:18:00+10:00,2023-08-12,02:18,2,0,2
55,2023-08-12T02:21:00+10:00,2023-08-12,02:21,1,2,3
55,2023-08-12T02:22:00+10:00,2023-08-12,02:22,7,7,14
55,2023-08-12T02:23:00+10:00,2023-08-12,02:23,2,1,3
55,2023-08-12T02:24:00+10:00,2023-08-12,02:24,1,0,1
65,2023-08-12T02:10:00+10:00,2023-08-12,02:10,0,1,1
65,2023-08-12T02:22:00+10:00,2023-08-12,02:22,0,1,1
65,2023-08-12T02:23:00+10:00,2023-08-12,02:23,0,1,1
65,2023-08-12T02:24:00+10:00,2023-08-12,02:24,0,2,2
66,2023-08-12T02:19:00+10:00,2023-08-12,02:19,3,0,3
69,2023-08-12T02:23:00+10:00,2023-08-12,02:23,0,1,1
75,2023-08-12T02:16:00+10:00,2023-08-12,02:16,0,1,1
75,2023-08-12T02:19:00+10:00,2023-08-12,02:19,1,0,1
77,2023-08-12T02:24:00+10:00,2023-08-12,02:24,1,0,1
108,2023-08-12T02:18:00+10:00,2023-08-12,02:18,3,3,6
118,2023-08-12T02:20:00+10:00,2023-08-12,02:20,0,1,1
1,2023-08-12T02:14:00+10:00,2023-08-12,02:14,0,2,2
1,2023-08-12T02:15:00+10:00,2023-08-12,02:15,0,1,1
1,2023-08-12T02:16:00+10:00,2023-08-12,02:16,4,0,4
1,2023-08-12T02:19:00+10:00,2023-08-12,02:19,1,0,1
2,2023-08-12T02:19:00+10:00,2023-08-12,02:19,0,2,2
2,2023-08-12T02:21:00+10:00,2023-08-12,02:21,0,1,1
2,2023-08-12T02:23:00+10:00,2023-08-12,02:23,4,0,4
9,2023-08-12T02:17:00+10:00,2023-08-12,02:17,1,0,1
9,2023-08-12T02:19:00+10:00,2023-08-12,02:19,0,3,3
17,2023-08-12T02:22:00+10:00,2023-08-12,02:22,1,0,1
17,2023-08-12T02:23:00+10:00,2023-08-12,02:23,1,0,1
24,2023-08-12T02:14:00+10:00,2023-08-12,02:14,0,2,2
24,2023-08-12T02:20:00+10:00,2023-08-12,02:20,3,0,3
27,2023-08-12T02:23:00+10:00,2023-08-12,02:23,1,0,1
35,2023-08-12T02:11:00+10:00,2023-08-12,02:11,2,3,5
35,2023-08-12T02:14:00+10:00,2023-08-12,02:14,3,0,3
35,2023-08-12T02:22:00+10:00,2023-08-12,02:22,4,0,4
53,2023-08-12T02:17:00+10:00,2023-08-12,02:17,0,1,1
53,2023-08-12T02:21:00+10:00,2023-08-12,02:21,1,0,1
58,2023-08-12T02:18:00+10:00,2023-08-12,02:18,0,4,4
58,2023-08-12T02:20:00+10:00,2023-08-12,02:20,0,1,1
58,2023-08-12T02:22:00+10:00,2023-08-12,02:22,1,6,7
58,2023-08-12T02:23:00+10:00,2023-08-12,02:23,1,2,3
62,2023-08-12T02:17:00+10:00,2023-08-12,02:17,1,0,1
62,2023-08-12T02:18:00+10:00,2023-08-12,02:18,2,1,3
62,2023-08-12T02:21:00+10:00,2023-08-12,02:21,3,0,3
62,2023-08-12T02:23:00+10:00,2023-08-12,02:23,1,0,1
63,2023-08-12T02:10:00+10:00,2023-08-12,02:10,0,5,5
63,2023-08-12T02:22:00+10:00,2023-08-12,02:22,0,1,1
68,2023-08-12T02:10:00+10:00,2023-08-12,02:10,1,0,1
72,2023-08-12T02:20:00+10:00,2023-08-12,02:20,3,1,4
79,2023-08-12T02:10:00+10:00,2023-08-12,02:10,1,2,3
79,2023-08-12T02:15:00+10:00,2023-08-12,02:15,0,1,1
79,2023-08-12T02:20:00+10:00,2023-08-12,02:20,2,4,6
79,2023-08-12T02:21:00+10:00,2023-08-12,02:21,4,6,10
79,2023-08-12T02:23:00+10:00,2023-08-12,02:23,0,2,2
109,2023-08-12T02:10:00+10:00,2023-08-12,02:10,1,4,5
117,2023-08-12T02:20:00+10:00,2023-08-12,02:20,0,4,4
3,2023-08-12T02:26:00+10:00,2023-08-12,02:26,0,11,11
3,2023-08-12T02:29:00+10:00,2023-08-12,02:29,0,1,1
3,2023-08-12T02:30:00+10:00,2023-08-12,02:30,4,0,4
3,2023-08-12T02:31:00+10:00,2023-08-12,02:31,1,0,1
3,2023-08-12T02:33:00+10:00,2023-08-12,02:33,4,1,5
3,2023-08-12T02:36:00+10:00,2023-08-12,02:36,4,0,4
3,2023-08-12T02:38:00+10:00,2023-08-12,02:38,4,1,5
4,2023-08-12T02:26:00+10:00,2023-08-12,02:26,6,0,6
4,2023-08-12T02:27:00+10:00,2023-08-12,02:27,0,2,2
4,2023-08-12T02:28:00+10:00,2023-08-12,02:28,0,1,1
4,2023-08-12T02:29:00+10:00,2023-08-12,02:29,5,6,11
4,2023-08-12T02:30:00+10:00,2023-08-12,02:30,1,1,2
4,2023-08-12T02:32:00+10:00,2023-08-12,02:32,0,2,2
4,2023-08-12T02:35:00+10:00,2023-08-12,02:35,1,0,1
4,2023-08-12T02:39:00+10:00,2023-08-12,02:39,0,1,1
6,2023-08-12T02:27:00+10:00,2023-08-12,02:27,2,0,2
6,2023-08-12T02:28:00+10:00,2023-08-12,02:28,1,1,2
6,2023-08-12T02:39:00+10:00,2023-08-12,02:39,0,2,2
14,2023-08-12T02:31:00+10:00,2023-08-12,02:31,8,0,8
14,2023-08-12T02:37:00+10:00,2023-08-12,02:37,2,0,2
21,2023-08-12T02:28:00+10:00,2023-08-12,02:28,0,1,1
21,2023-08-12T02:31:00+10:00,2023-08-12,02:31,1,0,1
21,2023-08-12T02:37:00+10:00,2023-08-12,02:37,2,2,4
21,2023-08-12T02:39:00+10:00,2023-08-12,02:39,2,3,5
28,2023-08-12T02:27:00+10:00,2023-08-12,02:27,0,1,1
28,2023-08-12T02:34:00+10:00,2023-08-12,02:34,2,0,2
41,2023-08-12T02:28:00+10:00,2023-08-12,02:28,3,9,12
41,2023-08-12T02:30:00+10:00,2023-08-12,02:30,2,0,2
41,2023-08-12T02:36:00+10:00,2023-08-12,02:36,1,0,1
54,2023-08-12T02:33:00+10:00,2023-08-12,02:33,4,0,4
55,2023-08-12T02:28:00+10:00,2023-08-12,02:28,1,0,1
55,2023-08-12T02:29:00+10:00,2023-08-12,02:29,4,0,4
55,2023-08-12T02:30:00+10:00,2023-08-12,02:30,1,0,1
55,2023-08-12T02:36:00+10:00,2023-08-12,02:36,0,1,1
55,2023-08-12T02:37:00+10:00,2023-08-12,02:37,0,2,2
59,2023-08-12T02:30:00+10:00,2023-08-12,02:30,3,2,5
61,2023-08-12T02:30:00+10:00,2023-08-12,02:30,0,1,1
65,2023-08-12T02:25:00+10:00,2023-08-12,02:25,0,1,1
65,2023-08-12T02:37:00+10:00,2023-08-12,02:37,2,0,2
66,2023-08-12T02:25:00+10:00,2023-08-12,02:25,1,0,1
66,2023-08-12T02:29:00+10:00,2023-08-12,02:29,1,0,1
66,2023-08-12T02:31:00+10:00,2023-08-12,02:31,0,2,2
66,2023-08-12T02:33:00+10:00,2023-08-12,02:33,2,2,4
66,2023-08-12T02:37:00+10:00,2023-08-12,02:37,3,1,4
66,2023-08-12T02:38:00+10:00,2023-08-12,02:38,6,0,6
75,2023-08-12T02:38:00+10:00,2023-08-12,02:38,0,1,1
77,2023-08-12T02:32:00+10:00,2023-08-12,02:32,0,1,1
78,2023-08-12T02:29:00+10:00,2023-08-12,02:29,0,1,1
84,2023-08-12T02:30:00+10:00,2023-08-12,02:30,2,5,7
108,2023-08-12T02:32:00+10:00,2023-08-12,02:32,1,0,1
118,2023-08-12T02:25:00+10:00,2023-08-12,02:25,0,1,1
1,2023-08-12T02:25:00+10:00,2023-08-12,02:25,0,1,1
1,2023-08-12T02:37:00+10:00,2023-08-12,02:37,4,0,4
1,2023-08-12T02:39:00+10:00,2023-08-12,02:39,1,0,1
2,2023-08-12T02:29:00+10:00,2023-08-12,02:29,0,3,3
2,2023-08-12T02:33:00+10:00,2023-08-12,02:33,0,1,1
10,2023-08-12T02:34:00+10:00,2023-08-12,02:34,0,1,1
12,2023-08-12T02:28:00+10:00,2023-08-12,02:28,0,2,2
12,2023-08-12T02:36:00+10:00,2023-08-12,02:36,1,0,1
24,2023-08-12T02:31:00+10:00,2023-08-12,02:31,0,2,2
27,2023-08-12T02:33:00+10:00,2023-08-12,02:33,2,0,2
35,2023-08-12T02:27:00+10:00,2023-08-12,02:27,1,0,1
35,2023-08-12T02:32:00+10:00,2023-08-12,02:32,2,1,3
35,2023-08-12T02:36:00+10:00,2023-08-12,02:36,0,9,9
35,2023-08-12T02:39:00+10:00,2023-08-12,02:39,0,1,1
53,2023-08-12T02:25:00+10:00,2023-08-12,02:25,1,0,1
53,2023-08-12T02:31:00+10:00,2023-08-12,02:31,0,1,1
53,2023-08-12T02:33:00+10:00,2023-08-12,02:33,0,2,2
56,2023-08-12T02:28:00+10:00,2023-08-12,02:28,3,2,5
56,2023-08-12T02:33:00+10:00,2023-08-12,02:33,1,0,1
56,2023-08-12T02:34:00+10:00,2023-08-12,02:34,0,2,2
56,2023-08-12T02:35:00+10:00,2023-08-12,02:35,2,0,2
56,2023-08-12T02:37:00+10:00,2023-08-12,02:37,1,3,4
58,2023-08-12T02:25:00+10:00,2023-08-12,02:25,1,4,5
58,2023-08-12T02:27:00+10:00,2023-08-12,02:27,0,1,1
58,2023-08-12T02:28:00+10:00,2023-08-12,02:28,0,2,2
58,2023-08-12T02:32:00+10:00,2023-08-12,02:32,3,2,5
62,2023-08-12T02:27:00+10:00,2023-08-12,02:27,9,0,9
62,2023-08-12T02:34:00+10:00,2023-08-12,02:34,1,0,1
62,2023-08-12T02:36:00+10:00,2023-08-12,02:36,2,0,2
62,2023-08-12T02:37:00+10:00,2023-08-12,02:37,0,1,1
63,2023-08-12T02:28:00+10:00,2023-08-12,02:28,0,2,2
63,2023-08-12T02:30:00+10:00,2023-08-12,02:30,2,2,4
63,2023-08-12T02:35:00+10:00,2023-08-12,02:35,9,1,10
63,2023-08-12T02:36:00+10:00,2023-08-12,02:36,0,1,1
63,2023-08-12T02:38:00+10:00,2023-08-12,02:38,2,4,6
67,2023-08-12T02:25:00+10:00,2023-08-12,02:25,0,2,2
67,2023-08-12T02:34:00+10:00,2023-08-12,02:34,0,6,6
67,2023-08-12T02:38:00+10:00,2023-08-12,02:38,0,1,1
68,2023-08-12T02:37:00+10:00,2023-08-12,02:37,0,1,1
72,2023-08-12T02:37:00+10:00,2023-08-12,02:37,1,0,1
72,2023-08-12T02:38:00+10:00,2023-08-12,02:38,0,1,1
79,2023-08-12T02:25:00+10:00,2023-08-12,02:25,0,1,1
79,2023-08-12T02:26:00+10:00,2023-08-12,02:26,2,3,5
79,2023-08-12T02:28:00+10:00,2023-08-12,02:28,1,3,4
79,2023-08-12T02:30:00+10:00,2023-08-12,02:30,3,2,5
79,2023-08-12T02:34:00+10:00,2023-08-12,02:34,1,1,2
79,2023-08-12T02:38:00+10:00,2023-08-12,02:38,1,2,3
86,2023-08-12T02:33:00+10:00,2023-08-12,02:33,0,2,2
109,2023-08-12T02:35:00+10:00,2023-08-12,02:35,0,1,1
117,2023-08-12T02:30:00+10:00,2023-08-12,02:30,0,2,2
122,2023-08-12T02:33:00+10:00,2023-08-12,02:33,1,0,1
3,2023-08-12T02:42:00+10:00,2023-08-12,02:42,3,1,4
3,2023-08-12T02:46:00+10:00,2023-08-12,02:46,2,1,3
3,2023-08-12T02:51:00+10:00,2023-08-12,02:51,2,0,2
3,2023-08-12T02:52:00+10:00,2023-08-12,02:52,2,2,4
3,2023-08-12T02:54:00+10:00,2023-08-12,02:54,1,0,1
4,2023-08-12T02:42:00+10:00,2023-08-12,02:42,1,1,2
4,2023-08-12T02:43:00+10:00,2023-08-12,02:43,0,2,2
4,2023-08-12T02:46:00+10:00,2023-08-12,02:46,0,2,2
4,2023-08-12T02:47:00+10:00,2023-08-12,02:47,0,1,1
4,2023-08-12T02:50:00+10:00,2023-08-12,02:50,0,3,3
4,2023-08-12T02:52:00+10:00,2023-08-12,02:52,2,1,3
4,2023-08-12T02:53:00+10:00,2023-08-12,02:53,2,1,3
6,2023-08-12T02:42:00+10:00,2023-08-12,02:42,2,2,4
6,2023-08-12T02:44:00+10:00,2023-08-12,02:44,5,0,5
6,2023-08-12T02:45:00+10:00,2023-08-12,02:45,0,1,1
6,2023-08-12T02:48:00+10:00,2023-08-12,02:48,0,1,1
6,2023-08-12T02:54:00+10:00,2023-08-12,02:54,0,2,2
14,2023-08-12T02:46:00+10:00,2023-08-12,02:46,4,0,4
21,2023-08-12T02:41:00+10:00,2023-08-12,02:41,5,0,5
28,2023-08-12T02:44:00+10:00,2023-08-12,02:44,2,0,2
28,2023-08-12T02:49:00+10:00,2023-08-12,02:49,1,0,1
39,2023-08-12T02:45:00+10:00,2023-08-12,02:45,0,1,1
41,2023-08-12T02:46:00+10:00,2023-08-12,02:46,3,2,5
41,2023-08-12T02:52:00+10:00,2023-08-12,02:52,4,0,4
41,2023-08-12T02:53:00+10:00,2023-08-12,02:53,3,3,6
54,2023-08-12T02:41:00+10:00,2023-08-12,02:41,0,1,1
55,2023-08-12T02:40:00+10:00,2023-08-12,02:40,2,5,7
55,2023-08-12T02:42:00+10:00,2023-08-12,02:42,1,1,2
55,2023-08-12T02:47:00+10:00,2023-08-12,02:47,4,5,9
55,2023-08-12T02:49:00+10:00,2023-08-12,02:49,2,8,10
55,2023-08-12T02:51:00+10:00,2023-08-12,02:51,3,1,4
55,2023-08-12T02:52:00+10:00,2023-08-12,02:52,1,0,1
59,2023-08-12T02:40:00+10:00,2023-08-12,02:40,5,5,10
59,2023-08-12T02:45:00+10:00,2023-08-12,02:45,8,5,13
61,2023-08-12T02:44:00+10:00,2023-08-12,02:44,3,0,3
65,2023-08-12T02:43:00+10:00,2023-08-12,02:43,0,3,3
65,2023-08-12T02:45:00+10:00,2023-08-12,02:45,0,1,1
65,2023-08-12T02:54:00+10:00,2023-08-12,02:54,0,3,3
66,2023-08-12T02:53:00+10:00,2023-08-12,02:53,2,0,2
75,2023-08-12T02:43:00+10:00,2023-08-12,02:43,1,0,1
84,2023-08-12T02:50:00+10:00,2023-08-12,02:50,1,14,15
108,2023-08-12T02:52:00+10:00,2023-08-12,02:52,0,3,3
108,2023-08-12T02:54:00+10:00,2023-08-12,02:54,1,0,1
1,2023-08-12T02:45:00+10:00,2023-08-12,02:45,0,2,2
2,2023-08-12T02:44:00+10:00,2023-08-12,02:44,0,1,1
2,2023-08-12T02:52:00+10:00,2023-08-12,02:52,0,6,6
2,2023-08-12T02:53:00+10:00,2023-08-12,02:53,0,1,1
2,2023-08-12T02:54:00+10:00,2023-08-12,02:54,1,0,1
10,2023-08-12T02:54:00+10:00,2023-08-12,02:54,2,0,2
17,2023-08-12T02:41:00+10:00,2023-08-12,02:41,1,0,1
24,2023-08-12T02:49:00+10:00,2023-08-12,02:49,0,1,1
27,2023-08-12T02:54:00+10:00,2023-08-12,02:54,1,0,1
35,2023-08-12T02:45:00+10:00,2023-08-12,02:45,0,2,2
53,2023-08-12T02:49:00+10:00,2023-08-12,02:49,3,1,4
56,2023-08-12T02:41:00+10:00,2023-08-12,02:41,3,1,4
56,2023-08-12T02:54:00+10:00,2023-08-12,02:54,1,0,1
58,2023-08-12T02:43:00+10:00,2023-08-12,02:43,2,0,2
58,2023-08-12T02:49:00+10:00,2023-08-12,02:49,1,2,3
58,2023-08-12T02:51:00+10:00,2023-08-12,02:51,0,1,1
58,2023-08-12T02:53:00+10:00,2023-08-12,02:53,0,1,1
62,2023-08-12T02:43:00+10:00,2023-08-12,02:43,0,1,1
62,2023-08-12T02:44:00+10:00,2023-08-12,02:44,1,1,2
62,2023-08-12T02:45:00+10:00,2023-08-12,02:45,1,3,4
62,2023-08-12T02:54:00+10:00,2023-08-12,02:54,1,0,1
63,2023-08-12T02:44:00+10:00,2023-08-12,02:44,2,1,3
63,2023-08-12T02:50:00+10:00,2023-08-12,02:50,0,6,6
67,2023-08-12T02:40:00+10:00,2023-08-12,02:40,0,1,1
67,2023-08-12T02:50:00+10:00,2023-08-12,02:50,1,3,4
72,2023-08-12T02:40:00+10:00,2023-08-12,02:40,0,1,1
72,2023-08-12T02:52:00+10:00,2023-08-12,02:52,0,1,1
79,2023-08-12T02:42:00+10:00,2023-08-12,02:42,1,2,3
79,2023-08-12T02:44:00+10:00,2023-08-12,02:44,3,2,5
109,2023-08-12T02:40:00+10:00,2023-08-12,02:40,2,0,2
109,2023-08-12T02:45:00+10:00,2023-08-12,02:45,0,1,1
117,2023-08-12T02:40:00+10:00,2023-08-12,02:40,1,1,2
117,2023-08-12T02:50:00+10:00,2023-08-12,02:50,0,2,2
122,2023-08-12T02:45:00+10:00,2023-08-12,02:45,2,0,2
122,2023-08-12T02:46:00+10:00,2023-08-12,02:46,1,0,1
122,2023-08-12T02:47:00+10:00,2023-08-12,02:47,0,1,1
3,2023-08-12T02:55:00+10:00,2023-08-12,02:55,4,0,4
3,2023-08-12T02:56:00+10:00,2023-08-12,02:56,3,3,6
3,2023-08-12T02:58:00+10:00,2023-08-12,02:58,12,1,13
3,2023-08-12T03:00:00+10:00,2023-08-12,03:00,11,3,14
3,2023-08-12T03:05:00+10:00,2023-08-12,03:05,0,7,7
3,2023-08-12T03:06:00+10:00,2023-08-12,03:06,7,2,9
3,2023-08-12T03:08:00+10:00,2023-08-12,03:08,1,4,5
4,2023-08-12T03:00:00+10:00,2023-08-12,03:00,0,4,4
4,2023-08-12T03:04:00+10:00,2023-08-12,03:04,1,7,8
4,2023-08-12T03:08:00+10:00,2023-08-12,03:08,0,2,2
4,2023-08-12T03:09:00+10:00,2023-08-12,03:09,0,2,2
6,2023-08-12T03:01:00+10:00,2023-08-12,03:01,2,1,3
6,2023-08-12T03:07:00+10:00,2023-08-12,03:07,0,5,5
14,2023-08-12T02:58:00+10:00,2023-08-12,02:58,2,0,2
21,2023-08-12T02:57:00+10:00,2023-08-12,02:57,0,2,2
21,2023-08-12T03:00:00+10:00,2023-08-12,03:00,5,3,8
28,2023-08-12T02:55:00+10:00,2023-08-12,02:55,1,0,1
28,2023-08-12T02:57:00+10:00,2023-08-12,02:57,1,0,1
28,2023-08-12T03:03:00+10:00,2023-08-12,03:03,2,0,2
29,2023-08-12T03:08:00+10:00,2023-08-12,03:08,0,1,1
41,2023-08-12T02:55:00+10:00,2023-08-12,02:55,2,0,2
41,2023-08-12T02:57:00+10:00,2023-08-12,02:57,1,10,11
41,2023-08-12T02:59:00+10:00,2023-08-12,02:59,0,4,4
41,2023-08-12T03:02:00+10:00,2023-08-12,03:02,2,2,4
41,2023-08-12T03:05:00+10:00,2023-08-12,03:05,0,2,2
41,2023-08-12T03:07:00+10:00,2023-08-12,03:07,4,7,11
41,2023-08-12T03:09:00+10:00,2023-08-12,03:09,0,3,3
54,2023-08-12T02:58:00+10:00,2023-08-12,02:58,0,1,1
54,2023-08-12T03:08:00+10:00,2023-08-12,03:08,1,0,1
55,2023-08-12T02:58:00+10:00,2023-08-12,02:58,2,4,6
55,2023-08-12T03:02:00+10:00,2023-08-12,03:02,0,2,2
55,2023-08-12T03:03:00+10:00,2023-08-12,03:03,1,0,1
55,2023-08-12T03:06:00+10:00,2023-08-12,03:06,2,0,2
59,2023-08-12T02:55:00+10:00,2023-08-12,02:55,5,3,8
61,2023-08-12T02:58:00+10:00,2023-08-12,02:58,0,1,1
61,2023-08-12T03:06:00+10:00,2023-08-12,03:06,2,0,2
65,2023-08-12T02:57:00+10:00,2023-08-12,02:57,0,1,1
65,2023-08-12T02:58:00+10:00,2023-08-12,02:58,0,1,1
65,2023-08-12T02:59:00+10:00,2023-08-12,02:59,0,2,2
65,2023-08-12T03:01:00+10:00,2023-08-12,03:01,0,1,1
65,2023-08-12T03:02:00+10:00,2023-08-12,03:02,3,1,4
65,2023-08-12T03:04:00+10:00,2023-08-12,03:04,0,1,1
65,2023-08-12T03:07:00+10:00,2023-08-12,03:07,0,1,1
66,2023-08-12T02:57:00+10:00,2023-08-12,02:57,0,1,1
66,2023-08-12T03:02:00+10:00,2023-08-12,03:02,6,2,8
66,2023-08-12T03:07:00+10:00,2023-08-12,03:07,1,0,1
75,2023-08-12T03:03:00+10:00,2023-08-12,03:03,0,1,1
77,2023-08-12T03:06:00+10:00,2023-08-12,03:06,2,0,2
108,2023-08-12T02:55:00+10:00,2023-08-12,02:55,1,0,1
108,2023-08-12T03:06:00+10:00,2023-08-12,03:06,1,0,1
1,2023-08-12T02:59:00+10:00,2023-08-12,02:59,0,2,2
1,2023-08-12T03:04:00+10:00,2023-08-12,03:04,1,1,2
1,2023-08-12T03:09:00+10:00,2023-08-12,03:09,0,2,2
2,2023-08-12T02:58:00+10:00,2023-08-12,02:58,0,1,1
2,2023-08-12T03:03:00+10:00,2023-08-12,03:03,0,4,4
2,2023-08-12T03:06:00+10:00,2023-08-12,03:06,0,2,2
9,2023-08-12T03:09:00+10:00,2023-08-12,03:09,0,1,1
17,2023-08-12T02:58:00+10:00,2023-08-12,02:58,0,1,1
17,2023-08-12T03:01:00+10:00,2023-08-12,03:01,1,0,1
24,2023-08-12T03:00:00+10:00,2023-08-12,03:00,3,1,4
24,2023-08-12T03:02:00+10:00,2023-08-12,03:02,1,1,2
24,2023-08-12T03:06:00+10:00,2023-08-12,03:06,3,0,3
24,2023-08-12T03:09:00+10:00,2023-08-12,03:09,2,0,2
35,2023-08-12T03:05:00+10:00,2023-08-12,03:05,0,2,2
53,2023-08-12T02:57:00+10:00,2023-08-12,02:57,1,0,1
53,2023-08-12T02:58:00+10:00,2023-08-12,02:58,2,0,2
53,2023-08-12T03:03:00+10:00,2023-08-12,03:03,0,1,1
56,2023-08-12T02:55:00+10:00,2023-08-12,02:55,2,0,2
56,2023-08-12T03:04:00+10:00,2023-08-12,03:04,2,1,3
56,2023-08-12T03:08:00+10:00,2023-08-12,03:08,5,1,6
58,2023-08-12T02:56:00+10:00,2023-08-12,02:56,0,1,1
58,2023-08-12T02:57:00+10:00,2023-08-12,02:57,0,1,1
58,2023-08-12T02:58:00+10:00,2023-08-12,02:58,2,0,2
58,2023-08-12T03:00:00+10:00,2023-08-12,03:00,1,0,1
58,2023-08-12T03:06:00+10:00,2023-08-12,03:06,2,0,2
62,2023-08-12T02:59:00+10:00,2023-08-12,02:59,1,0,1
62,2023-08-12T03:04:00+10:00,2023-08-12,03:04,0,1,1
63,2023-08-12T02:56:00+10:00,2023-08-12,02:56,0,2,2
63,2023-08-12T02:58:00+10:00,2023-08-12,02:58,2,3,5
63,2023-08-12T03:00:00+10:00,2023-08-12,03:00,0,2,2
63,2023-08-12T03:04:00+10:00,2023-08-12,03:04,0,1,1
63,2023-08-12T03:06:00+10:00,2023-08-12,03:06,0,3,3
67,2023-08-12T03:03:00+10:00,2023-08-12,03:03,0,2,2
72,2023-08-12T02:57:00+10:00,2023-08-12,02:57,0,1,1
79,2023-08-12T02:55:00+10:00,2023-08-12,02:55,4,3,7
79,2023-08-12T02:57:00+10:00,2023-08-12,02:57,3,2,5
79,2023-08-12T02:58:00+10:00,2023-08-12,02:58,0,2,2
79,2023-08-12T03:02:00+10:00,2023-08-12,03:02,0,1,1
79,2023-08-12T03:03:00+10:00,2023-08-12,03:03,1,3,4
79,2023-08-12T03:04:00+10:00,2023-08-12,03:04,0,1,1
79,2023-08-12T03:08:00+10:00,2023-08-12,03:08,3,2,5
79,2023-08-12T03:09:00+10:00,2023-08-12,03:09,1,0,1
86,2023-08-12T02:56:00+10:00,2023-08-12,02:56,0,1,1
117,2023-08-12T03:00:00+10:00,2023-08-12,03:00,1,0,1
117,2023-08-12T03:05:00+10:00,2023-08-12,03:05,1,4,5
3,2023-08-12T03:13:00+10:00,2023-08-12,03:13,8,5,13
3,2023-08-12T03:15:00+10:00,2023-08-12,03:15,4,0,4
3,2023-08-12T03:16:00+10:00,2023-08-12,03:16,6,1,7
3,2023-08-12T03:19:00+10:00,2023-08-12,03:19,5,1,6
3,2023-08-12T03:23:00+10:00,2023-08-12,03:23,6,4,10
4,2023-08-12T03:10:00+10:00,2023-08-12,03:10,2,2,4
4,2023-08-12T03:11:00+10:00,2023-08-12,03:11,0,2,2
4,2023-08-12T03:15:00+10:00,2023-08-12,03:15,0,1,1
4,2023-08-12T03:18:00+10:00,2023-08-12,03:18,2,1,3
4,2023-08-12T03:19:00+10:00,2023-08-12,03:19,0,4,4
4,2023-08-12T03:21:00+10:00,2023-08-12,03:21,2,2,4
4,2023-08-12T03:23:00+10:00,2023-08-12,03:23,1,0,1
6,2023-08-12T03:12:00+10:00,2023-08-12,03:12,4,0,4
6,2023-08-12T03:16:00+10:00,2023-08-12,03:16,2,0,2
6,2023-08-12T03:22:00+10:00,2023-08-12,03:22,3,0,3
6,2023-08-12T03:24:00+10:00,2023-08-12,03:24,1,1,2
14,2023-08-12T03:16:00+10:00,2023-08-12,03:16,1,0,1
14,2023-08-12T03:19:00+10:00,2023-08-12,03:19,1,0,1
14,2023-08-12T03:21:00+10:00,2023-08-12,03:21,1,0,1
21,2023-08-12T03:13:00+10:00,2023-08-12,03:13,0,1,1
21,2023-08-12T03:20:00+10:00,2023-08-12,03:20,2,0,2
21,2023-08-12T03:22:00+10:00,2023-08-12,03:22,1,2,3
21,2023-08-12T03:23:00+10:00,2023-08-12,03:23,0,6,6
21,2023-08-12T03:24:00+10:00,2023-08-12,03:24,0,1,1
28,2023-08-12T03:15:00+10:00,2023-08-12,03:15,1,0,1
28,2023-08-12T03:19:00+10:00,2023-08-12,03:19,1,0,1
29,2023-08-12T03:19:00+10:00,2023-08-12,03:19,3,1,4
41,2023-08-12T03:13:00+10:00,2023-08-12,03:13,2,3,5
41,2023-08-12T03:20:00+10:00,2023-08-12,03:20,4,1,5
54,2023-08-12T03:11:00+10:00,2023-08-12,03:11,0,1,1
55,2023-08-12T03:11:00+10:00,2023-08-12,03:11,11,4,15
55,2023-08-12T03:13:00+10:00,2023-08-12,03:13,6,0,6
55,2023-08-12T03:14:00+10:00,2023-08-12,03:14,8,0,8
55,2023-08-12T03:15:00+10:00,2023-08-12,03:15,2,2,4
55,2023-08-12T03:20:00+10:00,2023-08-12,03:20,0,3,3
55,2023-08-12T03:23:00+10:00,2023-08-12,03:23,4,0,4
61,2023-08-12T03:12:00+10:00,2023-08-12,03:12,1,0,1
61,2023-08-12T03:18:00+10:00,2023-08-12,03:18,0,1,1
65,2023-08-12T03:18:00+10:00,2023-08-12,03:18,1,1,2
66,2023-08-12T03:10:00+10:00,2023-08-12,03:10,3,0,3
66,2023-08-12T03:13:00+10:00,2023-08-12,03:13,3,0,3
66,2023-08-12T03:15:00+10:00,2023-08-12,03:15,1,0,1
66,2023-08-12T03:22:00+10:00,2023-08-12,03:22,1,0,1
78,2023-08-12T03:14:00+10:00,2023-08-12,03:14,3,0,3
84,2023-08-12T03:15:00+10:00,2023-08-12,03:15,11,12,23
108,2023-08-12T03:16:00+10:00,2023-08-12,03:16,2,0,2
108,2023-08-12T03:23:00+10:00,2023-08-12,03:23,1,0,1
2,2023-08-12T03:20:00+10:00,2023-08-12,03:20,0,2,2
9,2023-08-12T03:12:00+10:00,2023-08-12,03:12,1,0,1
24,2023-08-12T03:18:00+10:00,2023-08-12,03:18,2,1,3
27,2023-08-12T03:20:00+10:00,2023-08-12,03:20,1,0,1
35,2023-08-12T03:12:00+10:00,2023-08-12,03:12,1,3,4
35,2023-08-12T03:13:00+10:00,2023-08-12,03:13,0,2,2
56,2023-08-12T03:10:00+10:00,2023-08-12,03:10,2,0,2
56,2023-08-12T03:21:00+10:00,2023-08-12,03:21,3,1,4
56,2023-08-12T03:22:00+10:00,2023-08-12,03:22,0,5,5
58,2023-08-12T03:13:00+10:00,2023-08-12,03:13,0,1,1
58,2023-08-12T03:18:00+10:00,2023-08-12,03:18,1,0,1
62,2023-08-12T03:14:00+10:00,2023-08-12,03:14,3,1,4
62,2023-08-12T03:17:00+10:00,2023-08-12,03:17,1,3,4
62,2023-08-12T03:18:00+10:00,2023-08-12,03:18,0,7,7
62,2023-08-12T03:19:00+10:00,2023-08-12,03:19,0,3,3
63,2023-08-12T03:14:00+10:00,2023-08-12,03:14,0,1,1
63,2023-08-12T03:18:00+10:00,2023-08-12,03:18,1,4,5
63,2023-08-12T03:21:00+10:00,2023-08-12,03:21,0,3,3
63,2023-08-12T03:24:00+10:00,2023-08-12,03:24,3,1,4
68,2023-08-12T03:11:00+10:00,2023-08-12,03:11,2,0,2
72,2023-08-12T03:16:00+10:00,2023-08-12,03:16,0,1,1
79,2023-08-12T03:11:00+10:00,2023-08-12,03:11,0,1,1
79,2023-08-12T03:13:00+10:00,2023-08-12,03:13,1,3,4
79,2023-08-12T03:14:00+10:00,2023-08-12,03:14,1,2,3
109,2023-08-12T03:15:00+10:00,2023-08-12,03:15,0,1,1
117,2023-08-12T03:15:00+10:00,2023-08-12,03:15,3,0,3
122,2023-08-12T03:21:00+10:00,2023-08-12,03:21,0,1,1
3,2023-08-12T09:12:00+10:00,2023-08-12,09:12,4,3,7
3,2023-08-12T09:14:00+10:00,2023-08-12,09:14,2,7,9
3,2023-08-12T09:17:00+10:00,2023-08-12,09:17,0,1,1
3,2023-08-12T09:19:00+10:00,2023-08-12,09:19,1,6,7
3,2023-08-12T09:20:00+10:00,2023-08-12,09:20,2,7,9
3,2023-08-12T09:22:00+10:00,2023-08-12,09:22,3,2,5
3,2023-08-12T09:24:00+10:00,2023-08-12,09:24,5,1,6
4,2023-08-12T09:11:00+10:00,2023-08-12,09:11,9,2,11
4,2023-08-12T09:12:00+10:00,2023-08-12,09:12,6,7,13
4,2023-08-12T09:15:00+10:00,2023-08-12,09:15,15,5,20
4,2023-08-12T09:20:00+10:00,2023-08-12,09:20,6,7,13
4,2023-08-12T09:23:00+10:00,2023-08-12,09:23,7,3,10
6,2023-08-12T09:14:00+10:00,2023-08-12,09:14,10,1,11
6,2023-08-12T09:15:00+10:00,2023-08-12,09:15,3,1,4
6,2023-08-12T09:16:00+10:00,2023-08-12,09:16,10,2,12
8,2023-08-12T09:15:00+10:00,2023-08-12,09:15,1,3,4
8,2023-08-12T09:16:00+10:00,2023-08-12,09:16,1,0,1
8,2023-08-12T09:17:00+10:00,2023-08-12,09:17,0,1,1
8,2023-08-12T09:19:00+10:00,2023-08-12,09:19,0,3,3
8,2023-08-12T09:24:00+10:00,2023-08-12,09:24,2,6,8
14,2023-08-12T09:10:00+10:00,2023-08-12,09:10,10,2,12
14,2023-08-12T09:14:00+10:00,2023-08-12,09:14,1,2,3
14,2023-08-12T09:15:00+10:00,2023-08-12,09:15,3,0,3
14,2023-08-12T09:20:00+10:00,2023-08-12,09:20,3,0,3
21,2023-08-12T09:14:00+10:00,2023-08-12,09:14,0,1,1
21,2023-08-12T09:15:00+10:00,2023-08-12,09:15,2,5,7
21,2023-08-12T09:19:00+10:00,2023-08-12,09:19,1,3,4
28,2023-08-12T09:11:00+10:00,2023-08-12,09:11,2,1,3
28,2023-08-12T09:13:00+10:00,2023-08-12,09:13,0,1,1
28,2023-08-12T09:14:00+10:00,2023-08-12,09:14,1,2,3
28,2023-08-12T09:15:00+10:00,2023-08-12,09:15,1,3,4
28,2023-08-12T09:19:00+10:00,2023-08-12,09:19,1,2,3
28,2023-08-12T09:20:00+10:00,2023-08-12,09:20,3,3,6
29,2023-08-12T09:12:00+10:00,2023-08-12,09:12,1,2,3
29,2023-08-12T09:17:00+10:00,2023-08-12,09:17,6,2,8
29,2023-08-12T09:19:00+10:00,2023-08-12,09:19,0,1,1
29,2023-08-12T09:21:00+10:00,2023-08-12,09:21,1,3,4
29,2023-08-12T09:24:00+10:00,2023-08-12,09:24,0,1,1
39,2023-08-12T09:11:00+10:00,2023-08-12,09:11,0,6,6
39,2023-08-12T09:15:00+10:00,2023-08-12,09:15,5,1,6
39,2023-08-12T09:21:00+10:00,2023-08-12,09:21,0,1,1
41,2023-08-12T09:12:00+10:00,2023-08-12,09:12,18,8,26
41,2023-08-12T09:15:00+10:00,2023-08-12,09:15,5,3,8
41,2023-08-12T09:18:00+10:00,2023-08-12,09:18,7,11,18
41,2023-08-12T09:20:00+10:00,2023-08-12,09:20,11,5,16
41,2023-08-12T09:23:00+10:00,2023-08-12,09:23,13,8,21
41,2023-08-12T09:24:00+10:00,2023-08-12,09:24,11,4,15
54,2023-08-12T09:14:00+10:00,2023-08-12,09:14,1,0,1
54,2023-08-12T09:18:00+10:00,2023-08-12,09:18,1,0,1
54,2023-08-12T09:20:00+10:00,2023-08-12,09:20,0,2,2
55,2023-08-12T09:14:00+10:00,2023-08-12,09:14,3,6,9
55,2023-08-12T09:18:00+10:00,2023-08-12,09:18,2,8,10
55,2023-08-12T09:20:00+10:00,2023-08-12,09:20,5,8,13
55,2023-08-12T09:21:00+10:00,2023-08-12,09:21,4,8,12
61,2023-08-12T09:14:00+10:00,2023-08-12,09:14,2,2,4
61,2023-08-12T09:15:00+10:00,2023-08-12,09:15,0,3,3
61,2023-08-12T09:16:00+10:00,2023-08-12,09:16,0,9,9
61,2023-08-12T09:20:00+10:00,2023-08-12,09:20,0,7,7
61,2023-08-12T09:24:00+10:00,2023-08-12,09:24,2,5,7
65,2023-08-12T09:10:00+10:00,2023-08-12,09:10,6,0,6
65,2023-08-12T09:18:00+10:00,2023-08-12,09:18,0,2,2
65,2023-08-12T09:19:00+10:00,2023-08-12,09:19,2,2,4
65,2023-08-12T09:22:00+10:00,2023-08-12,09:22,3,7,10
65,2023-08-12T09:24:00+10:00,2023-08-12,09:24,5,1,6
66,2023-08-12T09:11:00+10:00,2023-08-12,09:11,2,4,6
66,2023-08-12T09:13:00+10:00,2023-08-12,09:13,3,3,6
66,2023-08-12T09:15:00+10:00,2023-08-12,09:15,1,9,10
66,2023-08-12T09:17:00+10:00,2023-08-12,09:17,2,5,7
66,2023-08-12T09:22:00+10:00,2023-08-12,09:22,0,3,3
69,2023-08-12T09:17:00+10:00,2023-08-12,09:17,5,3,8
69,2023-08-12T09:20:00+10:00,2023-08-12,09:20,4,0,4
70,2023-08-12T09:10:00+10:00,2023-08-12,09:10,1,0,1
70,2023-08-12T09:11:00+10:00,2023-08-12,09:11,1,1,2
70,2023-08-12T09:14:00+10:00,2023-08-12,09:14,0,2,2
70,2023-08-12T09:19:00+10:00,2023-08-12,09:19,0,2,2
70,2023-08-12T09:24:00+10:00,2023-08-12,09:24,0,3,3
71,2023-08-12T09:12:00+10:00,2023-08-12,09:12,0,1,1
75,2023-08-12T09:10:00+10:00,2023-08-12,09:10,0,1,1
75,2023-08-12T09:19:00+10:00,2023-08-12,09:19,2,0,2
75,2023-08-12T09:21:00+10:00,2023-08-12,09:21,1,0,1
75,2023-08-12T09:22:00+10:00,2023-08-12,09:22,0,5,5
77,2023-08-12T09:12:00+10:00,2023-08-12,09:12,3,0,3
77,2023-08-12T09:13:00+10:00,2023-08-12,09:13,0,1,1
77,2023-08-12T09:15:00+10:00,2023-08-12,09:15,1,0,1
77,2023-08-12T09:16:00+10:00,2023-08-12,09:16,0,5,5
77,2023-08-12T09:17:00+10:00,2023-08-12,09:17,0,1,1
78,2023-08-12T09:11:00+10:00,2023-08-12,09:11,5,0,5
78,2023-08-12T09:21:00+10:00,2023-08-12,09:21,0,2,2
78,2023-08-12T09:22:00+10:00,2023-08-12,09:22,0,4,4
78,2023-08-12T09:23:00+10:00,2023-08-12,09:23,0,1,1
84,2023-08-12T09:15:00+10:00,2023-08-12,09:15,57,31,88
87,2023-08-12T09:11:00+10:00,2023-08-12,09:11,0,2,2
87,2023-08-12T09:13:00+10:00,2023-08-12,09:13,1,0,1
87,2023-08-12T09:17:00+10:00,2023-08-12,09:17,0,1,1
107,2023-08-12T09:15:00+10:00,2023-08-12,09:15,6,10,16
108,2023-08-12T09:16:00+10:00,2023-08-12,09:16,1,2,3
108,2023-08-12T09:18:00+10:00,2023-08-12,09:18,0,5,5
108,2023-08-12T09:20:00+10:00,2023-08-12,09:20,1,1,2
108,2023-08-12T09:22:00+10:00,2023-08-12,09:22,1,3,4
108,2023-08-12T09:23:00+10:00,2023-08-12,09:23,3,6,9
108,2023-08-12T09:24:00+10:00,2023-08-12,09:24,0,1,1
118,2023-08-12T09:20:00+10:00,2023-08-12,09:20,1,0,1
1,2023-08-12T09:12:00+10:00,2023-08-12,09:12,3,1,4
1,2023-08-12T09:15:00+10:00,2023-08-12,09:15,0,11,11
1,2023-08-12T09:17:00+10:00,2023-08-12,09:17,1,7,8
1,2023-08-12T09:20:00+10:00,2023-08-12,09:20,3,6,9
1,2023-08-12T09:22:00+10:00,2023-08-12,09:22,15,7,22
2,2023-08-12T09:11:00+10:00,2023-08-12,09:11,3,1,4
2,2023-08-12T09:13:00+10:00,2023-08-12,09:13,3,6,9
2,2023-08-12T09:15:00+10:00,2023-08-12,09:15,1,1,2
2,2023-08-12T09:16:00+10:00,2023-08-12,09:16,0,2,2
2,2023-08-12T09:19:00+10:00,2023-08-12,09:19,0,1,1
2,2023-08-12T09:24:00+10:00,2023-08-12,09:24,2,7,9
7,2023-08-12T09:13:00+10:00,2023-08-12,09:13,0,1,1
7,2023-08-12T09:22:00+10:00,2023-08-12,09:22,0,2,2
9,2023-08-12T09:11:00+10:00,2023-08-12,09:11,0,1,1
9,2023-08-12T09:12:00+10:00,2023-08-12,09:12,0,1,1
9,2023-08-12T09:14:00+10:00,2023-08-12,09:14,1,0,1
9,2023-08-12T09:15:00+10:00,2023-08-12,09:15,1,1,2
10,2023-08-12T09:11:00+10:00,2023-08-12,09:11,1,2,3
10,2023-08-12T09:21:00+10:00,2023-08-12,09:21,2,0,2
11,2023-08-12T09:17:00+10:00,2023-08-12,09:17,2,0,2
11,2023-08-12T09:18:00+10:00,2023-08-12,09:18,1,0,1
11,2023-08-12T09:20:00+10:00,2023-08-12,09:20,7,1,8
12,2023-08-12T09:13:00+10:00,2023-08-12,09:13,1,2,3
12,2023-08-12T09:14:00+10:00,2023-08-12,09:14,0,3,3
12,2023-08-12T09:18:00+10:00,2023-08-12,09:18,0,2,2
12,2023-08-12T09:22:00+10:00,2023-08-12,09:22,3,2,5
17,2023-08-12T09:18:00+10:00,2023-08-12,09:18,1,2,3
17,2023-08-12T09:19:00+10:00,2023-08-12,09:19,4,1,5
17,2023-08-12T09:22:00+10:00,2023-08-12,09:22,1,0,1
17,2023-08-12T09:23:00+10:00,2023-08-12,09:23,1,6,7
17,2023-08-12T09:24:00+10:00,2023-08-12,09:24,0,2,2
18,2023-08-12T09:12:00+10:00,2023-08-12,09:12,1,0,1
18,2023-08-12T09:22:00+10:00,2023-08-12,09:22,2,1,3
24,2023-08-12T09:11:00+10:00,2023-08-12,09:11,7,4,11
24,2023-08-12T09:12:00+10:00,2023-08-12,09:12,3,8,11
24,2023-08-12T09:15:00+10:00,2023-08-12,09:15,3,5,8
24,2023-08-12T09:19:00+10:00,2023-08-12,09:19,3,1,4
24,2023-08-12T09:21:00+10:00,2023-08-12,09:21,14,7,21
24,2023-08-12T09:24:00+10:00,2023-08-12,09:24,13,11,24
27,2023-08-12T09:10:00+10:00,2023-08-12,09:10,0,7,7
27,2023-08-12T09:13:00+10:00,2023-08-12,09:13,2,2,4
27,2023-08-12T09:15:00+10:00,2023-08-12,09:15,0,2,2
27,2023-08-12T09:17:00+10:00,2023-08-12,09:17,3,5,8
27,2023-08-12T09:20:00+10:00,2023-08-12,09:20,0,2,2
27,2023-08-12T09:23:00+10:00,2023-08-12,09:23,3,2,5
35,2023-08-12T09:10:00+10:00,2023-08-12,09:10,5,2,7
35,2023-08-12T09:12:00+10:00,2023-08-12,09:12,8,3,11
35,2023-08-12T09:15:00+10:00,2023-08-12,09:15,14,0,14
35,2023-08-12T09:16:00+10:00,2023-08-12,09:16,2,2,4
35,2023-08-12T09:17:00+10:00,2023-08-12,09:17,14,6,20
35,2023-08-12T09:18:00+10:00,2023-08-12,09:18,5,2,7
35,2023-08-12T09:21:00+10:00,2023-08-12,09:21,2,6,8
35,2023-08-12T09:22:00+10:00,2023-08-12,09:22,4,11,15
53,2023-08-12T09:14:00+10:00,2023-08-12,09:14,4,6,10
53,2023-08-12T09:15:00+10:00,2023-08-12,09:15,2,10,12
53,2023-08-12T09:20:00+10:00,2023-08-12,09:20,8,3,11
56,2023-08-12T09:12:00+10:00,2023-08-12,09:12,5,1,6
56,2023-08-12T09:15:00+10:00,2023-08-12,09:15,1,0,1
56,2023-08-12T09:18:00+10:00,2023-08-12,09:18,1,1,2
56,2023-08-12T09:22:00+10:00,2023-08-12,09:22,1,0,1
57,2023-08-12T09:10:00+10:00,2023-08-12,09:10,1,1,2
57,2023-08-12T09:11:00+10:00,2023-08-12,09:11,1,2,3
57,2023-08-12T09:12:00+10:00,2023-08-12,09:12,1,1,2
57,2023-08-12T09:13:00+10:00,2023-08-12,09:13,2,0,2
57,2023-08-12T09:18:00+10:00,2023-08-12,09:18,0,1,1
57,2023-08-12T09:22:00+10:00,2023-08-12,09:22,1,0,1
57,2023-08-12T09:23:00+10:00,2023-08-12,09:23,0,3,3
58,2023-08-12T09:11:00+10:00,2023-08-12,09:11,3,2,5
58,2023-08-12T09:13:00+10:00,2023-08-12,09:13,4,3,7
58,2023-08-12T09:15:00+10:00,2023-08-12,09:15,12,3,15
58,2023-08-12T09:16:00+10:00,2023-08-12,09:16,10,10,20
58,2023-08-12T09:20:00+10:00,2023-08-12,09:20,8,0,8
58,2023-08-12T09:21:00+10:00,2023-08-12,09:21,6,1,7
58,2023-08-12T09:22:00+10:00,2023-08-12,09:22,25,1,26
62,2023-08-12T09:12:00+10:00,2023-08-12,09:12,1,1,2
62,2023-08-12T09:19:00+10:00,2023-08-12,09:19,0,9,9
63,2023-08-12T09:12:00+10:00,2023-08-12,09:12,1,6,7
63,2023-08-12T09:13:00+10:00,2023-08-12,09:13,0,1,1
63,2023-08-12T09:17:00+10:00,2023-08-12,09:17,2,4,6
63,2023-08-12T09:21:00+10:00,2023-08-12,09:21,1,0,1
67,2023-08-12T09:11:00+10:00,2023-08-12,09:11,1,2,3
67,2023-08-12T09:15:00+10:00,2023-08-12,09:15,10,2,12
67,2023-08-12T09:22:00+10:00,2023-08-12,09:22,11,5,16
67,2023-08-12T09:23:00+10:00,2023-08-12,09:23,4,0,4
68,2023-08-12T09:11:00+10:00,2023-08-12,09:11,1,3,4
68,2023-08-12T09:14:00+10:00,2023-08-12,09:14,1,1,2
68,2023-08-12T09:17:00+10:00,2023-08-12,09:17,3,0,3
68,2023-08-12T09:19:00+10:00,2023-08-12,09:19,4,3,7
68,2023-08-12T09:20:00+10:00,2023-08-12,09:20,2,1,3
68,2023-08-12T09:24:00+10:00,2023-08-12,09:24,5,2,7
72,2023-08-12T09:12:00+10:00,2023-08-12,09:12,3,3,6
72,2023-08-12T09:19:00+10:00,2023-08-12,09:19,0,4,4
72,2023-08-12T09:21:00+10:00,2023-08-12,09:21,3,3,6
72,2023-08-12T09:22:00+10:00,2023-08-12,09:22,1,4,5
72,2023-08-12T09:23:00+10:00,2023-08-12,09:23,1,2,3
72,2023-08-12T09:24:00+10:00,2023-08-12,09:24,6,1,7
76,2023-08-12T09:11:00+10:00,2023-08-12,09:11,2,1,3
76,2023-08-12T09:13:00+10:00,2023-08-12,09:13,0,3,3
76,2023-08-12T09:14:00+10:00,2023-08-12,09:14,1,1,2
76,2023-08-12T09:16:00+10:00,2023-08-12,09:16,0,1,1
76,2023-08-12T09:19:00+10:00,2023-08-12,09:19,2,0,2
79,2023-08-12T09:11:00+10:00,2023-08-12,09:11,1,4,5
79,2023-08-12T09:15:00+10:00,2023-08-12,09:15,4,4,8
79,2023-08-12T09:17:00+10:00,2023-08-12,09:17,7,3,10
79,2023-08-12T09:20:00+10:00,2023-08-12,09:20,4,3,7
85,2023-08-12T09:12:00+10:00,2023-08-12,09:12,2,4,6
85,2023-08-12T09:21:00+10:00,2023-08-12,09:21,0,4,4
85,2023-08-12T09:22:00+10:00,2023-08-12,09:22,2,0,2
85,2023-08-12T09:24:00+10:00,2023-08-12,09:24,1,0,1
86,2023-08-12T09:10:00+10:00,2023-08-12,09:10,1,0,1
86,2023-08-12T09:14:00+10:00,2023-08-12,09:14,2,1,3
86,2023-08-12T09:17:00+10:00,2023-08-12,09:17,1,0,1
86,2023-08-12T09:22:00+10:00,2023-08-12,09:22,0,1,1
117,2023-08-12T09:10:00+10:00,2023-08-12,09:10,3,5,8
122,2023-08-12T09:10:00+10:00,2023-08-12,09:10,1,0,1
122,2023-08-12T09:12:00+10:00,2023-08-12,09:12,1,0,1
122,2023-08-12T09:21:00+10:00,2023-08-12,09:21,0,1,1
3,2023-08-12T09:25:00+10:00,2023-08-12,09:25,0,2,2
3,2023-08-12T09:35:00+10:00,2023-08-12,09:35,4,7,11
3,2023-08-12T09:36:00+10:00,2023-08-12,09:36,1,14,15
4,2023-08-12T09:34:00+10:00,2023-08-12,09:34,14,3,17
4,2023-08-12T09:35:00+10:00,2023-08-12,09:35,18,3,21
6,2023-08-12T09:28:00+10:00,2023-08-12,09:28,4,1,5
6,2023-08-12T09:29:00+10:00,2023-08-12,09:29,8,6,14
6,2023-08-12T09:32:00+10:00,2023-08-12,09:32,2,2,4
8,2023-08-12T09:29:00+10:00,2023-08-12,09:29,0,2,2
14,2023-08-12T09:29:00+10:00,2023-08-12,09:29,4,1,5
14,2023-08-12T09:35:00+10:00,2023-08-12,09:35,3,3,6
14,2023-08-12T09:36:00+10:00,2023-08-12,09:36,1,0,1
14,2023-08-12T09:37:00+10:00,2023-08-12,09:37,4,3,7
14,2023-08-12T09:38:00+10:00,2023-08-12,09:38,5,0,5
14,2023-08-12T09:39:00+10:00,2023-08-12,09:39,1,1,2
21,2023-08-12T09:28:00+10:00,2023-08-12,09:28,0,1,1
21,2023-08-12T09:29:00+10:00,2023-08-12,09:29,1,5,6
21,2023-08-12T09:37:00+10:00,2023-08-12,09:37,0,3,3
28,2023-08-12T09:26:00+10:00,2023-08-12,09:26,5,5,10
28,2023-08-12T09:27:00+10:00,2023-08-12,09:27,1,1,2
28,2023-08-12T09:29:00+10:00,2023-08-12,09:29,2,3,5
28,2023-08-12T09:35:00+10:00,2023-08-12,09:35,1,1,2
28,2023-08-12T09:38:00+10:00,2023-08-12,09:38,2,1,3
29,2023-08-12T09:25:00+10:00,2023-08-12,09:25,2,3,5
29,2023-08-12T09:28:00+10:00,2023-08-12,09:28,2,3,5
29,2023-08-12T09:30:00+10:00,2023-08-12,09:30,0,1,1
29,2023-08-12T09:31:00+10:00,2023-08-12,09:31,3,5,8
29,2023-08-12T09:35:00+10:00,2023-08-12,09:35,6,3,9
29,2023-08-12T09:36:00+10:00,2023-08-12,09:36,0,1,1
39,2023-08-12T09:27:00+10:00,2023-08-12,09:27,1,2,3
39,2023-08-12T09:29:00+10:00,2023-08-12,09:29,3,2,5
39,2023-08-12T09:31:00+10:00,2023-08-12,09:31,1,1,2
39,2023-08-12T09:37:00+10:00,2023-08-12,09:37,4,1,5
56,2023-08-12T09:38:00+10:00,2023-08-12,09:38,5,4,9
57,2023-08-12T09:28:00+10:00,2023-08-12,09:28,1,1,2
57,2023-08-12T09:31:00+10:00,2023-08-12,09:31,0,1,1
57,2023-08-12T09:33:00+10:00,2023-08-12,09:33,0,3,3
57,2023-08-12T09:34:00+10:00,2023-08-12,09:34,3,1,4
57,2023-08-12T09:37:00+10:00,2023-08-12,09:37,1,1,2
58,2023-08-12T09:25:00+10:00,2023-08-12,09:25,3,0,3
58,2023-08-12T09:37:00+10:00,2023-08-12,09:37,3,4,7
58,2023-08-12T09:38:00+10:00,2023-08-12,09:38,8,0,8
58,2023-08-12T09:39:00+10:00,2023-08-12,09:39,4,1,5
62,2023-08-12T09:29:00+10:00,2023-08-12,09:29,1,0,1
62,2023-08-12T09:37:00+10:00,2023-08-12,09:37,1,2,3
63,2023-08-12T09:26:00+10:00,2023-08-12,09:26,3,3,6
63,2023-08-12T09:29:00+10:00,2023-08-12,09:29,1,7,8
63,2023-08-12T09:35:00+10:00,2023-08-12,09:35,0,1,1
63,2023-08-12T09:38:00+10:00,2023-08-12,09:38,0,4,4
67,2023-08-12T09:25:00+10:00,2023-08-12,09:25,0,1,1
67,2023-08-12T09:27:00+10:00,2023-08-12,09:27,2,7,9
67,2023-08-12T09:33:00+10:00,2023-08-12,09:33,4,6,10
67,2023-08-12T09:35:00+10:00,2023-08-12,09:35,6,2,8
67,2023-08-12T09:37:00+10:00,2023-08-12,09:37,6,0,6
68,2023-08-12T09:30:00+10:00,2023-08-12,09:30,3,1,4
68,2023-08-12T09:34:00+10:00,2023-08-12,09:34,3,0,3
68,2023-08-12T09:37:00+10:00,2023-08-12,09:37,0,2,2
68,2023-08-12T09:38:00+10:00,2023-08-12,09:38,3,2,5
72,2023-08-12T09:26:00+10:00,2023-08-12,09:26,2,1,3
72,2023-08-12T09:27:00+10:00,2023-08-12,09:27,7,0,7
72,2023-08-12T09:28:00+10:00,2023-08-12,09:28,1,0,1
72,2023-08-12T09:36:00+10:00,2023-08-12,09:36,0,1,1
72,2023-08-12T09:39:00+10:00,2023-08-12,09:39,2,0,2
76,2023-08-12T09:30:00+10:00,2023-08-12,09:30,1,1,2
76,2023-08-12T09:34:00+10:00,2023-08-12,09:34,0,2,2
76,2023-08-12T09:35:00+10:00,2023-08-12,09:35,1,1,2
79,2023-08-12T09:27:00+10:00,2023-08-12,09:27,13,6,19
79,2023-08-12T09:31:00+10:00,2023-08-12,09:31,3,7,10
79,2023-08-12T09:36:00+10:00,2023-08-12,09:36,5,5,10
79,2023-08-12T09:38:00+10:00,2023-08-12,09:38,10,1,11
79,2023-08-12T09:39:00+10:00,2023-08-12,09:39,3,3,6
85,2023-08-12T09:29:00+10:00,2023-08-12,09:29,4,0,4
85,2023-08-12T09:32:00+10:00,2023-08-12,09:32,2,0,2
85,2023-08-12T09:33:00+10:00,2023-08-12,09:33,0,1,1
85,2023-08-12T09:34:00+10:00,2023-08-12,09:34,2,0,2
85,2023-08-12T09:35:00+10:00,2023-08-12,09:35,2,0,2
85,2023-08-12T09:38:00+10:00,2023-08-12,09:38,1,1,2
85,2023-08-12T09:39:00+10:00,2023-08-12,09:39,0,1,1
86,2023-08-12T09:35:00+10:00,2023-08-12,09:35,1,0,1
109,2023-08-12T09:25:00+10:00,2023-08-12,09:25,13,17,30
109,2023-08-12T09:35:00+10:00,2023-08-12,09:35,5,8,13
122,2023-08-12T09:25:00+10:00,2023-08-12,09:25,1,0,1
122,2023-08-12T09:29:00+10:00,2023-08-12,09:29,1,1,2
122,2023-08-12T09:30:00+10:00,2023-08-12,09:30,0,1,1
122,2023-08-12T09:32:00+10:00,2023-08-12,09:32,0,4,4
122,2023-08-12T09:33:00+10:00,2023-08-12,09:33,0,2,2
122,2023-08-12T09:38:00+10:00,2023-08-12,09:38,0,1,1
41,2023-08-12T09:26:00+10:00,2023-08-12,09:26,16,10,26
41,2023-08-12T09:27:00+10:00,2023-08-12,09:27,16,4,20
41,2023-08-12T09:33:00+10:00,2023-08-12,09:33,34,2,36
41,2023-08-12T09:37:00+10:00,2023-08-12,09:37,10,9,19
41,2023-08-12T09:38:00+10:00,2023-08-12,09:38,12,4,16
54,2023-08-12T09:27:00+10:00,2023-08-12,09:27,5,0,5
54,2023-08-12T09:31:00+10:00,2023-08-12,09:31,0,3,3
55,2023-08-12T09:29:00+10:00,2023-08-12,09:29,5,2,7
55,2023-08-12T09:30:00+10:00,2023-08-12,09:30,8,6,14
55,2023-08-12T09:31:00+10:00,2023-08-12,09:31,3,12,15
55,2023-08-12T09:32:00+10:00,2023-08-12,09:32,2,1,3
55,2023-08-12T09:36:00+10:00,2023-08-12,09:36,0,15,15
55,2023-08-12T09:38:00+10:00,2023-08-12,09:38,7,8,15
61,2023-08-12T09:25:00+10:00,2023-08-12,09:25,0,3,3
61,2023-08-12T09:26:00+10:00,2023-08-12,09:26,0,7,7
61,2023-08-12T09:31:00+10:00,2023-08-12,09:31,0,3,3
61,2023-08-12T09:35:00+10:00,2023-08-12,09:35,1,4,5
65,2023-08-12T09:26:00+10:00,2023-08-12,09:26,1,2,3
65,2023-08-12T09:32:00+10:00,2023-08-12,09:32,4,4,8
65,2023-08-12T09:35:00+10:00,2023-08-12,09:35,1,4,5
65,2023-08-12T09:37:00+10:00,2023-08-12,09:37,0,1,1
65,2023-08-12T09:38:00+10:00,2023-08-12,09:38,1,1,2
66,2023-08-12T09:25:00+10:00,2023-08-12,09:25,1,1,2
66,2023-08-12T09:26:00+10:00,2023-08-12,09:26,2,6,8
66,2023-08-12T09:29:00+10:00,2023-08-12,09:29,2,7,9
66,2023-08-12T09:32:00+10:00,2023-08-12,09:32,3,1,4
66,2023-08-12T09:37:00+10:00,2023-08-12,09:37,6,5,11
69,2023-08-12T09:30:00+10:00,2023-08-12,09:30,2,2,4
69,2023-08-12T09:32:00+10:00,2023-08-12,09:32,3,2,5
69,2023-08-12T09:35:00+10:00,2023-08-12,09:35,9,2,11
70,2023-08-12T09:36:00+10:00,2023-08-12,09:36,3,1,4
70,2023-08-12T09:38:00+10:00,2023-08-12,09:38,3,2,5
75,2023-08-12T09:25:00+10:00,2023-08-12,09:25,1,0,1
75,2023-08-12T09:32:00+10:00,2023-08-12,09:32,1,0,1
75,2023-08-12T09:33:00+10:00,2023-08-12,09:33,2,0,2
75,2023-08-12T09:34:00+10:00,2023-08-12,09:34,0,2,2
77,2023-08-12T09:26:00+10:00,2023-08-12,09:26,3,5,8
77,2023-08-12T09:27:00+10:00,2023-08-12,09:27,0,2,2
77,2023-08-12T09:29:00+10:00,2023-08-12,09:29,0,3,3
77,2023-08-12T09:38:00+10:00,2023-08-12,09:38,2,7,9
78,2023-08-12T09:25:00+10:00,2023-08-12,09:25,0,2,2
78,2023-08-12T09:30:00+10:00,2023-08-12,09:30,0,1,1
78,2023-08-12T09:39:00+10:00,2023-08-12,09:39,0,2,2
87,2023-08-12T09:26:00+10:00,2023-08-12,09:26,1,1,2
87,2023-08-12T09:27:00+10:00,2023-08-12,09:27,4,3,7
87,2023-08-12T09:28:00+10:00,2023-08-12,09:28,0,1,1
87,2023-08-12T09:33:00+10:00,2023-08-12,09:33,0,1,1
87,2023-08-12T09:34:00+10:00,2023-08-12,09:34,1,3,4
87,2023-08-12T09:36:00+10:00,2023-08-12,09:36,0,2,2
87,2023-08-12T09:38:00+10:00,2023-08-12,09:38,2,2,4
87,2023-08-12T09:39:00+10:00,2023-08-12,09:39,0,1,1
108,2023-08-12T09:26:00+10:00,2023-08-12,09:26,3,4,7
108,2023-08-12T09:27:00+10:00,2023-08-12,09:27,3,1,4
108,2023-08-12T09:28:00+10:00,2023-08-12,09:28,1,0,1
108,2023-08-12T09:30:00+10:00,2023-08-12,09:30,0,2,2
108,2023-08-12T09:31:00+10:00,2023-08-12,09:31,0,2,2
108,2023-08-12T09:32:00+10:00,2023-08-12,09:32,0,1,1
108,2023-08-12T09:34:00+10:00,2023-08-12,09:34,6,3,9
108,2023-08-12T09:36:00+10:00,2023-08-12,09:36,1,7,8
108,2023-08-12T09:39:00+10:00,2023-08-12,09:39,0,6,6
1,2023-08-12T09:25:00+10:00,2023-08-12,09:25,9,14,23
1,2023-08-12T09:28:00+10:00,2023-08-12,09:28,6,4,10
1,2023-08-12T09:30:00+10:00,2023-08-12,09:30,4,4,8
1,2023-08-12T09:31:00+10:00,2023-08-12,09:31,9,3,12
1,2023-08-12T09:39:00+10:00,2023-08-12,09:39,1,9,10
2,2023-08-12T09:28:00+10:00,2023-08-12,09:28,3,5,8
2,2023-08-12T09:31:00+10:00,2023-08-12,09:31,2,9,11
2,2023-08-12T09:33:00+10:00,2023-08-12,09:33,2,1,3
2,2023-08-12T09:34:00+10:00,2023-08-12,09:34,4,5,9
2,2023-08-12T09:35:00+10:00,2023-08-12,09:35,1,9,10
2,2023-08-12T09:39:00+10:00,2023-08-12,09:39,1,3,4
7,2023-08-12T09:27:00+10:00,2023-08-12,09:27,5,0,5
7,2023-08-12T09:29:00+10:00,2023-08-12,09:29,0,1,1
9,2023-08-12T09:26:00+10:00,2023-08-12,09:26,0,3,3
9,2023-08-12T09:29:00+10:00,2023-08-12,09:29,1,0,1
9,2023-08-12T09:31:00+10:00,2023-08-12,09:31,1,0,1
10,2023-08-12T09:25:00+10:00,2023-08-12,09:25,0,1,1
10,2023-08-12T09:28:00+10:00,2023-08-12,09:28,0,2,2
10,2023-08-12T09:31:00+10:00,2023-08-12,09:31,0,3,3
10,2023-08-12T09:35:00+10:00,2023-08-12,09:35,1,0,1
10,2023-08-12T09:37:00+10:00,2023-08-12,09:37,1,0,1
10,2023-08-12T09:39:00+10:00,2023-08-12,09:39,2,0,2
11,2023-08-12T09:25:00+10:00,2023-08-12,09:25,6,0,6
11,2023-08-12T09:31:00+10:00,2023-08-12,09:31,2,1,3
12,2023-08-12T09:32:00+10:00,2023-08-12,09:32,1,1,2
12,2023-08-12T09:34:00+10:00,2023-08-12,09:34,3,3,6
12,2023-08-12T09:35:00+10:00,2023-08-12,09:35,3,3,6
12,2023-08-12T09:36:00+10:00,2023-08-12,09:36,1,0,1
17,2023-08-12T09:26:00+10:00,2023-08-12,09:26,2,1,3
17,2023-08-12T09:27:00+10:00,2023-08-12,09:27,1,2,3
17,2023-08-12T09:32:00+10:00,2023-08-12,09:32,2,2,4
17,2023-08-12T09:35:00+10:00,2023-08-12,09:35,2,3,5
17,2023-08-12T09:37:00+10:00,2023-08-12,09:37,2,1,3
18,2023-08-12T09:27:00+10:00,2023-08-12,09:27,0,1,1
18,2023-08-12T09:31:00+10:00,2023-08-12,09:31,0,2,2
18,2023-08-12T09:32:00+10:00,2023-08-12,09:32,0,1,1
18,2023-08-12T09:35:00+10:00,2023-08-12,09:35,1,0,1
24,2023-08-12T09:26:00+10:00,2023-08-12,09:26,5,0,5
24,2023-08-12T09:27:00+10:00,2023-08-12,09:27,1,10,11
24,2023-08-12T09:29:00+10:00,2023-08-12,09:29,0,2,2
24,2023-08-12T09:38:00+10:00,2023-08-12,09:38,6,3,9
24,2023-08-12T09:39:00+10:00,2023-08-12,09:39,14,4,18
27,2023-08-12T09:31:00+10:00,2023-08-12,09:31,1,2,3
27,2023-08-12T09:34:00+10:00,2023-08-12,09:34,1,2,3
27,2023-08-12T09:39:00+10:00,2023-08-12,09:39,3,2,5
35,2023-08-12T09:27:00+10:00,2023-08-12,09:27,2,5,7
35,2023-08-12T09:31:00+10:00,2023-08-12,09:31,8,5,13
35,2023-08-12T09:33:00+10:00,2023-08-12,09:33,8,5,13
53,2023-08-12T09:27:00+10:00,2023-08-12,09:27,10,11,21
53,2023-08-12T09:33:00+10:00,2023-08-12,09:33,3,7,10
53,2023-08-12T09:34:00+10:00,2023-08-12,09:34,0,5,5
53,2023-08-12T09:36:00+10:00,2023-08-12,09:36,6,6,12
53,2023-08-12T09:37:00+10:00,2023-08-12,09:37,5,4,9
53,2023-08-12T09:39:00+10:00,2023-08-12,09:39,9,4,13
56,2023-08-12T09:35:00+10:00,2023-08-12,09:35,4,0,4
56,2023-08-12T09:36:00+10:00,2023-08-12,09:36,6,3,9
3,2023-08-12T09:47:00+10:00,2023-08-12,09:47,10,2,12
3,2023-08-12T09:51:00+10:00,2023-08-12,09:51,9,11,20
3,2023-08-12T09:53:00+10:00,2023-08-12,09:53,2,4,6
3,2023-08-12T09:54:00+10:00,2023-08-12,09:54,5,9,14
4,2023-08-12T09:40:00+10:00,2023-08-12,09:40,8,8,16
4,2023-08-12T09:43:00+10:00,2023-08-12,09:43,8,14,22
4,2023-08-12T09:44:00+10:00,2023-08-12,09:44,34,16,50
4,2023-08-12T09:45:00+10:00,2023-08-12,09:45,24,7,31
6,2023-08-12T09:40:00+10:00,2023-08-12,09:40,10,9,19
6,2023-08-12T09:41:00+10:00,2023-08-12,09:41,9,9,18
6,2023-08-12T09:44:00+10:00,2023-08-12,09:44,7,2,9
6,2023-08-12T09:50:00+10:00,2023-08-12,09:50,4,4,8
6,2023-08-12T09:53:00+10:00,2023-08-12,09:53,6,12,18
8,2023-08-12T09:42:00+10:00,2023-08-12,09:42,2,1,3
8,2023-08-12T09:43:00+10:00,2023-08-12,09:43,3,5,8
8,2023-08-12T09:49:00+10:00,2023-08-12,09:49,2,1,3
8,2023-08-12T09:50:00+10:00,2023-08-12,09:50,0,4,4
8,2023-08-12T09:52:00+10:00,2023-08-12,09:52,1,1,2
14,2023-08-12T09:41:00+10:00,2023-08-12,09:41,2,2,4
14,2023-08-12T09:45:00+10:00,2023-08-12,09:45,2,1,3
14,2023-08-12T09:47:00+10:00,2023-08-12,09:47,3,0,3
14,2023-08-12T09:54:00+10:00,2023-08-12,09:54,0,1,1
21,2023-08-12T09:41:00+10:00,2023-08-12,09:41,0,4,4
21,2023-08-12T09:46:00+10:00,2023-08-12,09:46,0,2,2
21,2023-08-12T09:53:00+10:00,2023-08-12,09:53,4,0,4
21,2023-08-12T09:54:00+10:00,2023-08-12,09:54,10,0,10
28,2023-08-12T09:44:00+10:00,2023-08-12,09:44,5,1,6
28,2023-08-12T09:53:00+10:00,2023-08-12,09:53,4,2,6
29,2023-08-12T09:43:00+10:00,2023-08-12,09:43,6,0,6
29,2023-08-12T09:46:00+10:00,2023-08-12,09:46,3,2,5
39,2023-08-12T09:42:00+10:00,2023-08-12,09:42,0,1,1
39,2023-08-12T09:44:00+10:00,2023-08-12,09:44,0,1,1
39,2023-08-12T09:45:00+10:00,2023-08-12,09:45,2,0,2
39,2023-08-12T09:46:00+10:00,2023-08-12,09:46,0,2,2
39,2023-08-12T09:47:00+10:00,2023-08-12,09:47,3,2,5
39,2023-08-12T09:48:00+10:00,2023-08-12,09:48,2,0,2
39,2023-08-12T09:50:00+10:00,2023-08-12,09:50,0,1,1
39,2023-08-12T09:52:00+10:00,2023-08-12,09:52,0,1,1
41,2023-08-12T09:41:00+10:00,2023-08-12,09:41,2,5,7
41,2023-08-12T09:46:00+10:00,2023-08-12,09:46,5,9,14
41,2023-08-12T09:50:00+10:00,2023-08-12,09:50,28,18,46
54,2023-08-12T09:42:00+10:00,2023-08-12,09:42,3,1,4
54,2023-08-12T09:48:00+10:00,2023-08-12,09:48,1,3,4
54,2023-08-12T09:52:00+10:00,2023-08-12,09:52,1,0,1
55,2023-08-12T09:41:00+10:00,2023-08-12,09:41,7,5,12
55,2023-08-12T09:51:00+10:00,2023-08-12,09:51,10,12,22
61,2023-08-12T09:41:00+10:00,2023-08-12,09:41,4,3,7
61,2023-08-12T09:42:00+10:00,2023-08-12,09:42,0,9,9
61,2023-08-12T09:48:00+10:00,2023-08-12,09:48,1,5,6
61,2023-08-12T09:52:00+10:00,2023-08-12,09:52,4,4,8
65,2023-08-12T09:40:00+10:00,2023-08-12,09:40,3,5,8
65,2023-08-12T09:42:00+10:00,2023-08-12,09:42,1,6,7
65,2023-08-12T09:44:00+10:00,2023-08-12,09:44,6,2,8
65,2023-08-12T09:51:00+10:00,2023-08-12,09:51,1,4,5
66,2023-08-12T09:41:00+10:00,2023-08-12,09:41,6,5,11
66,2023-08-12T09:42:00+10:00,2023-08-12,09:42,2,3,5
66,2023-08-12T09:52:00+10:00,2023-08-12,09:52,5,5,10
69,2023-08-12T09:40:00+10:00,2023-08-12,09:40,1,0,1
69,2023-08-12T09:44:00+10:00,2023-08-12,09:44,1,2,3
69,2023-08-12T09:51:00+10:00,2023-08-12,09:51,8,6,14
69,2023-08-12T09:54:00+10:00,2023-08-12,09:54,4,0,4
70,2023-08-12T09:42:00+10:00,2023-08-12,09:42,0,2,2
70,2023-08-12T09:46:00+10:00,2023-08-12,09:46,0,2,2
70,2023-08-12T09:51:00+10:00,2023-08-12,09:51,0,2,2
70,2023-08-12T09:52:00+10:00,2023-08-12,09:52,1,2,3
75,2023-08-12T09:40:00+10:00,2023-08-12,09:40,0,2,2
75,2023-08-12T09:49:00+10:00,2023-08-12,09:49,1,0,1
75,2023-08-12T09:50:00+10:00,2023-08-12,09:50,1,0,1
77,2023-08-12T09:40:00+10:00,2023-08-12,09:40,1,2,3
77,2023-08-12T09:41:00+10:00,2023-08-12,09:41,0,1,1
77,2023-08-12T09:45:00+10:00,2023-08-12,09:45,1,2,3
77,2023-08-12T09:54:00+10:00,2023-08-12,09:54,2,3,5
78,2023-08-12T09:45:00+10:00,2023-08-12,09:45,0,1,1
78,2023-08-12T09:48:00+10:00,2023-08-12,09:48,0,1,1
78,2023-08-12T09:49:00+10:00,2023-08-12,09:49,0,1,1
78,2023-08-12T09:54:00+10:00,2023-08-12,09:54,0,1,1
84,2023-08-12T09:45:00+10:00,2023-08-12,09:45,63,43,106
84,2023-08-12T09:50:00+10:00,2023-08-12,09:50,61,27,88
87,2023-08-12T09:42:00+10:00,2023-08-12,09:42,4,1,5
87,2023-08-12T09:45:00+10:00,2023-08-12,09:45,5,0,5
87,2023-08-12T09:46:00+10:00,2023-08-12,09:46,1,0,1
87,2023-08-12T09:47:00+10:00,2023-08-12,09:47,1,1,2
87,2023-08-12T09:51:00+10:00,2023-08-12,09:51,2,0,2
107,2023-08-12T09:50:00+10:00,2023-08-12,09:50,4,8,12
108,2023-08-12T09:40:00+10:00,2023-08-12,09:40,2,0,2
108,2023-08-12T09:45:00+10:00,2023-08-12,09:45,0,4,4
108,2023-08-12T09:50:00+10:00,2023-08-12,09:50,1,1,2
108,2023-08-12T09:53:00+10:00,2023-08-12,09:53,3,2,5
1,2023-08-12T09:41:00+10:00,2023-08-12,09:41,3,3,6
1,2023-08-12T09:42:00+10:00,2023-08-12,09:42,2,10,12
1,2023-08-12T09:44:00+10:00,2023-08-12,09:44,9,2,11
1,2023-08-12T09:46:00+10:00,2023-08-12,09:46,5,10,15
1,2023-08-12T09:49:00+10:00,2023-08-12,09:49,14,7,21
2,2023-08-12T09:40:00+10:00,2023-08-12,09:40,2,9,11
2,2023-08-12T09:41:00+10:00,2023-08-12,09:41,0,5,5
2,2023-08-12T09:44:00+10:00,2023-08-12,09:44,1,1,2
2,2023-08-12T09:50:00+10:00,2023-08-12,09:50,2,9,11
2,2023-08-12T09:51:00+10:00,2023-08-12,09:51,5,10,15
7,2023-08-12T09:40:00+10:00,2023-08-12,09:40,1,0,1
7,2023-08-12T09:43:00+10:00,2023-08-12,09:43,1,4,5
7,2023-08-12T09:48:00+10:00,2023-08-12,09:48,0,1,1
7,2023-08-12T09:50:00+10:00,2023-08-12,09:50,3,3,6
7,2023-08-12T09:51:00+10:00,2023-08-12,09:51,1,0,1
7,2023-08-12T09:52:00+10:00,2023-08-12,09:52,2,0,2
9,2023-08-12T09:43:00+10:00,2023-08-12,09:43,0,1,1
9,2023-08-12T09:45:00+10:00,2023-08-12,09:45,0,1,1
9,2023-08-12T09:46:00+10:00,2023-08-12,09:46,1,0,1
9,2023-08-12T09:47:00+10:00,2023-08-12,09:47,1,0,1
9,2023-08-12T09:48:00+10:00,2023-08-12,09:48,1,2,3
10,2023-08-12T09:41:00+10:00,2023-08-12,09:41,1,0,1
10,2023-08-12T09:42:00+10:00,2023-08-12,09:42,0,1,1
10,2023-08-12T09:50:00+10:00,2023-08-12,09:50,0,1,1
11,2023-08-12T09:40:00+10:00,2023-08-12,09:40,2,2,4
11,2023-08-12T09:42:00+10:00,2023-08-12,09:42,2,0,2
11,2023-08-12T09:44:00+10:00,2023-08-12,09:44,0,1,1
11,2023-08-12T09:48:00+10:00,2023-08-12,09:48,1,0,1
11,2023-08-12T09:52:00+10:00,2023-08-12,09:52,0,2,2
12,2023-08-12T09:54:00+10:00,2023-08-12,09:54,0,3,3
17,2023-08-12T09:40:00+10:00,2023-08-12,09:40,2,0,2
17,2023-08-12T09:41:00+10:00,2023-08-12,09:41,2,0,2
17,2023-08-12T09:42:00+10:00,2023-08-12,09:42,0,1,1
17,2023-08-12T09:49:00+10:00,2023-08-12,09:49,3,0,3
18,2023-08-12T09:42:00+10:00,2023-08-12,09:42,1,0,1
18,2023-08-12T09:47:00+10:00,2023-08-12,09:47,2,0,2
18,2023-08-12T09:48:00+10:00,2023-08-12,09:48,1,0,1
18,2023-08-12T09:51:00+10:00,2023-08-12,09:51,0,4,4
24,2023-08-12T09:41:00+10:00,2023-08-12,09:41,7,1,8
24,2023-08-12T09:44:00+10:00,2023-08-12,09:44,11,6,17
24,2023-08-12T09:47:00+10:00,2023-08-12,09:47,2,2,4
24,2023-08-12T09:49:00+10:00,2023-08-12,09:49,5,4,9
24,2023-08-12T09:50:00+10:00,2023-08-12,09:50,4,6,10
24,2023-08-12T09:54:00+10:00,2023-08-12,09:54,7,8,15
27,2023-08-12T09:40:00+10:00,2023-08-12,09:40,2,8,10
27,2023-08-12T09:41:00+10:00,2023-08-12,09:41,2,4,6
27,2023-08-12T09:42:00+10:00,2023-08-12,09:42,2,0,2
27,2023-08-12T09:45:00+10:00,2023-08-12,09:45,4,0,4
27,2023-08-12T09:46:00+10:00,2023-08-12,09:46,1,1,2
27,2023-08-12T09:52:00+10:00,2023-08-12,09:52,4,1,5
35,2023-08-12T09:40:00+10:00,2023-08-12,09:40,17,5,22
35,2023-08-12T09:41:00+10:00,2023-08-12,09:41,8,2,10
35,2023-08-12T09:45:00+10:00,2023-08-12,09:45,5,6,11
35,2023-08-12T09:47:00+10:00,2023-08-12,09:47,11,4,15
35,2023-08-12T09:52:00+10:00,2023-08-12,09:52,10,7,17
35,2023-08-12T09:53:00+10:00,2023-08-12,09:53,6,8,14
35,2023-08-12T09:54:00+10:00,2023-08-12,09:54,12,8,20
53,2023-08-12T09:40:00+10:00,2023-08-12,09:40,2,3,5
53,2023-08-12T09:42:00+10:00,2023-08-12,09:42,10,4,14
53,2023-08-12T09:43:00+10:00,2023-08-12,09:43,2,8,10
53,2023-08-12T09:44:00+10:00,2023-08-12,09:44,7,5,12
53,2023-08-12T09:50:00+10:00,2023-08-12,09:50,2,9,11
53,2023-08-12T09:51:00+10:00,2023-08-12,09:51,9,8,17
53,2023-08-12T09:52:00+10:00,2023-08-12,09:52,2,6,8
56,2023-08-12T09:43:00+10:00,2023-08-12,09:43,1,2,3
56,2023-08-12T09:44:00+10:00,2023-08-12,09:44,0,3,3
56,2023-08-12T09:48:00+10:00,2023-08-12,09:48,3,1,4
56,2023-08-12T09:50:00+10:00,2023-08-12,09:50,9,1,10
56,2023-08-12T09:52:00+10:00,2023-08-12,09:52,1,0,1
56,2023-08-12T09:53:00+10:00,2023-08-12,09:53,6,4,10
56,2023-08-12T09:54:00+10:00,2023-08-12,09:54,1,0,1
57,2023-08-12T09:41:00+10:00,2023-08-12,09:41,0,1,1
57,2023-08-12T09:42:00+10:00,2023-08-12,09:42,1,2,3
57,2023-08-12T09:44:00+10:00,2023-08-12,09:44,3,4,7
57,2023-08-12T09:46:00+10:00,2023-08-12,09:46,2,1,3
57,2023-08-12T09:47:00+10:00,2023-08-12,09:47,1,0,1
57,2023-08-12T09:51:00+10:00,2023-08-12,09:51,2,3,5
58,2023-08-12T09:40:00+10:00,2023-08-12,09:40,17,3,20
58,2023-08-12T09:43:00+10:00,2023-08-12,09:43,6,2,8
58,2023-08-12T09:45:00+10:00,2023-08-12,09:45,8,2,10
58,2023-08-12T09:50:00+10:00,2023-08-12,09:50,7,1,8
58,2023-08-12T09:51:00+10:00,2023-08-12,09:51,10,1,11
58,2023-08-12T09:52:00+10:00,2023-08-12,09:52,3,1,4
58,2023-08-12T09:53:00+10:00,2023-08-12,09:53,6,1,7
62,2023-08-12T09:44:00+10:00,2023-08-12,09:44,0,4,4
62,2023-08-12T09:50:00+10:00,2023-08-12,09:50,5,7,12
63,2023-08-12T09:40:00+10:00,2023-08-12,09:40,1,0,1
63,2023-08-12T09:44:00+10:00,2023-08-12,09:44,0,1,1
63,2023-08-12T09:45:00+10:00,2023-08-12,09:45,0,4,4
63,2023-08-12T09:49:00+10:00,2023-08-12,09:49,7,1,8
63,2023-08-12T09:52:00+10:00,2023-08-12,09:52,4,2,6
63,2023-08-12T09:54:00+10:00,2023-08-12,09:54,1,0,1
67,2023-08-12T09:40:00+10:00,2023-08-12,09:40,2,2,4
67,2023-08-12T09:44:00+10:00,2023-08-12,09:44,9,2,11
67,2023-08-12T09:45:00+10:00,2023-08-12,09:45,1,4,5
67,2023-08-12T09:46:00+10:00,2023-08-12,09:46,5,2,7
67,2023-08-12T09:48:00+10:00,2023-08-12,09:48,8,12,20
67,2023-08-12T09:50:00+10:00,2023-08-12,09:50,13,8,21
67,2023-08-12T09:52:00+10:00,2023-08-12,09:52,10,8,18
68,2023-08-12T09:46:00+10:00,2023-08-12,09:46,4,2,6
68,2023-08-12T09:50:00+10:00,2023-08-12,09:50,2,1,3
72,2023-08-12T09:41:00+10:00,2023-08-12,09:41,5,2,7
72,2023-08-12T09:44:00+10:00,2023-08-12,09:44,1,0,1
72,2023-08-12T09:46:00+10:00,2023-08-12,09:46,6,0,6
72,2023-08-12T09:52:00+10:00,2023-08-12,09:52,2,0,2
72,2023-08-12T09:53:00+10:00,2023-08-12,09:53,3,2,5
76,2023-08-12T09:40:00+10:00,2023-08-12,09:40,1,1,2
76,2023-08-12T09:45:00+10:00,2023-08-12,09:45,0,1,1
76,2023-08-12T09:46:00+10:00,2023-08-12,09:46,1,0,1
76,2023-08-12T09:50:00+10:00,2023-08-12,09:50,1,1,2
79,2023-08-12T09:40:00+10:00,2023-08-12,09:40,4,10,14
79,2023-08-12T09:44:00+10:00,2023-08-12,09:44,4,2,6
79,2023-08-12T09:47:00+10:00,2023-08-12,09:47,16,2,18
79,2023-08-12T09:51:00+10:00,2023-08-12,09:51,8,16,24
85,2023-08-12T09:43:00+10:00,2023-08-12,09:43,3,0,3
85,2023-08-12T09:46:00+10:00,2023-08-12,09:46,2,1,3
85,2023-08-12T09:48:00+10:00,2023-08-12,09:48,1,2,3
85,2023-08-12T09:53:00+10:00,2023-08-12,09:53,0,3,3
86,2023-08-12T09:46:00+10:00,2023-08-12,09:46,2,1,3
86,2023-08-12T09:52:00+10:00,2023-08-12,09:52,1,0,1
117,2023-08-12T09:40:00+10:00,2023-08-12,09:40,3,14,17
117,2023-08-12T09:45:00+10:00,2023-08-12,09:45,5,5,10
122,2023-08-12T09:50:00+10:00,2023-08-12,09:50,0,2,2
122,2023-08-12T09:51:00+10:00,2023-08-12,09:51,1,1,2
3,2023-08-12T09:55:00+10:00,2023-08-12,09:55,3,12,15
3,2023-08-12T09:59:00+10:00,2023-08-12,09:59,10,7,17
3,2023-08-12T10:02:00+10:00,2023-08-12,10:02,8,2,10
3,2023-08-12T10:07:00+10:00,2023-08-12,10:07,5,5,10
3,2023-08-12T10:08:00+10:00,2023-08-12,10:08,3,8,11
3,2023-08-12T10:09:00+10:00,2023-08-12,10:09,10,3,13
3,2023-08-12T10:10:00+10:00,2023-08-12,10:10,9,4,13
3,2023-08-12T10:11:00+10:00,2023-08-12,10:11,5,5,10
3,2023-08-12T10:14:00+10:00,2023-08-12,10:14,0,10,10
3,2023-08-12T10:15:00+10:00,2023-08-12,10:15,11,8,19
3,2023-08-12T10:20:00+10:00,2023-08-12,10:20,7,8,15
3,2023-08-12T10:21:00+10:00,2023-08-12,10:21,9,5,14
3,2023-08-12T10:22:00+10:00,2023-08-12,10:22,5,10,15
3,2023-08-12T10:27:00+10:00,2023-08-12,10:27,5,4,9
3,2023-08-12T10:28:00+10:00,2023-08-12,10:28,3,12,15
3,2023-08-12T10:30:00+10:00,2023-08-12,10:30,6,12,18
3,2023-08-12T10:33:00+10:00,2023-08-12,10:33,14,17,31
3,2023-08-12T10:34:00+10:00,2023-08-12,10:34,10,9,19
3,2023-08-12T10:39:00+10:00,2023-08-12,10:39,15,6,21
3,2023-08-12T10:40:00+10:00,2023-08-12,10:40,2,6,8
3,2023-08-12T10:43:00+10:00,2023-08-12,10:43,9,9,18
3,2023-08-12T10:45:00+10:00,2023-08-12,10:45,6,15,21
3,2023-08-12T10:46:00+10:00,2023-08-12,10:46,2,10,12
3,2023-08-12T10:48:00+10:00,2023-08-12,10:48,6,18,24
3,2023-08-12T10:51:00+10:00,2023-08-12,10:51,6,12,18
3,2023-08-12T10:52:00+10:00,2023-08-12,10:52,11,12,23
4,2023-08-12T09:56:00+10:00,2023-08-12,09:56,25,4,29
4,2023-08-12T09:57:00+10:00,2023-08-12,09:57,13,4,17
4,2023-08-12T10:00:00+10:00,2023-08-12,10:00,6,8,14
4,2023-08-12T10:04:00+10:00,2023-08-12,10:04,21,8,29
4,2023-08-12T10:08:00+10:00,2023-08-12,10:08,20,3,23
4,2023-08-12T10:14:00+10:00,2023-08-12,10:14,20,3,23
4,2023-08-12T10:19:00+10:00,2023-08-12,10:19,13,8,21
4,2023-08-12T10:22:00+10:00,2023-08-12,10:22,16,6,22
4,2023-08-12T10:24:00+10:00,2023-08-12,10:24,23,8,31
4,2023-08-12T10:25:00+10:00,2023-08-12,10:25,17,14,31
4,2023-08-12T10:32:00+10:00,2023-08-12,10:32,12,7,19
4,2023-08-12T10:38:00+10:00,2023-08-12,10:38,27,11,38
4,2023-08-12T10:42:00+10:00,2023-08-12,10:42,12,2,14
4,2023-08-12T10:47:00+10:00,2023-08-12,10:47,16,14,30
4,2023-08-12T10:48:00+10:00,2023-08-12,10:48,24,3,27
4,2023-08-12T10:50:00+10:00,2023-08-12,10:50,21,8,29
4,2023-08-12T10:54:00+10:00,2023-08-12,10:54,34,11,45
6,2023-08-12T10:00:00+10:00,2023-08-12,10:00,5,2,7
6,2023-08-12T10:03:00+10:00,2023-08-12,10:03,8,4,12
6,2023-08-12T10:04:00+10:00,2023-08-12,10:04,5,5,10
6,2023-08-12T10:08:00+10:00,2023-08-12,10:08,5,7,12
6,2023-08-12T10:09:00+10:00,2023-08-12,10:09,18,5,23
6,2023-08-12T10:14:00+10:00,2023-08-12,10:14,5,2,7
6,2023-08-12T10:16:00+10:00,2023-08-12,10:16,12,2,14
6,2023-08-12T10:20:00+10:00,2023-08-12,10:20,10,12,22
6,2023-08-12T10:21:00+10:00,2023-08-12,10:21,17,2,19
6,2023-08-12T10:22:00+10:00,2023-08-12,10:22,3,5,8
6,2023-08-12T10:23:00+10:00,2023-08-12,10:23,11,7,18
6,2023-08-12T10:28:00+10:00,2023-08-12,10:28,8,10,18
6,2023-08-12T10:30:00+10:00,2023-08-12,10:30,5,9,14
6,2023-08-12T10:34:00+10:00,2023-08-12,10:34,11,6,17
6,2023-08-12T10:36:00+10:00,2023-08-12,10:36,3,9,12
6,2023-08-12T10:37:00+10:00,2023-08-12,10:37,6,3,9
6,2023-08-12T10:38:00+10:00,2023-08-12,10:38,7,6,13
6,2023-08-12T10:39:00+10:00,2023-08-12,10:39,13,3,16
6,2023-08-12T10:41:00+10:00,2023-08-12,10:41,4,6,10
6,2023-08-12T10:48:00+10:00,2023-08-12,10:48,8,6,14
6,2023-08-12T10:49:00+10:00,2023-08-12,10:49,7,2,9
6,2023-08-12T10:50:00+10:00,2023-08-12,10:50,6,3,9
6,2023-08-12T10:51:00+10:00,2023-08-12,10:51,0,8,8
8,2023-08-12T09:55:00+10:00,2023-08-12,09:55,3,0,3
8,2023-08-12T09:56:00+10:00,2023-08-12,09:56,1,5,6
8,2023-08-12T09:57:00+10:00,2023-08-12,09:57,2,3,5
8,2023-08-12T10:02:00+10:00,2023-08-12,10:02,0,3,3
8,2023-08-12T10:03:00+10:00,2023-08-12,10:03,0,6,6
8,2023-08-12T10:08:00+10:00,2023-08-12,10:08,2,1,3
8,2023-08-12T10:09:00+10:00,2023-08-12,10:09,1,3,4
8,2023-08-12T10:10:00+10:00,2023-08-12,10:10,1,4,5
8,2023-08-12T10:14:00+10:00,2023-08-12,10:14,1,0,1
8,2023-08-12T10:22:00+10:00,2023-08-12,10:22,1,8,9
8,2023-08-12T10:29:00+10:00,2023-08-12,10:29,5,0,5
8,2023-08-12T10:33:00+10:00,2023-08-12,10:33,3,0,3
8,2023-08-12T10:34:00+10:00,2023-08-12,10:34,1,1,2
8,2023-08-12T10:35:00+10:00,2023-08-12,10:35,0,8,8
8,2023-08-12T10:44:00+10:00,2023-08-12,10:44,2,1,3
8,2023-08-12T10:51:00+10:00,2023-08-12,10:51,2,1,3
8,2023-08-12T10:53:00+10:00,2023-08-12,10:53,1,2,3
8,2023-08-12T10:55:00+10:00,2023-08-12,10:55,0,8,8
14,2023-08-12T09:56:00+10:00,2023-08-12,09:56,3,5,8
14,2023-08-12T10:00:00+10:00,2023-08-12,10:00,3,1,4
14,2023-08-12T10:01:00+10:00,2023-08-12,10:01,2,5,7
14,2023-08-12T10:03:00+10:00,2023-08-12,10:03,5,2,7
14,2023-08-12T10:11:00+10:00,2023-08-12,10:11,5,7,12
14,2023-08-12T10:12:00+10:00,2023-08-12,10:12,1,5,6
14,2023-08-12T10:18:00+10:00,2023-08-12,10:18,2,1,3
14,2023-08-12T10:22:00+10:00,2023-08-12,10:22,9,5,14
14,2023-08-12T10:27:00+10:00,2023-08-12,10:27,10,3,13
14,2023-08-12T10:28:00+10:00,2023-08-12,10:28,0,2,2
14,2023-08-12T10:32:00+10:00,2023-08-12,10:32,5,0,5
14,2023-08-12T10:35:00+10:00,2023-08-12,10:35,2,2,4
14,2023-08-12T10:39:00+10:00,2023-08-12,10:39,8,3,11
14,2023-08-12T10:42:00+10:00,2023-08-12,10:42,5,3,8
14,2023-08-12T10:44:00+10:00,2023-08-12,10:44,2,3,5
14,2023-08-12T10:49:00+10:00,2023-08-12,10:49,5,5,10
14,2023-08-12T10:53:00+10:00,2023-08-12,10:53,5,3,8
21,2023-08-12T09:55:00+10:00,2023-08-12,09:55,4,2,6
21,2023-08-12T09:56:00+10:00,2023-08-12,09:56,0,2,2
21,2023-08-12T09:58:00+10:00,2023-08-12,09:58,1,2,3
21,2023-08-12T09:59:00+10:00,2023-08-12,09:59,4,3,7
21,2023-08-12T10:00:00+10:00,2023-08-12,10:00,0,10,10
21,2023-08-12T10:01:00+10:00,2023-08-12,10:01,0,9,9
21,2023-08-12T10:06:00+10:00,2023-08-12,10:06,3,1,4
21,2023-08-12T10:07:00+10:00,2023-08-12,10:07,2,1,3
21,2023-08-12T10:10:00+10:00,2023-08-12,10:10,0,3,3
21,2023-08-12T10:11:00+10:00,2023-08-12,10:11,5,5,10
21,2023-08-12T10:20:00+10:00,2023-08-12,10:20,1,2,3
21,2023-08-12T10:22:00+10:00,2023-08-12,10:22,2,3,5
21,2023-08-12T10:23:00+10:00,2023-08-12,10:23,3,0,3
21,2023-08-12T10:25:00+10:00,2023-08-12,10:25,8,0,8
21,2023-08-12T10:34:00+10:00,2023-08-12,10:34,3,2,5
21,2023-08-12T10:35:00+10:00,2023-08-12,10:35,5,2,7
21,2023-08-12T10:44:00+10:00,2023-08-12,10:44,8,5,13
21,2023-08-12T10:49:00+10:00,2023-08-12,10:49,11,4,15
21,2023-08-12T10:53:00+10:00,2023-08-12,10:53,4,3,7
28,2023-08-12T09:59:00+10:00,2023-08-12,09:59,5,1,6
28,2023-08-12T10:01:00+10:00,2023-08-12,10:01,10,2,12
28,2023-08-12T10:07:00+10:00,2023-08-12,10:07,9,9,18
28,2023-08-12T10:10:00+10:00,2023-08-12,10:10,6,2,8
28,2023-08-12T10:12:00+10:00,2023-08-12,10:12,6,3,9
28,2023-08-12T10:21:00+10:00,2023-08-12,10:21,3,8,11
28,2023-08-12T10:26:00+10:00,2023-08-12,10:26,10,4,14
28,2023-08-12T10:28:00+10:00,2023-08-12,10:28,6,1,7
28,2023-08-12T10:31:00+10:00,2023-08-12,10:31,7,7,14
28,2023-08-12T10:36:00+10:00,2023-08-12,10:36,10,3,13
28,2023-08-12T10:40:00+10:00,2023-08-12,10:40,8,5,13
28,2023-08-12T10:43:00+10:00,2023-08-12,10:43,3,3,6
28,2023-08-12T10:55:00+10:00,2023-08-12,10:55,7,5,12
29,2023-08-12T10:01:00+10:00,2023-08-12,10:01,4,6,10
29,2023-08-12T10:06:00+10:00,2023-08-12,10:06,3,8,11
29,2023-08-12T10:07:00+10:00,2023-08-12,10:07,1,7,8
29,2023-08-12T10:11:00+10:00,2023-08-12,10:11,2,12,14
29,2023-08-12T10:14:00+10:00,2023-08-12,10:14,6,3,9
29,2023-08-12T10:15:00+10:00,2023-08-12,10:15,6,9,15
29,2023-08-12T10:17:00+10:00,2023-08-12,10:17,5,4,9
29,2023-08-12T10:18:00+10:00,2023-08-12,10:18,0,7,7
29,2023-08-12T10:21:00+10:00,2023-08-12,10:21,1,7,8
29,2023-08-12T10:24:00+10:00,2023-08-12,10:24,3,10,13
29,2023-08-12T10:28:00+10:00,2023-08-12,10:28,2,7,9
29,2023-08-12T10:33:00+10:00,2023-08-12,10:33,4,11,15
29,2023-08-12T10:38:00+10:00,2023-08-12,10:38,1,5,6
29,2023-08-12T10:39:00+10:00,2023-08-12,10:39,2,15,17
29,2023-08-12T10:42:00+10:00,2023-08-12,10:42,7,10,17
29,2023-08-12T10:45:00+10:00,2023-08-12,10:45,3,9,12
29,2023-08-12T10:48:00+10:00,2023-08-12,10:48,9,9,18
29,2023-08-12T10:49:00+10:00,2023-08-12,10:49,11,2,13
29,2023-08-12T10:53:00+10:00,2023-08-12,10:53,3,13,16
29,2023-08-12T10:54:00+10:00,2023-08-12,10:54,5,1,6
29,2023-08-12T10:55:00+10:00,2023-08-12,10:55,7,8,15
39,2023-08-12T09:55:00+10:00,2023-08-12,09:55,0,1,1
39,2023-08-12T10:01:00+10:00,2023-08-12,10:01,3,2,5
39,2023-08-12T10:04:00+10:00,2023-08-12,10:04,1,0,1
39,2023-08-12T10:07:00+10:00,2023-08-12,10:07,0,5,5
39,2023-08-12T10:13:00+10:00,2023-08-12,10:13,8,3,11
39,2023-08-12T10:20:00+10:00,2023-08-12,10:20,2,0,2
39,2023-08-12T10:21:00+10:00,2023-08-12,10:21,2,0,2
39,2023-08-12T10:29:00+10:00,2023-08-12,10:29,1,1,2
39,2023-08-12T10:31:00+10:00,2023-08-12,10:31,1,4,5
39,2023-08-12T10:32:00+10:00,2023-08-12,10:32,6,4,10
39,2023-08-12T10:35:00+10:00,2023-08-12,10:35,1,0,1
39,2023-08-12T10:43:00+10:00,2023-08-12,10:43,1,4,5
39,2023-08-12T10:48:00+10:00,2023-08-12,10:48,1,0,1
39,2023-08-12T10:50:00+10:00,2023-08-12,10:50,1,2,3
41,2023-08-12T09:58:00+10:00,2023-08-12,09:58,28,11,39
41,2023-08-12T10:01:00+10:00,2023-08-12,10:01,27,18,45
41,2023-08-12T10:02:00+10:00,2023-08-12,10:02,21,19,40
41,2023-08-12T10:05:00+10:00,2023-08-12,10:05,13,10,23
41,2023-08-12T10:08:00+10:00,2023-08-12,10:08,20,13,33
41,2023-08-12T10:09:00+10:00,2023-08-12,10:09,13,12,25
41,2023-08-12T10:16:00+10:00,2023-08-12,10:16,21,10,31
41,2023-08-12T10:21:00+10:00,2023-08-12,10:21,22,9,31
41,2023-08-12T10:22:00+10:00,2023-08-12,10:22,12,20,32
41,2023-08-12T10:23:00+10:00,2023-08-12,10:23,34,12,46
41,2023-08-12T10:26:00+10:00,2023-08-12,10:26,15,6,21
41,2023-08-12T10:29:00+10:00,2023-08-12,10:29,40,9,49
41,2023-08-12T10:30:00+10:00,2023-08-12,10:30,18,11,29
41,2023-08-12T10:33:00+10:00,2023-08-12,10:33,27,16,43
41,2023-08-12T10:37:00+10:00,2023-08-12,10:37,2,10,12
41,2023-08-12T10:41:00+10:00,2023-08-12,10:41,47,14,61
41,2023-08-12T10:42:00+10:00,2023-08-12,10:42,17,12,29
41,2023-08-12T10:49:00+10:00,2023-08-12,10:49,53,8,61
41,2023-08-12T10:50:00+10:00,2023-08-12,10:50,33,15,48
41,2023-08-12T10:55:00+10:00,2023-08-12,10:55,23,15,38
54,2023-08-12T10:02:00+10:00,2023-08-12,10:02,1,0,1
54,2023-08-12T10:03:00+10:00,2023-08-12,10:03,2,0,2
54,2023-08-12T10:06:00+10:00,2023-08-12,10:06,2,0,2
54,2023-08-12T10:09:00+10:00,2023-08-12,10:09,1,0,1
54,2023-08-12T10:19:00+10:00,2023-08-12,10:19,1,5,6
54,2023-08-12T10:22:00+10:00,2023-08-12,10:22,0,1,1
54,2023-08-12T10:24:00+10:00,2023-08-12,10:24,2,0,2
54,2023-08-12T10:30:00+10:00,2023-08-12,10:30,1,1,2
54,2023-08-12T10:36:00+10:00,2023-08-12,10:36,0,2,2
54,2023-08-12T10:43:00+10:00,2023-08-12,10:43,3,0,3
54,2023-08-12T10:49:00+10:00,2023-08-12,10:49,1,0,1
54,2023-08-12T10:53:00+10:00,2023-08-12,10:53,2,1,3
55,2023-08-12T09:56:00+10:00,2023-08-12,09:56,5,9,14
55,2023-08-12T10:01:00+10:00,2023-08-12,10:01,0,8,8
55,2023-08-12T10:03:00+10:00,2023-08-12,10:03,12,8,20
55,2023-08-12T10:04:00+10:00,2023-08-12,10:04,1,4,5
55,2023-08-12T10:05:00+10:00,2023-08-12,10:05,10,11,21
55,2023-08-12T10:11:00+10:00,2023-08-12,10:11,6,10,16
55,2023-08-12T10:12:00+10:00,2023-08-12,10:12,3,9,12
55,2023-08-12T10:14:00+10:00,2023-08-12,10:14,11,6,17
55,2023-08-12T10:17:00+10:00,2023-08-12,10:17,6,6,12
55,2023-08-12T10:31:00+10:00,2023-08-12,10:31,2,11,13
55,2023-08-12T10:32:00+10:00,2023-08-12,10:32,4,16,20
55,2023-08-12T10:35:00+10:00,2023-08-12,10:35,7,6,13
55,2023-08-12T10:37:00+10:00,2023-08-12,10:37,8,7,15
55,2023-08-12T10:39:00+10:00,2023-08-12,10:39,8,17,25
55,2023-08-12T10:41:00+10:00,2023-08-12,10:41,8,10,18
55,2023-08-12T10:42:00+10:00,2023-08-12,10:42,2,19,21
55,2023-08-12T10:43:00+10:00,2023-08-12,10:43,11,10,21
55,2023-08-12T10:45:00+10:00,2023-08-12,10:45,17,10,27
55,2023-08-12T10:48:00+10:00,2023-08-12,10:48,18,16,34
55,2023-08-12T10:50:00+10:00,2023-08-12,10:50,3,3,6
55,2023-08-12T10:51:00+10:00,2023-08-12,10:51,20,16,36
59,2023-08-12T10:20:00+10:00,2023-08-12,10:20,17,37,54
59,2023-08-12T10:30:00+10:00,2023-08-12,10:30,19,26,45
59,2023-08-12T10:40:00+10:00,2023-08-12,10:40,25,28,53
59,2023-08-12T10:50:00+10:00,2023-08-12,10:50,18,34,52
61,2023-08-12T09:58:00+10:00,2023-08-12,09:58,0,3,3
61,2023-08-12T10:01:00+10:00,2023-08-12,10:01,2,2,4
61,2023-08-12T10:02:00+10:00,2023-08-12,10:02,4,10,14
61,2023-08-12T10:08:00+10:00,2023-08-12,10:08,0,1,1
61,2023-08-12T10:09:00+10:00,2023-08-12,10:09,2,13,15
61,2023-08-12T10:10:00+10:00,2023-08-12,10:10,2,1,3
61,2023-08-12T10:13:00+10:00,2023-08-12,10:13,0,11,11
61,2023-08-12T10:18:00+10:00,2023-08-12,10:18,1,5,6
61,2023-08-12T10:23:00+10:00,2023-08-12,10:23,4,11,15
61,2023-08-12T10:24:00+10:00,2023-08-12,10:24,3,3,6
61,2023-08-12T10:25:00+10:00,2023-08-12,10:25,7,6,13
61,2023-08-12T10:26:00+10:00,2023-08-12,10:26,0,3,3
61,2023-08-12T10:27:00+10:00,2023-08-12,10:27,2,1,3
61,2023-08-12T10:32:00+10:00,2023-08-12,10:32,4,3,7
61,2023-08-12T10:34:00+10:00,2023-08-12,10:34,0,9,9
61,2023-08-12T10:36:00+10:00,2023-08-12,10:36,0,4,4
61,2023-08-12T10:37:00+10:00,2023-08-12,10:37,5,4,9
61,2023-08-12T10:39:00+10:00,2023-08-12,10:39,0,6,6
61,2023-08-12T10:40:00+10:00,2023-08-12,10:40,1,7,8
61,2023-08-12T10:43:00+10:00,2023-08-12,10:43,0,5,5
61,2023-08-12T10:44:00+10:00,2023-08-12,10:44,1,6,7
65,2023-08-12T10:00:00+10:00,2023-08-12,10:00,4,2,6
65,2023-08-12T10:01:00+10:00,2023-08-12,10:01,7,7,14
65,2023-08-12T10:04:00+10:00,2023-08-12,10:04,5,4,9
65,2023-08-12T10:05:00+10:00,2023-08-12,10:05,1,2,3
65,2023-08-12T10:10:00+10:00,2023-08-12,10:10,4,11,15
65,2023-08-12T10:11:00+10:00,2023-08-12,10:11,4,5,9
65,2023-08-12T10:22:00+10:00,2023-08-12,10:22,2,4,6
65,2023-08-12T10:28:00+10:00,2023-08-12,10:28,1,8,9
65,2023-08-12T10:30:00+10:00,2023-08-12,10:30,6,1,7
65,2023-08-12T10:31:00+10:00,2023-08-12,10:31,2,3,5
65,2023-08-12T10:33:00+10:00,2023-08-12,10:33,3,3,6
65,2023-08-12T10:42:00+10:00,2023-08-12,10:42,8,5,13
65,2023-08-12T10:48:00+10:00,2023-08-12,10:48,3,7,10
65,2023-08-12T10:49:00+10:00,2023-08-12,10:49,5,8,13
66,2023-08-12T09:56:00+10:00,2023-08-12,09:56,4,7,11
66,2023-08-12T09:59:00+10:00,2023-08-12,09:59,3,7,10
66,2023-08-12T10:02:00+10:00,2023-08-12,10:02,4,5,9
66,2023-08-12T10:14:00+10:00,2023-08-12,10:14,4,5,9
66,2023-08-12T10:17:00+10:00,2023-08-12,10:17,10,9,19
66,2023-08-12T10:20:00+10:00,2023-08-12,10:20,9,10,19
66,2023-08-12T10:26:00+10:00,2023-08-12,10:26,10,16,26
66,2023-08-12T10:29:00+10:00,2023-08-12,10:29,12,8,20
66,2023-08-12T10:31:00+10:00,2023-08-12,10:31,4,8,12
66,2023-08-12T10:38:00+10:00,2023-08-12,10:38,17,8,25
66,2023-08-12T10:54:00+10:00,2023-08-12,10:54,11,21,32
66,2023-08-12T10:55:00+10:00,2023-08-12,10:55,4,2,6
69,2023-08-12T09:59:00+10:00,2023-08-12,09:59,6,3,9
69,2023-08-12T10:03:00+10:00,2023-08-12,10:03,6,5,11
69,2023-08-12T10:04:00+10:00,2023-08-12,10:04,2,1,3
69,2023-08-12T10:07:00+10:00,2023-08-12,10:07,2,0,2
69,2023-08-12T10:11:00+10:00,2023-08-12,10:11,7,2,9
69,2023-08-12T10:24:00+10:00,2023-08-12,10:24,7,4,11
69,2023-08-12T10:25:00+10:00,2023-08-12,10:25,4,1,5
69,2023-08-12T10:30:00+10:00,2023-08-12,10:30,7,0,7
69,2023-08-12T10:36:00+10:00,2023-08-12,10:36,2,2,4
69,2023-08-12T10:37:00+10:00,2023-08-12,10:37,9,1,10
69,2023-08-12T10:39:00+10:00,2023-08-12,10:39,1,6,7
69,2023-08-12T10:40:00+10:00,2023-08-12,10:40,6,3,9
69,2023-08-12T10:43:00+10:00,2023-08-12,10:43,5,2,7
69,2023-08-12T10:44:00+10:00,2023-08-12,10:44,2,0,2
69,2023-08-12T10:49:00+10:00,2023-08-12,10:49,10,1,11
70,2023-08-12T09:56:00+10:00,2023-08-12,09:56,0,3,3
70,2023-08-12T09:57:00+10:00,2023-08-12,09:57,2,4,6
70,2023-08-12T09:59:00+10:00,2023-08-12,09:59,7,1,8
70,2023-08-12T10:04:00+10:00,2023-08-12,10:04,0,3,3
70,2023-08-12T10:10:00+10:00,2023-08-12,10:10,1,4,5
70,2023-08-12T10:12:00+10:00,2023-08-12,10:12,0,2,2
70,2023-08-12T10:15:00+10:00,2023-08-12,10:15,5,3,8
70,2023-08-12T10:17:00+10:00,2023-08-12,10:17,8,2,10
70,2023-08-12T10:18:00+10:00,2023-08-12,10:18,2,2,4
70,2023-08-12T10:19:00+10:00,2023-08-12,10:19,0,2,2
70,2023-08-12T10:26:00+10:00,2023-08-12,10:26,0,1,1
70,2023-08-12T10:29:00+10:00,2023-08-12,10:29,4,2,6
70,2023-08-12T10:30:00+10:00,2023-08-12,10:30,3,3,6
70,2023-08-12T10:32:00+10:00,2023-08-12,10:32,4,0,4
70,2023-08-12T10:35:00+10:00,2023-08-12,10:35,3,9,12
70,2023-08-12T10:38:00+10:00,2023-08-12,10:38,0,3,3
70,2023-08-12T10:39:00+10:00,2023-08-12,10:39,1,1,2
70,2023-08-12T10:40:00+10:00,2023-08-12,10:40,5,7,12
70,2023-08-12T10:46:00+10:00,2023-08-12,10:46,3,2,5
70,2023-08-12T10:49:00+10:00,2023-08-12,10:49,0,2,2
70,2023-08-12T10:50:00+10:00,2023-08-12,10:50,0,3,3
70,2023-08-12T10:52:00+10:00,2023-08-12,10:52,2,2,4
70,2023-08-12T10:55:00+10:00,2023-08-12,10:55,5,5,10
71,2023-08-12T10:25:00+10:00,2023-08-12,10:25,0,1,1
71,2023-08-12T10:28:00+10:00,2023-08-12,10:28,1,0,1
71,2023-08-12T10:44:00+10:00,2023-08-12,10:44,0,3,3
71,2023-08-12T10:46:00+10:00,2023-08-12,10:46,0,1,1
75,2023-08-12T10:02:00+10:00,2023-08-12,10:02,1,0,1
75,2023-08-12T10:03:00+10:00,2023-08-12,10:03,0,1,1
75,2023-08-12T10:07:00+10:00,2023-08-12,10:07,1,0,1
75,2023-08-12T10:16:00+10:00,2023-08-12,10:16,0,1,1
75,2023-08-12T10:17:00+10:00,2023-08-12,10:17,1,0,1
75,2023-08-12T10:18:00+10:00,2023-08-12,10:18,2,0,2
75,2023-08-12T10:41:00+10:00,2023-08-12,10:41,2,0,2
75,2023-08-12T10:49:00+10:00,2023-08-12,10:49,2,0,2
77,2023-08-12T09:55:00+10:00,2023-08-12,09:55,5,0,5
77,2023-08-12T09:58:00+10:00,2023-08-12,09:58,1,0,1
77,2023-08-12T10:01:00+10:00,2023-08-12,10:01,2,3,5
77,2023-08-12T10:05:00+10:00,2023-08-12,10:05,0,5,5
77,2023-08-12T10:21:00+10:00,2023-08-12,10:21,4,0,4
77,2023-08-12T10:23:00+10:00,2023-08-12,10:23,0,2,2
77,2023-08-12T10:26:00+10:00,2023-08-12,10:26,2,3,5
77,2023-08-12T10:33:00+10:00,2023-08-12,10:33,0,2,2
77,2023-08-12T10:36:00+10:00,2023-08-12,10:36,1,1,2
77,2023-08-12T10:37:00+10:00,2023-08-12,10:37,1,4,5
77,2023-08-12T10:44:00+10:00,2023-08-12,10:44,4,3,7
77,2023-08-12T10:48:00+10:00,2023-08-12,10:48,2,1,3
77,2023-08-12T10:49:00+10:00,2023-08-12,10:49,0,2,2
78,2023-08-12T09:58:00+10:00,2023-08-12,09:58,0,4,4
78,2023-08-12T10:04:00+10:00,2023-08-12,10:04,5,0,5
78,2023-08-12T10:05:00+10:00,2023-08-12,10:05,0,3,3
78,2023-08-12T10:07:00+10:00,2023-08-12,10:07,0,1,1
78,2023-08-12T10:13:00+10:00,2023-08-12,10:13,1,1,2
78,2023-08-12T10:14:00+10:00,2023-08-12,10:14,0,2,2
78,2023-08-12T10:17:00+10:00,2023-08-12,10:17,0,1,1
78,2023-08-12T10:20:00+10:00,2023-08-12,10:20,0,2,2
78,2023-08-12T10:26:00+10:00,2023-08-12,10:26,0,1,1
78,2023-08-12T10:28:00+10:00,2023-08-12,10:28,4,0,4
78,2023-08-12T10:29:00+10:00,2023-08-12,10:29,1,0,1
78,2023-08-12T10:52:00+10:00,2023-08-12,10:52,0,1,1
78,2023-08-12T10:53:00+10:00,2023-08-12,10:53,2,1,3
78,2023-08-12T10:54:00+10:00,2023-08-12,10:54,0,2,2
84,2023-08-12T10:10:00+10:00,2023-08-12,10:10,67,42,109
84,2023-08-12T10:20:00+10:00,2023-08-12,10:20,72,30,102
84,2023-08-12T10:30:00+10:00,2023-08-12,10:30,65,52,117
84,2023-08-12T10:35:00+10:00,2023-08-12,10:35,60,49,109
87,2023-08-12T09:56:00+10:00,2023-08-12,09:56,0,4,4
87,2023-08-12T09:59:00+10:00,2023-08-12,09:59,1,4,5
87,2023-08-12T10:06:00+10:00,2023-08-12,10:06,2,2,4
87,2023-08-12T10:09:00+10:00,2023-08-12,10:09,1,1,2
87,2023-08-12T10:10:00+10:00,2023-08-12,10:10,4,2,6
87,2023-08-12T10:13:00+10:00,2023-08-12,10:13,0,2,2
87,2023-08-12T10:16:00+10:00,2023-08-12,10:16,1,1,2
87,2023-08-12T10:20:00+10:00,2023-08-12,10:20,3,2,5
87,2023-08-12T10:21:00+10:00,2023-08-12,10:21,1,2,3
87,2023-08-12T10:23:00+10:00,2023-08-12,10:23,3,1,4
87,2023-08-12T10:24:00+10:00,2023-08-12,10:24,4,1,5
87,2023-08-12T10:26:00+10:00,2023-08-12,10:26,5,1,6
87,2023-08-12T10:28:00+10:00,2023-08-12,10:28,4,1,5
87,2023-08-12T10:29:00+10:00,2023-08-12,10:29,1,2,3
87,2023-08-12T10:32:00+10:00,2023-08-12,10:32,1,0,1
87,2023-08-12T10:34:00+10:00,2023-08-12,10:34,5,1,6
87,2023-08-12T10:35:00+10:00,2023-08-12,10:35,0,2,2
87,2023-08-12T10:36:00+10:00,2023-08-12,10:36,2,0,2
87,2023-08-12T10:45:00+10:00,2023-08-12,10:45,2,3,5
87,2023-08-12T10:48:00+10:00,2023-08-12,10:48,2,1,3
87,2023-08-12T10:50:00+10:00,2023-08-12,10:50,1,2,3
87,2023-08-12T10:51:00+10:00,2023-08-12,10:51,5,0,5
87,2023-08-12T10:52:00+10:00,2023-08-12,10:52,1,3,4
107,2023-08-12T09:55:00+10:00,2023-08-12,09:55,15,11,26
107,2023-08-12T10:05:00+10:00,2023-08-12,10:05,4,14,18
107,2023-08-12T10:10:00+10:00,2023-08-12,10:10,3,1,4
107,2023-08-12T10:20:00+10:00,2023-08-12,10:20,7,5,12
107,2023-08-12T10:45:00+10:00,2023-08-12,10:45,3,7,10
107,2023-08-12T10:55:00+10:00,2023-08-12,10:55,14,7,21
108,2023-08-12T09:56:00+10:00,2023-08-12,09:56,4,6,10
108,2023-08-12T09:59:00+10:00,2023-08-12,09:59,2,1,3
108,2023-08-12T10:00:00+10:00,2023-08-12,10:00,0,1,1
108,2023-08-12T10:01:00+10:00,2023-08-12,10:01,7,4,11
108,2023-08-12T10:02:00+10:00,2023-08-12,10:02,1,1,2
108,2023-08-12T10:06:00+10:00,2023-08-12,10:06,1,3,4
108,2023-08-12T10:08:00+10:00,2023-08-12,10:08,3,0,3
108,2023-08-12T10:16:00+10:00,2023-08-12,10:16,0,3,3
108,2023-08-12T10:21:00+10:00,2023-08-12,10:21,3,3,6
108,2023-08-12T10:22:00+10:00,2023-08-12,10:22,0,4,4
108,2023-08-12T10:24:00+10:00,2023-08-12,10:24,0,2,2
108,2023-08-12T10:31:00+10:00,2023-08-12,10:31,3,0,3
108,2023-08-12T10:32:00+10:00,2023-08-12,10:32,2,1,3
108,2023-08-12T10:34:00+10:00,2023-08-12,10:34,2,1,3
108,2023-08-12T10:38:00+10:00,2023-08-12,10:38,2,5,7
108,2023-08-12T10:40:00+10:00,2023-08-12,10:40,2,1,3
108,2023-08-12T10:43:00+10:00,2023-08-12,10:43,2,9,11
108,2023-08-12T10:48:00+10:00,2023-08-12,10:48,1,0,1
108,2023-08-12T10:51:00+10:00,2023-08-12,10:51,1,4,5
118,2023-08-12T09:55:00+10:00,2023-08-12,09:55,0,1,1
118,2023-08-12T10:35:00+10:00,2023-08-12,10:35,0,4,4
1,2023-08-12T09:56:00+10:00,2023-08-12,09:56,6,10,16
1,2023-08-12T09:58:00+10:00,2023-08-12,09:58,3,6,9
1,2023-08-12T10:00:00+10:00,2023-08-12,10:00,5,11,16
1,2023-08-12T10:04:00+10:00,2023-08-12,10:04,6,0,6
1,2023-08-12T10:05:00+10:00,2023-08-12,10:05,6,12,18
1,2023-08-12T10:15:00+10:00,2023-08-12,10:15,9,6,15
1,2023-08-12T10:19:00+10:00,2023-08-12,10:19,4,14,18
1,2023-08-12T10:20:00+10:00,2023-08-12,10:20,8,13,21
1,2023-08-12T10:21:00+10:00,2023-08-12,10:21,6,5,11
1,2023-08-12T10:23:00+10:00,2023-08-12,10:23,3,7,10
1,2023-08-12T10:26:00+10:00,2023-08-12,10:26,12,1,13
1,2023-08-12T10:32:00+10:00,2023-08-12,10:32,16,11,27
1,2023-08-12T10:33:00+10:00,2023-08-12,10:33,3,14,17
1,2023-08-12T10:40:00+10:00,2023-08-12,10:40,14,20,34
1,2023-08-12T10:41:00+10:00,2023-08-12,10:41,16,13,29
1,2023-08-12T10:44:00+10:00,2023-08-12,10:44,13,23,36
1,2023-08-12T10:45:00+10:00,2023-08-12,10:45,10,13,23
1,2023-08-12T10:49:00+10:00,2023-08-12,10:49,11,11,22
1,2023-08-12T10:53:00+10:00,2023-08-12,10:53,9,9,18
2,2023-08-12T09:56:00+10:00,2023-08-12,09:56,7,12,19
2,2023-08-12T09:57:00+10:00,2023-08-12,09:57,2,9,11
2,2023-08-12T09:58:00+10:00,2023-08-12,09:58,16,14,30
2,2023-08-12T10:00:00+10:00,2023-08-12,10:00,1,6,7
2,2023-08-12T10:05:00+10:00,2023-08-12,10:05,4,9,13
2,2023-08-12T10:06:00+10:00,2023-08-12,10:06,0,3,3
2,2023-08-12T10:08:00+10:00,2023-08-12,10:08,1,6,7
2,2023-08-12T10:15:00+10:00,2023-08-12,10:15,7,13,20
2,2023-08-12T10:16:00+10:00,2023-08-12,10:16,6,4,10
2,2023-08-12T10:18:00+10:00,2023-08-12,10:18,9,10,19
2,2023-08-12T10:22:00+10:00,2023-08-12,10:22,4,5,9
2,2023-08-12T10:24:00+10:00,2023-08-12,10:24,4,8,12
2,2023-08-12T10:34:00+10:00,2023-08-12,10:34,5,7,12
2,2023-08-12T10:41:00+10:00,2023-08-12,10:41,8,1,9
2,2023-08-12T10:44:00+10:00,2023-08-12,10:44,4,8,12
2,2023-08-12T10:46:00+10:00,2023-08-12,10:46,4,8,12
2,2023-08-12T10:48:00+10:00,2023-08-12,10:48,8,6,14
2,2023-08-12T10:50:00+10:00,2023-08-12,10:50,3,3,6
2,2023-08-12T10:51:00+10:00,2023-08-12,10:51,6,4,10
2,2023-08-12T10:52:00+10:00,2023-08-12,10:52,6,5,11
2,2023-08-12T10:53:00+10:00,2023-08-12,10:53,8,10,18
2,2023-08-12T10:54:00+10:00,2023-08-12,10:54,3,23,26
2,2023-08-12T10:55:00+10:00,2023-08-12,10:55,6,9,15
7,2023-08-12T09:55:00+10:00,2023-08-12,09:55,1,0,1
7,2023-08-12T10:03:00+10:00,2023-08-12,10:03,0,1,1
7,2023-08-12T10:06:00+10:00,2023-08-12,10:06,0,2,2
7,2023-08-12T10:08:00+10:00,2023-08-12,10:08,0,1,1
7,2023-08-12T10:20:00+10:00,2023-08-12,10:20,1,2,3
7,2023-08-12T10:25:00+10:00,2023-08-12,10:25,1,0,1
7,2023-08-12T10:29:00+10:00,2023-08-12,10:29,1,2,3
7,2023-08-12T10:31:00+10:00,2023-08-12,10:31,0,2,2
7,2023-08-12T10:33:00+10:00,2023-08-12,10:33,2,0,2
7,2023-08-12T10:36:00+10:00,2023-08-12,10:36,4,0,4
7,2023-08-12T10:40:00+10:00,2023-08-12,10:40,0,2,2
7,2023-08-12T10:41:00+10:00,2023-08-12,10:41,0,2,2
7,2023-08-12T10:42:00+10:00,2023-08-12,10:42,0,3,3
7,2023-08-12T10:43:00+10:00,2023-08-12,10:43,0,3,3
7,2023-08-12T10:44:00+10:00,2023-08-12,10:44,1,0,1
7,2023-08-12T10:46:00+10:00,2023-08-12,10:46,3,1,4
7,2023-08-12T10:53:00+10:00,2023-08-12,10:53,1,0,1
7,2023-08-12T10:54:00+10:00,2023-08-12,10:54,0,1,1
9,2023-08-12T09:56:00+10:00,2023-08-12,09:56,1,0,1
9,2023-08-12T09:57:00+10:00,2023-08-12,09:57,2,0,2
9,2023-08-12T10:07:00+10:00,2023-08-12,10:07,0,1,1
9,2023-08-12T10:15:00+10:00,2023-08-12,10:15,1,0,1
9,2023-08-12T10:17:00+10:00,2023-08-12,10:17,0,2,2
9,2023-08-12T10:23:00+10:00,2023-08-12,10:23,0,2,2
9,2023-08-12T10:37:00+10:00,2023-08-12,10:37,10,3,13
9,2023-08-12T10:38:00+10:00,2023-08-12,10:38,0,2,2
9,2023-08-12T10:41:00+10:00,2023-08-12,10:41,2,1,3
9,2023-08-12T10:42:00+10:00,2023-08-12,10:42,0,2,2
9,2023-08-12T10:44:00+10:00,2023-08-12,10:44,1,3,4
9,2023-08-12T10:45:00+10:00,2023-08-12,10:45,2,2,4
9,2023-08-12T10:51:00+10:00,2023-08-12,10:51,2,2,4
9,2023-08-12T10:53:00+10:00,2023-08-12,10:53,1,1,2
10,2023-08-12T09:58:00+10:00,2023-08-12,09:58,1,2,3
10,2023-08-12T10:01:00+10:00,2023-08-12,10:01,1,0,1
10,2023-08-12T10:02:00+10:00,2023-08-12,10:02,2,0,2
10,2023-08-12T10:03:00+10:00,2023-08-12,10:03,1,0,1
10,2023-08-12T10:06:00+10:00,2023-08-12,10:06,1,1,2
10,2023-08-12T10:09:00+10:00,2023-08-12,10:09,0,2,2
10,2023-08-12T10:10:00+10:00,2023-08-12,10:10,1,1,2
10,2023-08-12T10:15:00+10:00,2023-08-12,10:15,0,1,1
10,2023-08-12T10:23:00+10:00,2023-08-12,10:23,0,2,2
10,2023-08-12T10:25:00+10:00,2023-08-12,10:25,2,0,2
10,2023-08-12T10:26:00+10:00,2023-08-12,10:26,1,0,1
10,2023-08-12T10:33:00+10:00,2023-08-12,10:33,0,1,1
10,2023-08-12T10:34:00+10:00,2023-08-12,10:34,1,2,3
10,2023-08-12T10:46:00+10:00,2023-08-12,10:46,3,1,4
10,2023-08-12T10:50:00+10:00,2023-08-12,10:50,0,3,3
10,2023-08-12T10:51:00+10:00,2023-08-12,10:51,1,2,3
10,2023-08-12T10:54:00+10:00,2023-08-12,10:54,5,0,5
10,2023-08-12T10:55:00+10:00,2023-08-12,10:55,12,0,12
11,2023-08-12T09:57:00+10:00,2023-08-12,09:57,0,2,2
11,2023-08-12T09:59:00+10:00,2023-08-12,09:59,0,1,1
11,2023-08-12T10:12:00+10:00,2023-08-12,10:12,0,2,2
11,2023-08-12T10:13:00+10:00,2023-08-12,10:13,0,1,1
11,2023-08-12T10:14:00+10:00,2023-08-12,10:14,1,1,2
11,2023-08-12T10:16:00+10:00,2023-08-12,10:16,1,0,1
11,2023-08-12T10:24:00+10:00,2023-08-12,10:24,1,0,1
11,2023-08-12T10:25:00+10:00,2023-08-12,10:25,10,3,13
11,2023-08-12T10:47:00+10:00,2023-08-12,10:47,2,0,2
11,2023-08-12T10:50:00+10:00,2023-08-12,10:50,4,5,9
12,2023-08-12T09:59:00+10:00,2023-08-12,09:59,3,0,3
12,2023-08-12T10:00:00+10:00,2023-08-12,10:00,3,0,3
12,2023-08-12T10:05:00+10:00,2023-08-12,10:05,2,1,3
12,2023-08-12T10:08:00+10:00,2023-08-12,10:08,0,3,3
12,2023-08-12T10:11:00+10:00,2023-08-12,10:11,0,3,3
12,2023-08-12T10:18:00+10:00,2023-08-12,10:18,2,5,7
12,2023-08-12T10:20:00+10:00,2023-08-12,10:20,3,1,4
12,2023-08-12T10:21:00+10:00,2023-08-12,10:21,3,1,4
12,2023-08-12T10:24:00+10:00,2023-08-12,10:24,1,0,1
12,2023-08-12T10:25:00+10:00,2023-08-12,10:25,0,1,1
12,2023-08-12T10:29:00+10:00,2023-08-12,10:29,1,0,1
12,2023-08-12T10:30:00+10:00,2023-08-12,10:30,0,2,2
12,2023-08-12T10:31:00+10:00,2023-08-12,10:31,2,2,4
12,2023-08-12T10:33:00+10:00,2023-08-12,10:33,2,1,3
12,2023-08-12T10:36:00+10:00,2023-08-12,10:36,14,3,17
12,2023-08-12T10:37:00+10:00,2023-08-12,10:37,5,0,5
12,2023-08-12T10:38:00+10:00,2023-08-12,10:38,2,5,7
12,2023-08-12T10:39:00+10:00,2023-08-12,10:39,2,2,4
12,2023-08-12T10:40:00+10:00,2023-08-12,10:40,2,0,2
12,2023-08-12T10:41:00+10:00,2023-08-12,10:41,1,1,2
12,2023-08-12T10:44:00+10:00,2023-08-12,10:44,2,0,2
12,2023-08-12T10:54:00+10:00,2023-08-12,10:54,1,3,4
17,2023-08-12T09:56:00+10:00,2023-08-12,09:56,4,6,10
17,2023-08-12T09:57:00+10:00,2023-08-12,09:57,1,0,1
17,2023-08-12T09:59:00+10:00,2023-08-12,09:59,6,1,7
17,2023-08-12T10:01:00+10:00,2023-08-12,10:01,4,0,4
17,2023-08-12T10:02:00+10:00,2023-08-12,10:02,2,0,2
17,2023-08-12T10:03:00+10:00,2023-08-12,10:03,1,1,2
17,2023-08-12T10:09:00+10:00,2023-08-12,10:09,4,0,4
17,2023-08-12T10:12:00+10:00,2023-08-12,10:12,3,3,6
17,2023-08-12T10:13:00+10:00,2023-08-12,10:13,7,3,10
17,2023-08-12T10:22:00+10:00,2023-08-12,10:22,4,0,4
17,2023-08-12T10:27:00+10:00,2023-08-12,10:27,3,1,4
17,2023-08-12T10:30:00+10:00,2023-08-12,10:30,1,0,1
17,2023-08-12T10:39:00+10:00,2023-08-12,10:39,0,4,4
17,2023-08-12T10:40:00+10:00,2023-08-12,10:40,2,0,2
17,2023-08-12T10:54:00+10:00,2023-08-12,10:54,7,7,14
18,2023-08-12T09:55:00+10:00,2023-08-12,09:55,0,2,2
18,2023-08-12T10:06:00+10:00,2023-08-12,10:06,2,0,2
18,2023-08-12T10:10:00+10:00,2023-08-12,10:10,1,0,1
18,2023-08-12T10:12:00+10:00,2023-08-12,10:12,3,0,3
18,2023-08-12T10:18:00+10:00,2023-08-12,10:18,1,1,2
18,2023-08-12T10:19:00+10:00,2023-08-12,10:19,1,0,1
18,2023-08-12T10:24:00+10:00,2023-08-12,10:24,1,2,3
18,2023-08-12T10:25:00+10:00,2023-08-12,10:25,0,2,2
18,2023-08-12T10:32:00+10:00,2023-08-12,10:32,0,2,2
18,2023-08-12T10:36:00+10:00,2023-08-12,10:36,2,0,2
18,2023-08-12T10:41:00+10:00,2023-08-12,10:41,2,1,3
18,2023-08-12T10:44:00+10:00,2023-08-12,10:44,0,3,3
18,2023-08-12T10:55:00+10:00,2023-08-12,10:55,10,0,10
24,2023-08-12T09:57:00+10:00,2023-08-12,09:57,7,6,13
24,2023-08-12T10:02:00+10:00,2023-08-12,10:02,11,0,11
24,2023-08-12T10:03:00+10:00,2023-08-12,10:03,0,11,11
24,2023-08-12T10:05:00+10:00,2023-08-12,10:05,3,1,4
24,2023-08-12T10:06:00+10:00,2023-08-12,10:06,15,1,16
24,2023-08-12T10:10:00+10:00,2023-08-12,10:10,1,1,2
24,2023-08-12T10:13:00+10:00,2023-08-12,10:13,6,3,9
24,2023-08-12T10:14:00+10:00,2023-08-12,10:14,12,9,21
24,2023-08-12T10:17:00+10:00,2023-08-12,10:17,16,3,19
24,2023-08-12T10:20:00+10:00,2023-08-12,10:20,4,0,4
24,2023-08-12T10:24:00+10:00,2023-08-12,10:24,17,3,20
24,2023-08-12T10:25:00+10:00,2023-08-12,10:25,4,5,9
24,2023-08-12T10:30:00+10:00,2023-08-12,10:30,2,6,8
24,2023-08-12T10:32:00+10:00,2023-08-12,10:32,7,2,9
24,2023-08-12T10:36:00+10:00,2023-08-12,10:36,7,7,14
24,2023-08-12T10:38:00+10:00,2023-08-12,10:38,0,5,5
24,2023-08-12T10:41:00+10:00,2023-08-12,10:41,7,0,7
24,2023-08-12T10:42:00+10:00,2023-08-12,10:42,13,4,17
24,2023-08-12T10:46:00+10:00,2023-08-12,10:46,1,4,5
27,2023-08-12T09:56:00+10:00,2023-08-12,09:56,2,3,5
27,2023-08-12T09:59:00+10:00,2023-08-12,09:59,5,2,7
27,2023-08-12T10:02:00+10:00,2023-08-12,10:02,4,3,7
27,2023-08-12T10:05:00+10:00,2023-08-12,10:05,3,1,4
27,2023-08-12T10:16:00+10:00,2023-08-12,10:16,0,4,4
27,2023-08-12T10:18:00+10:00,2023-08-12,10:18,6,1,7
27,2023-08-12T10:35:00+10:00,2023-08-12,10:35,1,5,6
27,2023-08-12T10:36:00+10:00,2023-08-12,10:36,12,4,16
27,2023-08-12T10:38:00+10:00,2023-08-12,10:38,0,11,11
27,2023-08-12T10:40:00+10:00,2023-08-12,10:40,5,5,10
27,2023-08-12T10:44:00+10:00,2023-08-12,10:44,1,4,5
27,2023-08-12T10:46:00+10:00,2023-08-12,10:46,6,3,9
27,2023-08-12T10:47:00+10:00,2023-08-12,10:47,4,8,12
27,2023-08-12T10:48:00+10:00,2023-08-12,10:48,1,3,4
27,2023-08-12T10:49:00+10:00,2023-08-12,10:49,3,6,9
27,2023-08-12T10:53:00+10:00,2023-08-12,10:53,2,2,4
35,2023-08-12T09:58:00+10:00,2023-08-12,09:58,5,6,11
35,2023-08-12T10:00:00+10:00,2023-08-12,10:00,9,9,18
35,2023-08-12T10:01:00+10:00,2023-08-12,10:01,13,4,17
35,2023-08-12T10:05:00+10:00,2023-08-12,10:05,3,5,8
35,2023-08-12T10:06:00+10:00,2023-08-12,10:06,5,4,9
35,2023-08-12T10:07:00+10:00,2023-08-12,10:07,6,11,17
35,2023-08-12T10:11:00+10:00,2023-08-12,10:11,9,2,11
35,2023-08-12T10:17:00+10:00,2023-08-12,10:17,9,7,16
35,2023-08-12T10:21:00+10:00,2023-08-12,10:21,5,9,14
35,2023-08-12T10:22:00+10:00,2023-08-12,10:22,5,7,12
35,2023-08-12T10:34:00+10:00,2023-08-12,10:34,8,3,11
35,2023-08-12T10:40:00+10:00,2023-08-12,10:40,6,4,10
35,2023-08-12T10:41:00+10:00,2023-08-12,10:41,11,8,19
35,2023-08-12T10:43:00+10:00,2023-08-12,10:43,8,6,14
35,2023-08-12T10:47:00+10:00,2023-08-12,10:47,9,7,16
35,2023-08-12T10:48:00+10:00,2023-08-12,10:48,11,9,20
35,2023-08-12T10:53:00+10:00,2023-08-12,10:53,10,10,20
35,2023-08-12T10:54:00+10:00,2023-08-12,10:54,10,4,14
35,2023-08-12T10:55:00+10:00,2023-08-12,10:55,18,19,37
53,2023-08-12T09:56:00+10:00,2023-08-12,09:56,3,5,8
53,2023-08-12T09:57:00+10:00,2023-08-12,09:57,6,1,7
53,2023-08-12T09:58:00+10:00,2023-08-12,09:58,10,7,17
53,2023-08-12T10:02:00+10:00,2023-08-12,10:02,3,5,8
53,2023-08-12T10:04:00+10:00,2023-08-12,10:04,10,6,16
53,2023-08-12T10:09:00+10:00,2023-08-12,10:09,7,5,12
53,2023-08-12T10:14:00+10:00,2023-08-12,10:14,12,0,12
53,2023-08-12T10:15:00+10:00,2023-08-12,10:15,12,7,19
53,2023-08-12T10:16:00+10:00,2023-08-12,10:16,7,2,9
53,2023-08-12T10:17:00+10:00,2023-08-12,10:17,7,7,14
53,2023-08-12T10:21:00+10:00,2023-08-12,10:21,7,2,9
53,2023-08-12T10:22:00+10:00,2023-08-12,10:22,7,3,10
53,2023-08-12T10:24:00+10:00,2023-08-12,10:24,2,6,8
53,2023-08-12T10:26:00+10:00,2023-08-12,10:26,8,7,15
53,2023-08-12T10:27:00+10:00,2023-08-12,10:27,13,7,20
53,2023-08-12T10:29:00+10:00,2023-08-12,10:29,17,5,22
53,2023-08-12T10:31:00+10:00,2023-08-12,10:31,1,6,7
53,2023-08-12T10:33:00+10:00,2023-08-12,10:33,7,6,13
53,2023-08-12T10:34:00+10:00,2023-08-12,10:34,3,4,7
53,2023-08-12T10:36:00+10:00,2023-08-12,10:36,6,7,13
53,2023-08-12T10:40:00+10:00,2023-08-12,10:40,12,7,19
53,2023-08-12T10:45:00+10:00,2023-08-12,10:45,5,7,12
53,2023-08-12T10:46:00+10:00,2023-08-12,10:46,11,12,23
53,2023-08-12T10:47:00+10:00,2023-08-12,10:47,6,4,10
53,2023-08-12T10:49:00+10:00,2023-08-12,10:49,7,4,11
53,2023-08-12T10:51:00+10:00,2023-08-12,10:51,7,4,11
53,2023-08-12T10:52:00+10:00,2023-08-12,10:52,8,9,17
53,2023-08-12T10:55:00+10:00,2023-08-12,10:55,9,10,19
56,2023-08-12T09:55:00+10:00,2023-08-12,09:55,15,2,17
56,2023-08-12T09:56:00+10:00,2023-08-12,09:56,0,2,2
56,2023-08-12T09:58:00+10:00,2023-08-12,09:58,4,0,4
56,2023-08-12T09:59:00+10:00,2023-08-12,09:59,3,2,5
56,2023-08-12T10:00:00+10:00,2023-08-12,10:00,3,0,3
56,2023-08-12T10:07:00+10:00,2023-08-12,10:07,6,0,6
56,2023-08-12T10:09:00+10:00,2023-08-12,10:09,5,5,10
56,2023-08-12T10:14:00+10:00,2023-08-12,10:14,4,0,4
56,2023-08-12T10:15:00+10:00,2023-08-12,10:15,11,0,11
56,2023-08-12T10:17:00+10:00,2023-08-12,10:17,7,0,7
56,2023-08-12T10:18:00+10:00,2023-08-12,10:18,3,1,4
56,2023-08-12T10:23:00+10:00,2023-08-12,10:23,2,1,3
56,2023-08-12T10:24:00+10:00,2023-08-12,10:24,3,1,4
56,2023-08-12T10:27:00+10:00,2023-08-12,10:27,3,7,10
56,2023-08-12T10:30:00+10:00,2023-08-12,10:30,4,1,5
56,2023-08-12T10:32:00+10:00,2023-08-12,10:32,5,2,7
56,2023-08-12T10:35:00+10:00,2023-08-12,10:35,11,2,13
56,2023-08-12T10:42:00+10:00,2023-08-12,10:42,0,3,3
56,2023-08-12T10:43:00+10:00,2023-08-12,10:43,1,2,3
56,2023-08-12T10:45:00+10:00,2023-08-12,10:45,3,1,4
56,2023-08-12T10:46:00+10:00,2023-08-12,10:46,4,4,8
56,2023-08-12T10:48:00+10:00,2023-08-12,10:48,2,7,9
57,2023-08-12T10:03:00+10:00,2023-08-12,10:03,2,2,4
57,2023-08-12T10:07:00+10:00,2023-08-12,10:07,2,1,3
57,2023-08-12T10:13:00+10:00,2023-08-12,10:13,1,1,2
57,2023-08-12T10:20:00+10:00,2023-08-12,10:20,5,4,9
57,2023-08-12T10:21:00+10:00,2023-08-12,10:21,9,2,11
57,2023-08-12T10:24:00+10:00,2023-08-12,10:24,8,0,8
57,2023-08-12T10:31:00+10:00,2023-08-12,10:31,2,3,5
57,2023-08-12T10:36:00+10:00,2023-08-12,10:36,2,4,6
57,2023-08-12T10:39:00+10:00,2023-08-12,10:39,5,5,10
57,2023-08-12T10:40:00+10:00,2023-08-12,10:40,8,5,13
57,2023-08-12T10:42:00+10:00,2023-08-12,10:42,3,6,9
57,2023-08-12T10:45:00+10:00,2023-08-12,10:45,1,3,4
57,2023-08-12T10:54:00+10:00,2023-08-12,10:54,2,3,5
57,2023-08-12T10:55:00+10:00,2023-08-12,10:55,1,2,3
58,2023-08-12T09:57:00+10:00,2023-08-12,09:57,4,4,8
58,2023-08-12T09:58:00+10:00,2023-08-12,09:58,10,8,18
58,2023-08-12T09:59:00+10:00,2023-08-12,09:59,7,2,9
58,2023-08-12T10:00:00+10:00,2023-08-12,10:00,4,5,9
58,2023-08-12T10:08:00+10:00,2023-08-12,10:08,7,10,17
58,2023-08-12T10:09:00+10:00,2023-08-12,10:09,8,3,11
58,2023-08-12T10:10:00+10:00,2023-08-12,10:10,6,3,9
58,2023-08-12T10:13:00+10:00,2023-08-12,10:13,13,0,13
58,2023-08-12T10:15:00+10:00,2023-08-12,10:15,10,2,12
58,2023-08-12T10:20:00+10:00,2023-08-12,10:20,4,3,7
58,2023-08-12T10:25:00+10:00,2023-08-12,10:25,6,21,27
58,2023-08-12T10:26:00+10:00,2023-08-12,10:26,9,1,10
58,2023-08-12T10:27:00+10:00,2023-08-12,10:27,5,3,8
58,2023-08-12T10:34:00+10:00,2023-08-12,10:34,9,4,13
58,2023-08-12T10:36:00+10:00,2023-08-12,10:36,14,1,15
58,2023-08-12T10:38:00+10:00,2023-08-12,10:38,11,3,14
58,2023-08-12T10:42:00+10:00,2023-08-12,10:42,19,4,23
58,2023-08-12T10:45:00+10:00,2023-08-12,10:45,12,2,14
58,2023-08-12T10:48:00+10:00,2023-08-12,10:48,10,0,10
58,2023-08-12T10:52:00+10:00,2023-08-12,10:52,18,2,20
58,2023-08-12T10:55:00+10:00,2023-08-12,10:55,8,3,11
62,2023-08-12T09:55:00+10:00,2023-08-12,09:55,3,4,7
62,2023-08-12T09:57:00+10:00,2023-08-12,09:57,3,3,6
62,2023-08-12T10:01:00+10:00,2023-08-12,10:01,1,1,2
62,2023-08-12T10:05:00+10:00,2023-08-12,10:05,1,0,1
62,2023-08-12T10:06:00+10:00,2023-08-12,10:06,4,2,6
62,2023-08-12T10:12:00+10:00,2023-08-12,10:12,3,2,5
62,2023-08-12T10:13:00+10:00,2023-08-12,10:13,3,1,4
62,2023-08-12T10:22:00+10:00,2023-08-12,10:22,3,3,6
62,2023-08-12T10:25:00+10:00,2023-08-12,10:25,3,5,8
62,2023-08-12T10:27:00+10:00,2023-08-12,10:27,8,2,10
62,2023-08-12T10:32:00+10:00,2023-08-12,10:32,7,2,9
62,2023-08-12T10:33:00+10:00,2023-08-12,10:33,3,0,3
62,2023-08-12T10:35:00+10:00,2023-08-12,10:35,2,0,2
62,2023-08-12T10:38:00+10:00,2023-08-12,10:38,0,2,2
62,2023-08-12T10:41:00+10:00,2023-08-12,10:41,1,1,2
62,2023-08-12T10:42:00+10:00,2023-08-12,10:42,0,2,2
62,2023-08-12T10:43:00+10:00,2023-08-12,10:43,7,5,12
62,2023-08-12T10:44:00+10:00,2023-08-12,10:44,3,3,6
63,2023-08-12T09:57:00+10:00,2023-08-12,09:57,1,3,4
63,2023-08-12T10:05:00+10:00,2023-08-12,10:05,0,8,8
63,2023-08-12T10:06:00+10:00,2023-08-12,10:06,0,7,7
63,2023-08-12T10:09:00+10:00,2023-08-12,10:09,1,2,3
63,2023-08-12T10:10:00+10:00,2023-08-12,10:10,6,3,9
63,2023-08-12T10:11:00+10:00,2023-08-12,10:11,3,5,8
63,2023-08-12T10:13:00+10:00,2023-08-12,10:13,1,2,3
63,2023-08-12T10:19:00+10:00,2023-08-12,10:19,1,4,5
63,2023-08-12T10:23:00+10:00,2023-08-12,10:23,0,2,2
63,2023-08-12T10:25:00+10:00,2023-08-12,10:25,5,3,8
63,2023-08-12T10:26:00+10:00,2023-08-12,10:26,13,5,18
63,2023-08-12T10:27:00+10:00,2023-08-12,10:27,1,5,6
63,2023-08-12T10:31:00+10:00,2023-08-12,10:31,1,6,7
63,2023-08-12T10:33:00+10:00,2023-08-12,10:33,2,4,6
63,2023-08-12T10:34:00+10:00,2023-08-12,10:34,1,11,12
63,2023-08-12T10:35:00+10:00,2023-08-12,10:35,6,9,15
63,2023-08-12T10:37:00+10:00,2023-08-12,10:37,1,4,5
63,2023-08-12T10:38:00+10:00,2023-08-12,10:38,8,2,10
63,2023-08-12T10:45:00+10:00,2023-08-12,10:45,3,6,9
63,2023-08-12T10:46:00+10:00,2023-08-12,10:46,1,0,1
63,2023-08-12T10:47:00+10:00,2023-08-12,10:47,2,2,4
63,2023-08-12T10:48:00+10:00,2023-08-12,10:48,5,2,7
63,2023-08-12T10:54:00+10:00,2023-08-12,10:54,3,3,6
67,2023-08-12T09:55:00+10:00,2023-08-12,09:55,6,4,10
67,2023-08-12T09:59:00+10:00,2023-08-12,09:59,8,12,20
67,2023-08-12T10:00:00+10:00,2023-08-12,10:00,3,2,5
67,2023-08-12T10:04:00+10:00,2023-08-12,10:04,0,7,7
67,2023-08-12T10:11:00+10:00,2023-08-12,10:11,10,2,12
67,2023-08-12T10:16:00+10:00,2023-08-12,10:16,4,2,6
67,2023-08-12T10:19:00+10:00,2023-08-12,10:19,5,13,18
67,2023-08-12T10:20:00+10:00,2023-08-12,10:20,7,4,11
67,2023-08-12T10:23:00+10:00,2023-08-12,10:23,8,7,15
67,2023-08-12T10:25:00+10:00,2023-08-12,10:25,4,5,9
67,2023-08-12T10:27:00+10:00,2023-08-12,10:27,4,6,10
67,2023-08-12T10:29:00+10:00,2023-08-12,10:29,2,7,9
67,2023-08-12T10:33:00+10:00,2023-08-12,10:33,5,8,13
67,2023-08-12T10:40:00+10:00,2023-08-12,10:40,6,8,14
67,2023-08-12T10:44:00+10:00,2023-08-12,10:44,2,15,17
68,2023-08-12T09:56:00+10:00,2023-08-12,09:56,2,1,3
68,2023-08-12T09:59:00+10:00,2023-08-12,09:59,3,5,8
68,2023-08-12T10:01:00+10:00,2023-08-12,10:01,2,0,2
68,2023-08-12T10:04:00+10:00,2023-08-12,10:04,3,1,4
68,2023-08-12T10:05:00+10:00,2023-08-12,10:05,4,1,5
68,2023-08-12T10:06:00+10:00,2023-08-12,10:06,2,2,4
68,2023-08-12T10:09:00+10:00,2023-08-12,10:09,1,3,4
68,2023-08-12T10:10:00+10:00,2023-08-12,10:10,4,3,7
68,2023-08-12T10:12:00+10:00,2023-08-12,10:12,1,0,1
68,2023-08-12T10:13:00+10:00,2023-08-12,10:13,2,1,3
68,2023-08-12T10:14:00+10:00,2023-08-12,10:14,1,1,2
68,2023-08-12T10:19:00+10:00,2023-08-12,10:19,1,3,4
68,2023-08-12T10:20:00+10:00,2023-08-12,10:20,7,4,11
68,2023-08-12T10:23:00+10:00,2023-08-12,10:23,2,4,6
68,2023-08-12T10:30:00+10:00,2023-08-12,10:30,5,2,7
68,2023-08-12T10:31:00+10:00,2023-08-12,10:31,2,2,4
68,2023-08-12T10:33:00+10:00,2023-08-12,10:33,5,2,7
68,2023-08-12T10:36:00+10:00,2023-08-12,10:36,2,3,5
68,2023-08-12T10:37:00+10:00,2023-08-12,10:37,4,1,5
68,2023-08-12T10:38:00+10:00,2023-08-12,10:38,2,1,3
68,2023-08-12T10:39:00+10:00,2023-08-12,10:39,2,1,3
68,2023-08-12T10:44:00+10:00,2023-08-12,10:44,0,1,1
68,2023-08-12T10:49:00+10:00,2023-08-12,10:49,1,2,3
68,2023-08-12T10:53:00+10:00,2023-08-12,10:53,0,5,5
68,2023-08-12T10:55:00+10:00,2023-08-12,10:55,2,0,2
72,2023-08-12T09:55:00+10:00,2023-08-12,09:55,0,11,11
72,2023-08-12T09:57:00+10:00,2023-08-12,09:57,4,8,12
72,2023-08-12T10:03:00+10:00,2023-08-12,10:03,3,9,12
72,2023-08-12T10:14:00+10:00,2023-08-12,10:14,1,1,2
72,2023-08-12T10:19:00+10:00,2023-08-12,10:19,12,0,12
72,2023-08-12T10:20:00+10:00,2023-08-12,10:20,9,4,13
72,2023-08-12T10:21:00+10:00,2023-08-12,10:21,8,0,8
72,2023-08-12T10:25:00+10:00,2023-08-12,10:25,8,0,8
72,2023-08-12T10:28:00+10:00,2023-08-12,10:28,3,0,3
72,2023-08-12T10:30:00+10:00,2023-08-12,10:30,6,2,8
72,2023-08-12T10:35:00+10:00,2023-08-12,10:35,4,7,11
72,2023-08-12T10:36:00+10:00,2023-08-12,10:36,7,3,10
72,2023-08-12T10:41:00+10:00,2023-08-12,10:41,8,11,19
72,2023-08-12T10:49:00+10:00,2023-08-12,10:49,3,6,9
76,2023-08-12T09:56:00+10:00,2023-08-12,09:56,1,1,2
76,2023-08-12T09:59:00+10:00,2023-08-12,09:59,0,1,1
76,2023-08-12T10:01:00+10:00,2023-08-12,10:01,4,0,4
76,2023-08-12T10:05:00+10:00,2023-08-12,10:05,0,3,3
76,2023-08-12T10:06:00+10:00,2023-08-12,10:06,3,4,7
76,2023-08-12T10:07:00+10:00,2023-08-12,10:07,0,2,2
76,2023-08-12T10:11:00+10:00,2023-08-12,10:11,7,1,8
76,2023-08-12T10:12:00+10:00,2023-08-12,10:12,1,0,1
76,2023-08-12T10:17:00+10:00,2023-08-12,10:17,2,0,2
76,2023-08-12T10:24:00+10:00,2023-08-12,10:24,0,3,3
76,2023-08-12T10:25:00+10:00,2023-08-12,10:25,2,3,5
76,2023-08-12T10:26:00+10:00,2023-08-12,10:26,5,0,5
76,2023-08-12T10:40:00+10:00,2023-08-12,10:40,2,0,2
76,2023-08-12T10:43:00+10:00,2023-08-12,10:43,0,2,2
76,2023-08-12T10:44:00+10:00,2023-08-12,10:44,3,0,3
76,2023-08-12T10:46:00+10:00,2023-08-12,10:46,0,5,5
76,2023-08-12T10:49:00+10:00,2023-08-12,10:49,0,4,4
76,2023-08-12T10:54:00+10:00,2023-08-12,10:54,5,1,6
76,2023-08-12T10:55:00+10:00,2023-08-12,10:55,1,1,2
79,2023-08-12T09:58:00+10:00,2023-08-12,09:58,17,3,20
79,2023-08-12T10:02:00+10:00,2023-08-12,10:02,8,4,12
79,2023-08-12T10:04:00+10:00,2023-08-12,10:04,2,7,9
79,2023-08-12T10:06:00+10:00,2023-08-12,10:06,5,9,14
79,2023-08-12T10:11:00+10:00,2023-08-12,10:11,5,5,10
79,2023-08-12T10:14:00+10:00,2023-08-12,10:14,2,1,3
79,2023-08-12T10:18:00+10:00,2023-08-12,10:18,10,5,15
79,2023-08-12T10:25:00+10:00,2023-08-12,10:25,1,2,3
79,2023-08-12T10:26:00+10:00,2023-08-12,10:26,7,2,9
79,2023-08-12T10:28:00+10:00,2023-08-12,10:28,3,15,18
79,2023-08-12T10:30:00+10:00,2023-08-12,10:30,8,8,16
79,2023-08-12T10:32:00+10:00,2023-08-12,10:32,3,5,8
79,2023-08-12T10:34:00+10:00,2023-08-12,10:34,14,6,20
79,2023-08-12T10:35:00+10:00,2023-08-12,10:35,5,8,13
79,2023-08-12T10:37:00+10:00,2023-08-12,10:37,19,13,32
79,2023-08-12T10:38:00+10:00,2023-08-12,10:38,16,3,19
79,2023-08-12T10:39:00+10:00,2023-08-12,10:39,23,5,28
79,2023-08-12T10:43:00+10:00,2023-08-12,10:43,5,12,17
79,2023-08-12T10:47:00+10:00,2023-08-12,10:47,13,6,19
85,2023-08-12T09:56:00+10:00,2023-08-12,09:56,1,0,1
85,2023-08-12T10:00:00+10:00,2023-08-12,10:00,1,0,1
85,2023-08-12T10:03:00+10:00,2023-08-12,10:03,0,4,4
85,2023-08-12T10:10:00+10:00,2023-08-12,10:10,0,2,2
85,2023-08-12T10:12:00+10:00,2023-08-12,10:12,0,1,1
85,2023-08-12T10:14:00+10:00,2023-08-12,10:14,3,2,5
85,2023-08-12T10:18:00+10:00,2023-08-12,10:18,5,2,7
85,2023-08-12T10:20:00+10:00,2023-08-12,10:20,3,2,5
85,2023-08-12T10:29:00+10:00,2023-08-12,10:29,2,4,6
85,2023-08-12T10:31:00+10:00,2023-08-12,10:31,2,2,4
85,2023-08-12T10:32:00+10:00,2023-08-12,10:32,0,1,1
85,2023-08-12T10:34:00+10:00,2023-08-12,10:34,1,2,3
85,2023-08-12T10:36:00+10:00,2023-08-12,10:36,7,1,8
85,2023-08-12T10:38:00+10:00,2023-08-12,10:38,2,2,4
85,2023-08-12T10:41:00+10:00,2023-08-12,10:41,6,2,8
85,2023-08-12T10:46:00+10:00,2023-08-12,10:46,0,4,4
85,2023-08-12T10:48:00+10:00,2023-08-12,10:48,2,0,2
85,2023-08-12T10:50:00+10:00,2023-08-12,10:50,2,3,5
85,2023-08-12T10:53:00+10:00,2023-08-12,10:53,5,4,9
85,2023-08-12T10:55:00+10:00,2023-08-12,10:55,1,4,5
86,2023-08-12T10:02:00+10:00,2023-08-12,10:02,1,1,2
86,2023-08-12T10:05:00+10:00,2023-08-12,10:05,1,0,1
86,2023-08-12T10:08:00+10:00,2023-08-12,10:08,1,1,2
86,2023-08-12T10:09:00+10:00,2023-08-12,10:09,1,0,1
86,2023-08-12T10:16:00+10:00,2023-08-12,10:16,7,1,8
86,2023-08-12T10:18:00+10:00,2023-08-12,10:18,2,0,2
86,2023-08-12T10:25:00+10:00,2023-08-12,10:25,1,1,2
86,2023-08-12T10:28:00+10:00,2023-08-12,10:28,1,0,1
86,2023-08-12T10:30:00+10:00,2023-08-12,10:30,3,0,3
86,2023-08-12T10:31:00+10:00,2023-08-12,10:31,3,1,4
86,2023-08-12T10:32:00+10:00,2023-08-12,10:32,1,0,1
86,2023-08-12T10:36:00+10:00,2023-08-12,10:36,0,2,2
86,2023-08-12T10:41:00+10:00,2023-08-12,10:41,1,0,1
86,2023-08-12T10:43:00+10:00,2023-08-12,10:43,2,1,3
86,2023-08-12T10:53:00+10:00,2023-08-12,10:53,0,2,2
109,2023-08-12T10:15:00+10:00,2023-08-12,10:15,6,15,21
109,2023-08-12T10:20:00+10:00,2023-08-12,10:20,6,27,33
109,2023-08-12T10:30:00+10:00,2023-08-12,10:30,6,11,17
109,2023-08-12T10:35:00+10:00,2023-08-12,10:35,1,17,18
109,2023-08-12T10:55:00+10:00,2023-08-12,10:55,8,7,15
117,2023-08-12T09:55:00+10:00,2023-08-12,09:55,8,17,25
117,2023-08-12T10:10:00+10:00,2023-08-12,10:10,2,18,20
117,2023-08-12T10:35:00+10:00,2023-08-12,10:35,5,35,40
117,2023-08-12T10:40:00+10:00,2023-08-12,10:40,6,11,17
117,2023-08-12T10:45:00+10:00,2023-08-12,10:45,7,21,28
117,2023-08-12T10:50:00+10:00,2023-08-12,10:50,27,15,42
122,2023-08-12T10:03:00+10:00,2023-08-12,10:03,0,3,3
122,2023-08-12T10:06:00+10:00,2023-08-12,10:06,1,0,1
122,2023-08-12T10:08:00+10:00,2023-08-12,10:08,1,0,1
122,2023-08-12T10:12:00+10:00,2023-08-12,10:12,1,0,1
122,2023-08-12T10:15:00+10:00,2023-08-12,10:15,9,1,10
122,2023-08-12T10:16:00+10:00,2023-08-12,10:16,0,1,1
122,2023-08-12T10:22:00+10:00,2023-08-12,10:22,5,0,5
122,2023-08-12T10:34:00+10:00,2023-08-12,10:34,0,3,3
122,2023-08-12T10:43:00+10:00,2023-08-12,10:43,1,0,1
122,2023-08-12T10:47:00+10:00,2023-08-12,10:47,3,1,4
122,2023-08-12T10:49:00+10:00,2023-08-12,10:49,0,1,1
122,2023-08-12T10:50:00+10:00,2023-08-12,10:50,0,1,1
122,2023-08-12T10:52:00+10:00,2023-08-12,10:52,2,1,3
122,2023-08-12T10:55:00+10:00,2023-08-12,10:55,2,0,2
3,2023-08-12T03:42:00+10:00,2023-08-12,03:42,5,3,8
3,2023-08-12T03:43:00+10:00,2023-08-12,03:43,0,3,3
3,2023-08-12T03:44:00+10:00,2023-08-12,03:44,1,0,1
3,2023-08-12T03:50:00+10:00,2023-08-12,03:50,1,2,3
4,2023-08-12T03:44:00+10:00,2023-08-12,03:44,1,4,5
4,2023-08-12T03:46:00+10:00,2023-08-12,03:46,0,4,4
4,2023-08-12T03:49:00+10:00,2023-08-12,03:49,1,2,3
4,2023-08-12T03:52:00+10:00,2023-08-12,03:52,4,0,4
4,2023-08-12T03:54:00+10:00,2023-08-12,03:54,0,1,1
6,2023-08-12T03:44:00+10:00,2023-08-12,03:44,1,5,6
6,2023-08-12T03:49:00+10:00,2023-08-12,03:49,0,1,1
14,2023-08-12T03:47:00+10:00,2023-08-12,03:47,1,0,1
14,2023-08-12T03:48:00+10:00,2023-08-12,03:48,6,0,6
14,2023-08-12T03:52:00+10:00,2023-08-12,03:52,11,0,11
21,2023-08-12T03:40:00+10:00,2023-08-12,03:40,6,2,8
21,2023-08-12T03:44:00+10:00,2023-08-12,03:44,2,1,3
21,2023-08-12T03:45:00+10:00,2023-08-12,03:45,3,3,6
41,2023-08-12T03:40:00+10:00,2023-08-12,03:40,3,3,6
41,2023-08-12T03:42:00+10:00,2023-08-12,03:42,0,2,2
41,2023-08-12T03:49:00+10:00,2023-08-12,03:49,1,3,4
41,2023-08-12T03:50:00+10:00,2023-08-12,03:50,2,7,9
41,2023-08-12T03:51:00+10:00,2023-08-12,03:51,2,4,6
41,2023-08-12T03:53:00+10:00,2023-08-12,03:53,0,3,3
41,2023-08-12T03:54:00+10:00,2023-08-12,03:54,2,3,5
54,2023-08-12T03:44:00+10:00,2023-08-12,03:44,1,0,1
54,2023-08-12T03:45:00+10:00,2023-08-12,03:45,2,0,2
55,2023-08-12T03:44:00+10:00,2023-08-12,03:44,2,1,3
55,2023-08-12T03:48:00+10:00,2023-08-12,03:48,3,1,4
55,2023-08-12T03:49:00+10:00,2023-08-12,03:49,2,0,2
55,2023-08-12T03:53:00+10:00,2023-08-12,03:53,2,1,3
55,2023-08-12T03:54:00+10:00,2023-08-12,03:54,4,1,5
61,2023-08-12T03:47:00+10:00,2023-08-12,03:47,0,2,2
65,2023-08-12T03:43:00+10:00,2023-08-12,03:43,0,4,4
65,2023-08-12T03:46:00+10:00,2023-08-12,03:46,1,4,5
65,2023-08-12T03:47:00+10:00,2023-08-12,03:47,0,1,1
84,2023-08-12T03:45:00+10:00,2023-08-12,03:45,3,7,10
107,2023-08-12T03:40:00+10:00,2023-08-12,03:40,2,0,2
108,2023-08-12T03:45:00+10:00,2023-08-12,03:45,1,0,1
1,2023-08-12T03:40:00+10:00,2023-08-12,03:40,1,0,1
1,2023-08-12T03:47:00+10:00,2023-08-12,03:47,5,0,5
2,2023-08-12T03:48:00+10:00,2023-08-12,03:48,0,1,1
11,2023-08-12T03:45:00+10:00,2023-08-12,03:45,1,0,1
24,2023-08-12T03:42:00+10:00,2023-08-12,03:42,1,0,1
24,2023-08-12T03:45:00+10:00,2023-08-12,03:45,0,2,2
24,2023-08-12T03:46:00+10:00,2023-08-12,03:46,1,2,3
24,2023-08-12T03:50:00+10:00,2023-08-12,03:50,1,1,2
24,2023-08-12T03:54:00+10:00,2023-08-12,03:54,0,6,6
35,2023-08-12T03:40:00+10:00,2023-08-12,03:40,6,3,9
35,2023-08-12T03:46:00+10:00,2023-08-12,03:46,2,5,7
53,2023-08-12T03:47:00+10:00,2023-08-12,03:47,1,0,1
56,2023-08-12T03:46:00+10:00,2023-08-12,03:46,2,1,3
58,2023-08-12T03:47:00+10:00,2023-08-12,03:47,0,1,1
58,2023-08-12T03:50:00+10:00,2023-08-12,03:50,0,1,1
62,2023-08-12T03:43:00+10:00,2023-08-12,03:43,0,1,1
62,2023-08-12T03:48:00+10:00,2023-08-12,03:48,0,1,1
62,2023-08-12T03:49:00+10:00,2023-08-12,03:49,0,2,2
62,2023-08-12T03:51:00+10:00,2023-08-12,03:51,1,1,2
63,2023-08-12T03:42:00+10:00,2023-08-12,03:42,2,0,2
63,2023-08-12T03:50:00+10:00,2023-08-12,03:50,0,1,1
72,2023-08-12T03:46:00+10:00,2023-08-12,03:46,0,2,2
79,2023-08-12T03:41:00+10:00,2023-08-12,03:41,2,1,3
79,2023-08-12T03:52:00+10:00,2023-08-12,03:52,1,4,5
85,2023-08-12T03:54:00+10:00,2023-08-12,03:54,1,0,1
109,2023-08-12T03:40:00+10:00,2023-08-12,03:40,0,2,2
3,2023-08-12T03:27:00+10:00,2023-08-12,03:27,3,0,3
3,2023-08-12T03:28:00+10:00,2023-08-12,03:28,4,0,4
3,2023-08-12T03:30:00+10:00,2023-08-12,03:30,6,2,8
3,2023-08-12T03:32:00+10:00,2023-08-12,03:32,2,2,4
3,2023-08-12T03:34:00+10:00,2023-08-12,03:34,0,4,4
3,2023-08-12T03:37:00+10:00,2023-08-12,03:37,3,1,4
4,2023-08-12T03:25:00+10:00,2023-08-12,03:25,0,8,8
4,2023-08-12T03:26:00+10:00,2023-08-12,03:26,2,2,4
4,2023-08-12T03:27:00+10:00,2023-08-12,03:27,0,3,3
4,2023-08-12T03:29:00+10:00,2023-08-12,03:29,1,2,3
4,2023-08-12T03:33:00+10:00,2023-08-12,03:33,0,5,5
4,2023-08-12T03:38:00+10:00,2023-08-12,03:38,2,1,3
4,2023-08-12T03:39:00+10:00,2023-08-12,03:39,1,0,1
6,2023-08-12T03:27:00+10:00,2023-08-12,03:27,5,3,8
6,2023-08-12T03:28:00+10:00,2023-08-12,03:28,0,1,1
6,2023-08-12T03:34:00+10:00,2023-08-12,03:34,0,1,1
6,2023-08-12T03:35:00+10:00,2023-08-12,03:35,2,0,2
6,2023-08-12T03:38:00+10:00,2023-08-12,03:38,3,0,3
6,2023-08-12T03:39:00+10:00,2023-08-12,03:39,1,0,1
8,2023-08-12T03:27:00+10:00,2023-08-12,03:27,1,1,2
14,2023-08-12T03:36:00+10:00,2023-08-12,03:36,2,0,2
21,2023-08-12T03:37:00+10:00,2023-08-12,03:37,1,3,4
28,2023-08-12T03:31:00+10:00,2023-08-12,03:31,0,1,1
29,2023-08-12T03:31:00+10:00,2023-08-12,03:31,0,2,2
29,2023-08-12T03:32:00+10:00,2023-08-12,03:32,0,2,2
29,2023-08-12T03:34:00+10:00,2023-08-12,03:34,1,0,1
41,2023-08-12T03:27:00+10:00,2023-08-12,03:27,1,0,1
41,2023-08-12T03:28:00+10:00,2023-08-12,03:28,0,6,6
41,2023-08-12T03:30:00+10:00,2023-08-12,03:30,1,6,7
41,2023-08-12T03:36:00+10:00,2023-08-12,03:36,4,3,7
54,2023-08-12T03:35:00+10:00,2023-08-12,03:35,0,2,2
55,2023-08-12T03:25:00+10:00,2023-08-12,03:25,1,1,2
55,2023-08-12T03:27:00+10:00,2023-08-12,03:27,11,3,14
55,2023-08-12T03:31:00+10:00,2023-08-12,03:31,3,0,3
55,2023-08-12T03:33:00+10:00,2023-08-12,03:33,0,1,1
61,2023-08-12T03:39:00+10:00,2023-08-12,03:39,1,0,1
65,2023-08-12T03:26:00+10:00,2023-08-12,03:26,1,0,1
65,2023-08-12T03:33:00+10:00,2023-08-12,03:33,0,2,2
66,2023-08-12T03:25:00+10:00,2023-08-12,03:25,1,1,2
66,2023-08-12T03:27:00+10:00,2023-08-12,03:27,3,0,3
66,2023-08-12T03:33:00+10:00,2023-08-12,03:33,1,0,1
66,2023-08-12T03:35:00+10:00,2023-08-12,03:35,2,0,2
75,2023-08-12T03:34:00+10:00,2023-08-12,03:34,0,1,1
84,2023-08-12T03:25:00+10:00,2023-08-12,03:25,12,2,14
2,2023-08-12T03:31:00+10:00,2023-08-12,03:31,0,2,2
9,2023-08-12T03:26:00+10:00,2023-08-12,03:26,0,2,2
17,2023-08-12T03:35:00+10:00,2023-08-12,03:35,0,1,1
17,2023-08-12T03:38:00+10:00,2023-08-12,03:38,1,0,1
24,2023-08-12T03:33:00+10:00,2023-08-12,03:33,3,1,4
35,2023-08-12T03:30:00+10:00,2023-08-12,03:30,0,1,1
35,2023-08-12T03:36:00+10:00,2023-08-12,03:36,3,0,3
35,2023-08-12T03:39:00+10:00,2023-08-12,03:39,0,2,2
56,2023-08-12T03:37:00+10:00,2023-08-12,03:37,1,0,1
62,2023-08-12T03:26:00+10:00,2023-08-12,03:26,2,0,2
62,2023-08-12T03:38:00+10:00,2023-08-12,03:38,3,0,3
62,2023-08-12T03:39:00+10:00,2023-08-12,03:39,6,1,7
67,2023-08-12T03:29:00+10:00,2023-08-12,03:29,1,2,3
79,2023-08-12T03:34:00+10:00,2023-08-12,03:34,1,0,1
79,2023-08-12T03:37:00+10:00,2023-08-12,03:37,2,3,5
79,2023-08-12T03:39:00+10:00,2023-08-12,03:39,0,4,4
109,2023-08-12T03:30:00+10:00,2023-08-12,03:30,3,0,3
3,2023-08-12T04:01:00+10:00,2023-08-12,04:01,3,1,4
3,2023-08-12T04:07:00+10:00,2023-08-12,04:07,1,1,2
4,2023-08-12T03:56:00+10:00,2023-08-12,03:56,0,1,1
4,2023-08-12T04:01:00+10:00,2023-08-12,04:01,3,2,5
4,2023-08-12T04:07:00+10:00,2023-08-12,04:07,0,1,1
6,2023-08-12T03:55:00+10:00,2023-08-12,03:55,1,1,2
6,2023-08-12T03:56:00+10:00,2023-08-12,03:56,6,0,6
6,2023-08-12T03:58:00+10:00,2023-08-12,03:58,1,1,2
6,2023-08-12T04:01:00+10:00,2023-08-12,04:01,1,1,2
6,2023-08-12T04:05:00+10:00,2023-08-12,04:05,1,0,1
6,2023-08-12T04:07:00+10:00,2023-08-12,04:07,1,1,2
14,2023-08-12T03:58:00+10:00,2023-08-12,03:58,0,1,1
14,2023-08-12T04:01:00+10:00,2023-08-12,04:01,2,0,2
14,2023-08-12T04:05:00+10:00,2023-08-12,04:05,2,0,2
14,2023-08-12T04:09:00+10:00,2023-08-12,04:09,3,0,3
21,2023-08-12T04:02:00+10:00,2023-08-12,04:02,1,0,1
28,2023-08-12T04:05:00+10:00,2023-08-12,04:05,1,0,1
28,2023-08-12T04:08:00+10:00,2023-08-12,04:08,0,1,1
29,2023-08-12T03:55:00+10:00,2023-08-12,03:55,0,1,1
41,2023-08-12T03:59:00+10:00,2023-08-12,03:59,0,2,2
41,2023-08-12T04:01:00+10:00,2023-08-12,04:01,2,0,2
41,2023-08-12T04:08:00+10:00,2023-08-12,04:08,0,1,1
55,2023-08-12T04:04:00+10:00,2023-08-12,04:04,0,1,1
55,2023-08-12T04:07:00+10:00,2023-08-12,04:07,4,3,7
59,2023-08-12T04:00:00+10:00,2023-08-12,04:00,16,1,17
59,2023-08-12T04:05:00+10:00,2023-08-12,04:05,5,0,5
61,2023-08-12T04:09:00+10:00,2023-08-12,04:09,1,0,1
65,2023-08-12T04:01:00+10:00,2023-08-12,04:01,0,1,1
65,2023-08-12T04:05:00+10:00,2023-08-12,04:05,0,4,4
66,2023-08-12T03:57:00+10:00,2023-08-12,03:57,0,2,2
66,2023-08-12T03:58:00+10:00,2023-08-12,03:58,4,1,5
75,2023-08-12T03:59:00+10:00,2023-08-12,03:59,0,1,1
77,2023-08-12T04:04:00+10:00,2023-08-12,04:04,0,1,1
87,2023-08-12T04:04:00+10:00,2023-08-12,04:04,0,1,1
108,2023-08-12T03:55:00+10:00,2023-08-12,03:55,1,0,1
2,2023-08-12T03:59:00+10:00,2023-08-12,03:59,1,0,1
10,2023-08-12T04:07:00+10:00,2023-08-12,04:07,1,0,1
12,2023-08-12T04:07:00+10:00,2023-08-12,04:07,1,0,1
24,2023-08-12T03:57:00+10:00,2023-08-12,03:57,1,0,1
24,2023-08-12T03:59:00+10:00,2023-08-12,03:59,2,0,2
24,2023-08-12T04:04:00+10:00,2023-08-12,04:04,0,2,2
24,2023-08-12T04:09:00+10:00,2023-08-12,04:09,2,0,2
35,2023-08-12T03:57:00+10:00,2023-08-12,03:57,1,0,1
35,2023-08-12T04:00:00+10:00,2023-08-12,04:00,0,2,2
56,2023-08-12T04:04:00+10:00,2023-08-12,04:04,3,0,3
57,2023-08-12T03:55:00+10:00,2023-08-12,03:55,1,0,1
57,2023-08-12T04:07:00+10:00,2023-08-12,04:07,0,1,1
58,2023-08-12T04:03:00+10:00,2023-08-12,04:03,1,0,1
58,2023-08-12T04:08:00+10:00,2023-08-12,04:08,0,2,2
62,2023-08-12T04:02:00+10:00,2023-08-12,04:02,3,0,3
62,2023-08-12T04:05:00+10:00,2023-08-12,04:05,1,0,1
63,2023-08-12T03:58:00+10:00,2023-08-12,03:58,0,2,2
63,2023-08-12T04:04:00+10:00,2023-08-12,04:04,2,0,2
67,2023-08-12T03:56:00+10:00,2023-08-12,03:56,2,0,2
67,2023-08-12T03:57:00+10:00,2023-08-12,03:57,1,0,1
67,2023-08-12T04:02:00+10:00,2023-08-12,04:02,0,2,2
79,2023-08-12T03:55:00+10:00,2023-08-12,03:55,0,1,1
79,2023-08-12T03:57:00+10:00,2023-08-12,03:57,0,4,4
79,2023-08-12T03:58:00+10:00,2023-08-12,03:58,0,1,1
79,2023-08-12T04:01:00+10:00,2023-08-12,04:01,1,2,3
3,2023-08-12T04:11:00+10:00,2023-08-12,04:11,1,0,1
3,2023-08-12T04:12:00+10:00,2023-08-12,04:12,4,0,4
3,2023-08-12T04:17:00+10:00,2023-08-12,04:17,1,0,1
3,2023-08-12T04:20:00+10:00,2023-08-12,04:20,1,0,1
3,2023-08-12T04:22:00+10:00,2023-08-12,04:22,1,1,2
4,2023-08-12T04:11:00+10:00,2023-08-12,04:11,2,0,2
4,2023-08-12T04:19:00+10:00,2023-08-12,04:19,3,0,3
6,2023-08-12T04:10:00+10:00,2023-08-12,04:10,1,1,2
6,2023-08-12T04:12:00+10:00,2023-08-12,04:12,1,2,3
6,2023-08-12T04:16:00+10:00,2023-08-12,04:16,0,1,1
6,2023-08-12T04:20:00+10:00,2023-08-12,04:20,3,0,3
14,2023-08-12T04:13:00+10:00,2023-08-12,04:13,1,0,1
14,2023-08-12T04:16:00+10:00,2023-08-12,04:16,2,0,2
14,2023-08-12T04:18:00+10:00,2023-08-12,04:18,1,0,1
21,2023-08-12T04:10:00+10:00,2023-08-12,04:10,0,6,6
21,2023-08-12T04:11:00+10:00,2023-08-12,04:11,1,0,1
21,2023-08-12T04:16:00+10:00,2023-08-12,04:16,2,1,3
28,2023-08-12T04:15:00+10:00,2023-08-12,04:15,1,1,2
28,2023-08-12T04:18:00+10:00,2023-08-12,04:18,2,0,2
28,2023-08-12T04:19:00+10:00,2023-08-12,04:19,1,0,1
28,2023-08-12T04:22:00+10:00,2023-08-12,04:22,0,1,1
41,2023-08-12T04:10:00+10:00,2023-08-12,04:10,2,1,3
41,2023-08-12T04:17:00+10:00,2023-08-12,04:17,0,4,4
41,2023-08-12T04:21:00+10:00,2023-08-12,04:21,0,2,2
54,2023-08-12T04:17:00+10:00,2023-08-12,04:17,0,2,2
55,2023-08-12T04:19:00+10:00,2023-08-12,04:19,0,1,1
55,2023-08-12T04:22:00+10:00,2023-08-12,04:22,0,2,2
55,2023-08-12T04:24:00+10:00,2023-08-12,04:24,0,1,1
59,2023-08-12T04:15:00+10:00,2023-08-12,04:15,0,1,1
65,2023-08-12T04:15:00+10:00,2023-08-12,04:15,0,1,1
65,2023-08-12T04:19:00+10:00,2023-08-12,04:19,0,1,1
66,2023-08-12T04:17:00+10:00,2023-08-12,04:17,1,0,1
69,2023-08-12T04:15:00+10:00,2023-08-12,04:15,1,0,1
84,2023-08-12T04:20:00+10:00,2023-08-12,04:20,6,12,18
107,2023-08-12T04:20:00+10:00,2023-08-12,04:20,6,0,6
108,2023-08-12T04:14:00+10:00,2023-08-12,04:14,1,1,2
108,2023-08-12T04:22:00+10:00,2023-08-12,04:22,1,0,1
1,2023-08-12T04:12:00+10:00,2023-08-12,04:12,0,1,1
2,2023-08-12T04:15:00+10:00,2023-08-12,04:15,0,1,1
7,2023-08-12T04:15:00+10:00,2023-08-12,04:15,1,0,1
9,2023-08-12T04:10:00+10:00,2023-08-12,04:10,0,1,1
12,2023-08-12T04:12:00+10:00,2023-08-12,04:12,0,1,1
24,2023-08-12T04:11:00+10:00,2023-08-12,04:11,0,1,1
24,2023-08-12T04:12:00+10:00,2023-08-12,04:12,0,3,3
24,2023-08-12T04:18:00+10:00,2023-08-12,04:18,2,0,2
35,2023-08-12T04:16:00+10:00,2023-08-12,04:16,3,1,4
35,2023-08-12T04:17:00+10:00,2023-08-12,04:17,1,0,1
35,2023-08-12T04:18:00+10:00,2023-08-12,04:18,0,3,3
56,2023-08-12T04:17:00+10:00,2023-08-12,04:17,1,1,2
56,2023-08-12T04:19:00+10:00,2023-08-12,04:19,2,0,2
58,2023-08-12T04:19:00+10:00,2023-08-12,04:19,2,0,2
58,2023-08-12T04:20:00+10:00,2023-08-12,04:20,0,4,4
62,2023-08-12T04:22:00+10:00,2023-08-12,04:22,1,3,4
63,2023-08-12T04:11:00+10:00,2023-08-12,04:11,0,1,1
63,2023-08-12T04:13:00+10:00,2023-08-12,04:13,0,4,4
63,2023-08-12T04:14:00+10:00,2023-08-12,04:14,4,0,4
63,2023-08-12T04:16:00+10:00,2023-08-12,04:16,1,0,1
79,2023-08-12T04:13:00+10:00,2023-08-12,04:13,2,0,2
109,2023-08-12T04:20:00+10:00,2023-08-12,04:20,2,1,3
117,2023-08-12T04:10:00+10:00,2023-08-12,04:10,3,0,3
117,2023-08-12T04:15:00+10:00,2023-08-12,04:15,2,1,3
3,2023-08-12T04:25:00+10:00,2023-08-12,04:25,0,2,2
3,2023-08-12T04:28:00+10:00,2023-08-12,04:28,5,8,13
3,2023-08-12T04:32:00+10:00,2023-08-12,04:32,3,1,4
3,2023-08-12T04:38:00+10:00,2023-08-12,04:38,7,0,7
4,2023-08-12T04:25:00+10:00,2023-08-12,04:25,1,0,1
6,2023-08-12T04:27:00+10:00,2023-08-12,04:27,1,0,1
6,2023-08-12T04:28:00+10:00,2023-08-12,04:28,1,0,1
6,2023-08-12T04:29:00+10:00,2023-08-12,04:29,1,0,1
6,2023-08-12T04:30:00+10:00,2023-08-12,04:30,2,1,3
6,2023-08-12T04:34:00+10:00,2023-08-12,04:34,2,0,2
6,2023-08-12T04:37:00+10:00,2023-08-12,04:37,2,1,3
6,2023-08-12T04:39:00+10:00,2023-08-12,04:39,2,0,2
14,2023-08-12T04:25:00+10:00,2023-08-12,04:25,2,0,2
14,2023-08-12T04:31:00+10:00,2023-08-12,04:31,2,0,2
14,2023-08-12T04:35:00+10:00,2023-08-12,04:35,1,0,1
14,2023-08-12T04:36:00+10:00,2023-08-12,04:36,0,1,1
14,2023-08-12T04:38:00+10:00,2023-08-12,04:38,6,0,6
21,2023-08-12T04:28:00+10:00,2023-08-12,04:28,0,5,5
21,2023-08-12T04:34:00+10:00,2023-08-12,04:34,0,1,1
21,2023-08-12T04:37:00+10:00,2023-08-12,04:37,1,3,4
29,2023-08-12T04:39:00+10:00,2023-08-12,04:39,1,0,1
39,2023-08-12T04:34:00+10:00,2023-08-12,04:34,3,0,3
41,2023-08-12T04:27:00+10:00,2023-08-12,04:27,0,1,1
41,2023-08-12T04:35:00+10:00,2023-08-12,04:35,1,1,2
55,2023-08-12T04:31:00+10:00,2023-08-12,04:31,0,2,2
55,2023-08-12T04:32:00+10:00,2023-08-12,04:32,3,1,4
55,2023-08-12T04:35:00+10:00,2023-08-12,04:35,0,1,1
55,2023-08-12T04:37:00+10:00,2023-08-12,04:37,0,2,2
59,2023-08-12T04:30:00+10:00,2023-08-12,04:30,1,0,1
59,2023-08-12T04:35:00+10:00,2023-08-12,04:35,3,1,4
65,2023-08-12T04:26:00+10:00,2023-08-12,04:26,0,1,1
66,2023-08-12T04:29:00+10:00,2023-08-12,04:29,1,2,3
1,2023-08-12T04:35:00+10:00,2023-08-12,04:35,1,0,1
1,2023-08-12T04:38:00+10:00,2023-08-12,04:38,0,3,3
7,2023-08-12T04:30:00+10:00,2023-08-12,04:30,0,2,2
18,2023-08-12T04:37:00+10:00,2023-08-12,04:37,1,0,1
24,2023-08-12T04:29:00+10:00,2023-08-12,04:29,0,4,4
24,2023-08-12T04:33:00+10:00,2023-08-12,04:33,1,2,3
24,2023-08-12T04:35:00+10:00,2023-08-12,04:35,1,2,3
27,2023-08-12T04:30:00+10:00,2023-08-12,04:30,1,0,1
35,2023-08-12T04:30:00+10:00,2023-08-12,04:30,1,2,3
35,2023-08-12T04:36:00+10:00,2023-08-12,04:36,1,0,1
53,2023-08-12T04:36:00+10:00,2023-08-12,04:36,0,2,2
53,2023-08-12T04:39:00+10:00,2023-08-12,04:39,1,0,1
56,2023-08-12T04:25:00+10:00,2023-08-12,04:25,0,1,1
56,2023-08-12T04:27:00+10:00,2023-08-12,04:27,2,0,2
56,2023-08-12T04:32:00+10:00,2023-08-12,04:32,1,0,1
56,2023-08-12T04:33:00+10:00,2023-08-12,04:33,1,0,1
56,2023-08-12T04:37:00+10:00,2023-08-12,04:37,3,0,3
58,2023-08-12T04:31:00+10:00,2023-08-12,04:31,0,5,5
58,2023-08-12T04:36:00+10:00,2023-08-12,04:36,1,0,1
62,2023-08-12T04:26:00+10:00,2023-08-12,04:26,1,0,1
62,2023-08-12T04:33:00+10:00,2023-08-12,04:33,1,0,1
62,2023-08-12T04:34:00+10:00,2023-08-12,04:34,1,0,1
62,2023-08-12T04:37:00+10:00,2023-08-12,04:37,1,1,2
63,2023-08-12T04:29:00+10:00,2023-08-12,04:29,1,1,2
63,2023-08-12T04:32:00+10:00,2023-08-12,04:32,0,2,2
67,2023-08-12T04:28:00+10:00,2023-08-12,04:28,1,0,1
67,2023-08-12T04:31:00+10:00,2023-08-12,04:31,1,0,1
72,2023-08-12T04:33:00+10:00,2023-08-12,04:33,0,1,1
79,2023-08-12T04:28:00+10:00,2023-08-12,04:28,0,1,1
79,2023-08-12T04:33:00+10:00,2023-08-12,04:33,0,1,1
109,2023-08-12T04:35:00+10:00,2023-08-12,04:35,1,0,1
117,2023-08-12T04:35:00+10:00,2023-08-12,04:35,1,0,1
3,2023-08-12T04:53:00+10:00,2023-08-12,04:53,0,1,1
3,2023-08-12T04:54:00+10:00,2023-08-12,04:54,0,1,1
4,2023-08-12T04:46:00+10:00,2023-08-12,04:46,1,0,1
4,2023-08-12T04:53:00+10:00,2023-08-12,04:53,0,2,2
6,2023-08-12T04:46:00+10:00,2023-08-12,04:46,1,3,4
14,2023-08-12T04:42:00+10:00,2023-08-12,04:42,3,1,4
21,2023-08-12T04:41:00+10:00,2023-08-12,04:41,0,1,1
21,2023-08-12T04:44:00+10:00,2023-08-12,04:44,0,2,2
28,2023-08-12T04:41:00+10:00,2023-08-12,04:41,3,0,3
28,2023-08-12T04:48:00+10:00,2023-08-12,04:48,0,1,1
28,2023-08-12T04:53:00+10:00,2023-08-12,04:53,0,1,1
41,2023-08-12T04:43:00+10:00,2023-08-12,04:43,1,0,1
41,2023-08-12T04:44:00+10:00,2023-08-12,04:44,0,2,2
41,2023-08-12T04:50:00+10:00,2023-08-12,04:50,3,2,5
41,2023-08-12T04:52:00+10:00,2023-08-12,04:52,0,2,2
54,2023-08-12T04:45:00+10:00,2023-08-12,04:45,2,0,2
55,2023-08-12T04:43:00+10:00,2023-08-12,04:43,0,1,1
55,2023-08-12T04:48:00+10:00,2023-08-12,04:48,2,2,4
55,2023-08-12T04:50:00+10:00,2023-08-12,04:50,1,1,2
55,2023-08-12T04:53:00+10:00,2023-08-12,04:53,2,3,5
55,2023-08-12T04:54:00+10:00,2023-08-12,04:54,1,1,2
59,2023-08-12T04:45:00+10:00,2023-08-12,04:45,2,1,3
59,2023-08-12T04:50:00+10:00,2023-08-12,04:50,3,3,6
65,2023-08-12T04:44:00+10:00,2023-08-12,04:44,1,0,1
65,2023-08-12T04:54:00+10:00,2023-08-12,04:54,0,1,1
66,2023-08-12T04:40:00+10:00,2023-08-12,04:40,1,0,1
84,2023-08-12T04:40:00+10:00,2023-08-12,04:40,3,1,4
84,2023-08-12T04:45:00+10:00,2023-08-12,04:45,4,2,6
84,2023-08-12T04:50:00+10:00,2023-08-12,04:50,3,16,19
107,2023-08-12T04:40:00+10:00,2023-08-12,04:40,0,2,2
1,2023-08-12T04:45:00+10:00,2023-08-12,04:45,4,1,5
1,2023-08-12T04:47:00+10:00,2023-08-12,04:47,2,0,2
2,2023-08-12T04:48:00+10:00,2023-08-12,04:48,1,0,1
2,2023-08-12T04:53:00+10:00,2023-08-12,04:53,0,1,1
7,2023-08-12T04:46:00+10:00,2023-08-12,04:46,1,0,1
24,2023-08-12T04:44:00+10:00,2023-08-12,04:44,3,0,3
24,2023-08-12T04:52:00+10:00,2023-08-12,04:52,0,1,1
35,2023-08-12T04:42:00+10:00,2023-08-12,04:42,0,1,1
35,2023-08-12T04:44:00+10:00,2023-08-12,04:44,0,1,1
35,2023-08-12T04:45:00+10:00,2023-08-12,04:45,0,1,1
35,2023-08-12T04:52:00+10:00,2023-08-12,04:52,2,0,2
53,2023-08-12T04:46:00+10:00,2023-08-12,04:46,0,1,1
56,2023-08-12T04:40:00+10:00,2023-08-12,04:40,0,1,1
56,2023-08-12T04:46:00+10:00,2023-08-12,04:46,1,0,1
58,2023-08-12T04:47:00+10:00,2023-08-12,04:47,1,0,1
58,2023-08-12T04:51:00+10:00,2023-08-12,04:51,0,1,1
58,2023-08-12T04:54:00+10:00,2023-08-12,04:54,3,0,3
62,2023-08-12T04:45:00+10:00,2023-08-12,04:45,1,1,2
63,2023-08-12T04:40:00+10:00,2023-08-12,04:40,1,0,1
67,2023-08-12T04:49:00+10:00,2023-08-12,04:49,1,0,1
79,2023-08-12T04:40:00+10:00,2023-08-12,04:40,0,2,2
79,2023-08-12T04:46:00+10:00,2023-08-12,04:46,0,1,1
109,2023-08-12T04:45:00+10:00,2023-08-12,04:45,1,1,2
109,2023-08-12T04:50:00+10:00,2023-08-12,04:50,2,0,2
3,2023-08-12T04:56:00+10:00,2023-08-12,04:56,2,3,5
3,2023-08-12T05:03:00+10:00,2023-08-12,05:03,1,0,1
3,2023-08-12T05:05:00+10:00,2023-08-12,05:05,1,1,2
3,2023-08-12T05:08:00+10:00,2023-08-12,05:08,0,1,1
3,2023-08-12T05:09:00+10:00,2023-08-12,05:09,2,0,2
4,2023-08-12T05:05:00+10:00,2023-08-12,05:05,0,1,1
6,2023-08-12T05:01:00+10:00,2023-08-12,05:01,2,0,2
14,2023-08-12T04:58:00+10:00,2023-08-12,04:58,2,0,2
21,2023-08-12T04:56:00+10:00,2023-08-12,04:56,0,1,1
21,2023-08-12T05:02:00+10:00,2023-08-12,05:02,3,0,3
28,2023-08-12T04:57:00+10:00,2023-08-12,04:57,5,0,5
28,2023-08-12T05:00:00+10:00,2023-08-12,05:00,1,0,1
41,2023-08-12T04:56:00+10:00,2023-08-12,04:56,2,7,9
41,2023-08-12T05:01:00+10:00,2023-08-12,05:01,0,7,7
41,2023-08-12T05:02:00+10:00,2023-08-12,05:02,0,1,1
41,2023-08-12T05:03:00+10:00,2023-08-12,05:03,3,0,3
41,2023-08-12T05:04:00+10:00,2023-08-12,05:04,1,1,2
41,2023-08-12T05:06:00+10:00,2023-08-12,05:06,0,2,2
55,2023-08-12T04:56:00+10:00,2023-08-12,04:56,0,1,1
55,2023-08-12T04:57:00+10:00,2023-08-12,04:57,0,1,1
55,2023-08-12T05:00:00+10:00,2023-08-12,05:00,2,2,4
55,2023-08-12T05:06:00+10:00,2023-08-12,05:06,0,1,1
55,2023-08-12T05:09:00+10:00,2023-08-12,05:09,0,1,1
59,2023-08-12T04:55:00+10:00,2023-08-12,04:55,3,0,3
61,2023-08-12T04:57:00+10:00,2023-08-12,04:57,1,0,1
61,2023-08-12T05:05:00+10:00,2023-08-12,05:05,2,2,4
65,2023-08-12T04:55:00+10:00,2023-08-12,04:55,0,1,1
65,2023-08-12T04:57:00+10:00,2023-08-12,04:57,1,2,3
65,2023-08-12T05:09:00+10:00,2023-08-12,05:09,0,1,1
66,2023-08-12T05:09:00+10:00,2023-08-12,05:09,1,1,2
84,2023-08-12T04:55:00+10:00,2023-08-12,04:55,2,0,2
84,2023-08-12T05:05:00+10:00,2023-08-12,05:05,6,3,9
107,2023-08-12T04:55:00+10:00,2023-08-12,04:55,1,0,1
108,2023-08-12T04:59:00+10:00,2023-08-12,04:59,1,0,1
1,2023-08-12T05:00:00+10:00,2023-08-12,05:00,0,1,1
9,2023-08-12T05:09:00+10:00,2023-08-12,05:09,0,1,1
17,2023-08-12T05:02:00+10:00,2023-08-12,05:02,1,0,1
18,2023-08-12T04:59:00+10:00,2023-08-12,04:59,1,0,1
24,2023-08-12T04:55:00+10:00,2023-08-12,04:55,3,5,8
24,2023-08-12T04:57:00+10:00,2023-08-12,04:57,2,4,6
24,2023-08-12T05:01:00+10:00,2023-08-12,05:01,0,2,2
24,2023-08-12T05:03:00+10:00,2023-08-12,05:03,0,1,1
24,2023-08-12T05:05:00+10:00,2023-08-12,05:05,0,1,1
24,2023-08-12T05:09:00+10:00,2023-08-12,05:09,1,0,1
35,2023-08-12T04:58:00+10:00,2023-08-12,04:58,1,0,1
35,2023-08-12T05:03:00+10:00,2023-08-12,05:03,0,2,2
35,2023-08-12T05:04:00+10:00,2023-08-12,05:04,0,1,1
56,2023-08-12T05:05:00+10:00,2023-08-12,05:05,6,0,6
56,2023-08-12T05:06:00+10:00,2023-08-12,05:06,2,0,2
58,2023-08-12T04:56:00+10:00,2023-08-12,04:56,0,1,1
58,2023-08-12T04:58:00+10:00,2023-08-12,04:58,1,0,1
58,2023-08-12T05:03:00+10:00,2023-08-12,05:03,0,3,3
62,2023-08-12T04:55:00+10:00,2023-08-12,04:55,0,1,1
62,2023-08-12T04:58:00+10:00,2023-08-12,04:58,2,0,2
62,2023-08-12T05:01:00+10:00,2023-08-12,05:01,4,1,5
62,2023-08-12T05:02:00+10:00,2023-08-12,05:02,5,1,6
62,2023-08-12T05:08:00+10:00,2023-08-12,05:08,6,0,6
63,2023-08-12T04:57:00+10:00,2023-08-12,04:57,0,1,1
63,2023-08-12T05:08:00+10:00,2023-08-12,05:08,0,1,1
67,2023-08-12T05:00:00+10:00,2023-08-12,05:00,0,1,1
67,2023-08-12T05:02:00+10:00,2023-08-12,05:02,3,0,3
72,2023-08-12T04:58:00+10:00,2023-08-12,04:58,0,1,1
72,2023-08-12T05:00:00+10:00,2023-08-12,05:00,5,0,5
79,2023-08-12T05:07:00+10:00,2023-08-12,05:07,1,4,5
109,2023-08-12T04:55:00+10:00,2023-08-12,04:55,1,0,1
3,2023-08-12T05:14:00+10:00,2023-08-12,05:14,0,1,1
3,2023-08-12T05:17:00+10:00,2023-08-12,05:17,3,0,3
3,2023-08-12T05:20:00+10:00,2023-08-12,05:20,2,0,2
3,2023-08-12T05:21:00+10:00,2023-08-12,05:21,1,1,2
3,2023-08-12T05:23:00+10:00,2023-08-12,05:23,1,2,3
3,2023-08-12T05:24:00+10:00,2023-08-12,05:24,3,1,4
4,2023-08-12T05:18:00+10:00,2023-08-12,05:18,2,0,2
6,2023-08-12T05:21:00+10:00,2023-08-12,05:21,2,1,3
8,2023-08-12T05:19:00+10:00,2023-08-12,05:19,1,0,1
14,2023-08-12T05:19:00+10:00,2023-08-12,05:19,4,0,4
14,2023-08-12T05:21:00+10:00,2023-08-12,05:21,1,0,1
21,2023-08-12T05:14:00+10:00,2023-08-12,05:14,0,2,2
21,2023-08-12T05:24:00+10:00,2023-08-12,05:24,0,3,3
29,2023-08-12T05:23:00+10:00,2023-08-12,05:23,1,0,1
41,2023-08-12T05:15:00+10:00,2023-08-12,05:15,1,0,1
41,2023-08-12T05:18:00+10:00,2023-08-12,05:18,0,4,4
41,2023-08-12T05:22:00+10:00,2023-08-12,05:22,0,1,1
41,2023-08-12T05:23:00+10:00,2023-08-12,05:23,0,2,2
55,2023-08-12T05:15:00+10:00,2023-08-12,05:15,0,1,1
59,2023-08-12T05:20:00+10:00,2023-08-12,05:20,3,0,3
61,2023-08-12T05:16:00+10:00,2023-08-12,05:16,0,2,2
61,2023-08-12T05:23:00+10:00,2023-08-12,05:23,1,0,1
65,2023-08-12T05:19:00+10:00,2023-08-12,05:19,0,1,1
65,2023-08-12T05:21:00+10:00,2023-08-12,05:21,0,2,2
65,2023-08-12T05:22:00+10:00,2023-08-12,05:22,0,1,1
70,2023-08-12T05:23:00+10:00,2023-08-12,05:23,0,1,1
108,2023-08-12T05:10:00+10:00,2023-08-12,05:10,0,1,1
1,2023-08-12T05:15:00+10:00,2023-08-12,05:15,5,0,5
2,2023-08-12T05:23:00+10:00,2023-08-12,05:23,0,2,2
7,2023-08-12T05:20:00+10:00,2023-08-12,05:20,0,1,1
9,2023-08-12T05:24:00+10:00,2023-08-12,05:24,1,0,1
17,2023-08-12T05:11:00+10:00,2023-08-12,05:11,0,1,1
17,2023-08-12T05:12:00+10:00,2023-08-12,05:12,1,0,1
17,2023-08-12T05:14:00+10:00,2023-08-12,05:14,0,4,4
17,2023-08-12T05:17:00+10:00,2023-08-12,05:17,0,1,1
17,2023-08-12T05:22:00+10:00,2023-08-12,05:22,2,0,2
24,2023-08-12T05:12:00+10:00,2023-08-12,05:12,1,0,1
27,2023-08-12T05:14:00+10:00,2023-08-12,05:14,1,0,1
35,2023-08-12T05:13:00+10:00,2023-08-12,05:13,1,1,2
35,2023-08-12T05:14:00+10:00,2023-08-12,05:14,1,0,1
35,2023-08-12T05:23:00+10:00,2023-08-12,05:23,1,0,1
53,2023-08-12T05:15:00+10:00,2023-08-12,05:15,1,0,1
56,2023-08-12T05:13:00+10:00,2023-08-12,05:13,3,0,3
56,2023-08-12T05:14:00+10:00,2023-08-12,05:14,1,0,1
56,2023-08-12T05:19:00+10:00,2023-08-12,05:19,3,0,3
58,2023-08-12T05:11:00+10:00,2023-08-12,05:11,0,2,2
58,2023-08-12T05:12:00+10:00,2023-08-12,05:12,1,0,1
58,2023-08-12T05:21:00+10:00,2023-08-12,05:21,2,3,5
58,2023-08-12T05:23:00+10:00,2023-08-12,05:23,2,0,2
62,2023-08-12T05:24:00+10:00,2023-08-12,05:24,1,0,1
63,2023-08-12T05:21:00+10:00,2023-08-12,05:21,0,1,1
79,2023-08-12T05:21:00+10:00,2023-08-12,05:21,0,2,2
79,2023-08-12T05:24:00+10:00,2023-08-12,05:24,0,1,1
117,2023-08-12T05:20:00+10:00,2023-08-12,05:20,1,0,1
3,2023-08-12T05:29:00+10:00,2023-08-12,05:29,0,1,1
3,2023-08-12T05:30:00+10:00,2023-08-12,05:30,0,1,1
3,2023-08-12T05:31:00+10:00,2023-08-12,05:31,1,0,1
3,2023-08-12T05:34:00+10:00,2023-08-12,05:34,0,1,1
3,2023-08-12T05:39:00+10:00,2023-08-12,05:39,1,2,3
4,2023-08-12T05:31:00+10:00,2023-08-12,05:31,1,0,1
4,2023-08-12T05:38:00+10:00,2023-08-12,05:38,0,1,1
4,2023-08-12T05:39:00+10:00,2023-08-12,05:39,0,1,1
6,2023-08-12T05:25:00+10:00,2023-08-12,05:25,2,0,2
6,2023-08-12T05:26:00+10:00,2023-08-12,05:26,0,3,3
6,2023-08-12T05:29:00+10:00,2023-08-12,05:29,2,1,3
6,2023-08-12T05:30:00+10:00,2023-08-12,05:30,0,1,1
14,2023-08-12T05:31:00+10:00,2023-08-12,05:31,0,1,1
14,2023-08-12T05:35:00+10:00,2023-08-12,05:35,2,0,2
21,2023-08-12T05:26:00+10:00,2023-08-12,05:26,2,0,2
21,2023-08-12T05:28:00+10:00,2023-08-12,05:28,1,1,2
28,2023-08-12T05:32:00+10:00,2023-08-12,05:32,0,2,2
29,2023-08-12T05:26:00+10:00,2023-08-12,05:26,0,1,1
29,2023-08-12T05:37:00+10:00,2023-08-12,05:37,1,0,1
29,2023-08-12T05:39:00+10:00,2023-08-12,05:39,1,0,1
39,2023-08-12T05:29:00+10:00,2023-08-12,05:29,0,1,1
39,2023-08-12T05:33:00+10:00,2023-08-12,05:33,0,1,1
41,2023-08-12T05:29:00+10:00,2023-08-12,05:29,3,2,5
41,2023-08-12T05:32:00+10:00,2023-08-12,05:32,0,2,2
41,2023-08-12T05:37:00+10:00,2023-08-12,05:37,2,2,4
55,2023-08-12T05:26:00+10:00,2023-08-12,05:26,0,1,1
55,2023-08-12T05:27:00+10:00,2023-08-12,05:27,2,2,4
55,2023-08-12T05:31:00+10:00,2023-08-12,05:31,2,0,2
55,2023-08-12T05:34:00+10:00,2023-08-12,05:34,3,0,3
59,2023-08-12T05:25:00+10:00,2023-08-12,05:25,5,0,5
61,2023-08-12T05:30:00+10:00,2023-08-12,05:30,1,0,1
61,2023-08-12T05:38:00+10:00,2023-08-12,05:38,0,3,3
65,2023-08-12T05:29:00+10:00,2023-08-12,05:29,1,0,1
65,2023-08-12T05:33:00+10:00,2023-08-12,05:33,0,1,1
87,2023-08-12T05:31:00+10:00,2023-08-12,05:31,1,0,1
87,2023-08-12T05:32:00+10:00,2023-08-12,05:32,1,0,1
87,2023-08-12T05:35:00+10:00,2023-08-12,05:35,1,1,2
108,2023-08-12T05:25:00+10:00,2023-08-12,05:25,0,2,2
108,2023-08-12T05:26:00+10:00,2023-08-12,05:26,1,1,2
108,2023-08-12T05:38:00+10:00,2023-08-12,05:38,0,1,1
17,2023-08-12T05:28:00+10:00,2023-08-12,05:28,2,0,2
17,2023-08-12T05:29:00+10:00,2023-08-12,05:29,1,0,1
24,2023-08-12T05:38:00+10:00,2023-08-12,05:38,1,0,1
24,2023-08-12T05:39:00+10:00,2023-08-12,05:39,0,4,4
27,2023-08-12T05:36:00+10:00,2023-08-12,05:36,0,1,1
35,2023-08-12T05:26:00+10:00,2023-08-12,05:26,2,0,2
35,2023-08-12T05:29:00+10:00,2023-08-12,05:29,0,3,3
35,2023-08-12T05:30:00+10:00,2023-08-12,05:30,2,1,3
53,2023-08-12T05:34:00+10:00,2023-08-12,05:34,0,1,1
58,2023-08-12T05:27:00+10:00,2023-08-12,05:27,1,0,1
58,2023-08-12T05:29:00+10:00,2023-08-12,05:29,1,0,1
58,2023-08-12T05:33:00+10:00,2023-08-12,05:33,1,0,1
62,2023-08-12T05:27:00+10:00,2023-08-12,05:27,1,0,1
62,2023-08-12T05:28:00+10:00,2023-08-12,05:28,1,0,1
67,2023-08-12T05:31:00+10:00,2023-08-12,05:31,1,0,1
72,2023-08-12T05:26:00+10:00,2023-08-12,05:26,0,3,3
72,2023-08-12T05:35:00+10:00,2023-08-12,05:35,1,0,1
79,2023-08-12T05:37:00+10:00,2023-08-12,05:37,0,2,2
79,2023-08-12T05:39:00+10:00,2023-08-12,05:39,0,1,1
122,2023-08-12T05:39:00+10:00,2023-08-12,05:39,1,0,1
3,2023-08-12T05:42:00+10:00,2023-08-12,05:42,1,2,3
3,2023-08-12T05:43:00+10:00,2023-08-12,05:43,0,1,1
3,2023-08-12T05:51:00+10:00,2023-08-12,05:51,0,1,1
6,2023-08-12T05:41:00+10:00,2023-08-12,05:41,1,0,1
6,2023-08-12T05:43:00+10:00,2023-08-12,05:43,0,3,3
6,2023-08-12T05:47:00+10:00,2023-08-12,05:47,0,1,1
6,2023-08-12T05:49:00+10:00,2023-08-12,05:49,0,1,1
6,2023-08-12T05:52:00+10:00,2023-08-12,05:52,0,1,1
14,2023-08-12T05:52:00+10:00,2023-08-12,05:52,1,0,1
21,2023-08-12T05:40:00+10:00,2023-08-12,05:40,1,1,2
29,2023-08-12T05:41:00+10:00,2023-08-12,05:41,1,0,1
29,2023-08-12T05:49:00+10:00,2023-08-12,05:49,1,0,1
39,2023-08-12T05:50:00+10:00,2023-08-12,05:50,1,0,1
41,2023-08-12T05:40:00+10:00,2023-08-12,05:40,2,0,2
41,2023-08-12T05:42:00+10:00,2023-08-12,05:42,1,3,4
41,2023-08-12T05:46:00+10:00,2023-08-12,05:46,0,2,2
41,2023-08-12T05:47:00+10:00,2023-08-12,05:47,2,4,6
41,2023-08-12T05:50:00+10:00,2023-08-12,05:50,2,0,2
55,2023-08-12T05:42:00+10:00,2023-08-12,05:42,2,0,2
55,2023-08-12T05:45:00+10:00,2023-08-12,05:45,0,4,4
55,2023-08-12T05:51:00+10:00,2023-08-12,05:51,1,0,1
55,2023-08-12T05:53:00+10:00,2023-08-12,05:53,1,0,1
61,2023-08-12T05:43:00+10:00,2023-08-12,05:43,0,1,1
61,2023-08-12T05:49:00+10:00,2023-08-12,05:49,0,1,1
61,2023-08-12T05:50:00+10:00,2023-08-12,05:50,0,1,1
65,2023-08-12T05:41:00+10:00,2023-08-12,05:41,0,1,1
75,2023-08-12T05:46:00+10:00,2023-08-12,05:46,2,0,2
84,2023-08-12T05:40:00+10:00,2023-08-12,05:40,3,2,5
84,2023-08-12T05:45:00+10:00,2023-08-12,05:45,3,4,7
87,2023-08-12T05:48:00+10:00,2023-08-12,05:48,0,1,1
87,2023-08-12T05:49:00+10:00,2023-08-12,05:49,0,1,1
87,2023-08-12T05:53:00+10:00,2023-08-12,05:53,1,0,1
107,2023-08-12T05:50:00+10:00,2023-08-12,05:50,2,4,6
108,2023-08-12T05:40:00+10:00,2023-08-12,05:40,0,2,2
108,2023-08-12T05:42:00+10:00,2023-08-12,05:42,0,1,1
108,2023-08-12T05:53:00+10:00,2023-08-12,05:53,1,0,1
108,2023-08-12T05:54:00+10:00,2023-08-12,05:54,1,0,1
118,2023-08-12T05:50:00+10:00,2023-08-12,05:50,1,0,1
1,2023-08-12T05:46:00+10:00,2023-08-12,05:46,3,0,3
2,2023-08-12T05:42:00+10:00,2023-08-12,05:42,1,0,1
9,2023-08-12T05:53:00+10:00,2023-08-12,05:53,0,2,2
9,2023-08-12T05:54:00+10:00,2023-08-12,05:54,0,1,1
24,2023-08-12T05:49:00+10:00,2023-08-12,05:49,1,0,1
24,2023-08-12T05:50:00+10:00,2023-08-12,05:50,1,2,3
24,2023-08-12T05:53:00+10:00,2023-08-12,05:53,2,1,3
27,2023-08-12T05:49:00+10:00,2023-08-12,05:49,1,0,1
35,2023-08-12T05:41:00+10:00,2023-08-12,05:41,1,0,1
35,2023-08-12T05:44:00+10:00,2023-08-12,05:44,2,0,2
35,2023-08-12T05:50:00+10:00,2023-08-12,05:50,1,0,1
35,2023-08-12T05:52:00+10:00,2023-08-12,05:52,2,1,3
56,2023-08-12T05:44:00+10:00,2023-08-12,05:44,1,0,1
56,2023-08-12T05:51:00+10:00,2023-08-12,05:51,7,0,7
57,2023-08-12T05:44:00+10:00,2023-08-12,05:44,0,1,1
58,2023-08-12T05:40:00+10:00,2023-08-12,05:40,1,0,1
58,2023-08-12T05:44:00+10:00,2023-08-12,05:44,1,0,1
58,2023-08-12T05:45:00+10:00,2023-08-12,05:45,0,1,1
58,2023-08-12T05:50:00+10:00,2023-08-12,05:50,1,1,2
58,2023-08-12T05:53:00+10:00,2023-08-12,05:53,1,0,1
62,2023-08-12T05:42:00+10:00,2023-08-12,05:42,0,1,1
62,2023-08-12T05:50:00+10:00,2023-08-12,05:50,1,0,1
63,2023-08-12T05:42:00+10:00,2023-08-12,05:42,0,4,4
63,2023-08-12T05:53:00+10:00,2023-08-12,05:53,0,1,1
72,2023-08-12T05:42:00+10:00,2023-08-12,05:42,1,2,3
72,2023-08-12T05:49:00+10:00,2023-08-12,05:49,3,0,3
72,2023-08-12T05:50:00+10:00,2023-08-12,05:50,0,1,1
79,2023-08-12T05:40:00+10:00,2023-08-12,05:40,1,1,2
79,2023-08-12T05:42:00+10:00,2023-08-12,05:42,1,2,3
79,2023-08-12T05:46:00+10:00,2023-08-12,05:46,0,1,1
109,2023-08-12T05:50:00+10:00,2023-08-12,05:50,1,0,1
117,2023-08-12T05:40:00+10:00,2023-08-12,05:40,1,0,1
117,2023-08-12T05:50:00+10:00,2023-08-12,05:50,1,0,1
122,2023-08-12T05:46:00+10:00,2023-08-12,05:46,1,0,1
122,2023-08-12T05:54:00+10:00,2023-08-12,05:54,1,1,2
3,2023-08-12T06:05:00+10:00,2023-08-12,06:05,1,0,1
4,2023-08-12T05:55:00+10:00,2023-08-12,05:55,1,0,1
4,2023-08-12T05:56:00+10:00,2023-08-12,05:56,0,1,1
4,2023-08-12T05:57:00+10:00,2023-08-12,05:57,0,1,1
4,2023-08-12T05:59:00+10:00,2023-08-12,05:59,0,1,1
4,2023-08-12T06:00:00+10:00,2023-08-12,06:00,0,1,1
4,2023-08-12T06:01:00+10:00,2023-08-12,06:01,0,3,3
4,2023-08-12T06:08:00+10:00,2023-08-12,06:08,1,1,2
6,2023-08-12T05:56:00+10:00,2023-08-12,05:56,0,1,1
6,2023-08-12T05:59:00+10:00,2023-08-12,05:59,0,1,1
6,2023-08-12T06:00:00+10:00,2023-08-12,06:00,0,1,1
6,2023-08-12T06:02:00+10:00,2023-08-12,06:02,1,0,1
6,2023-08-12T06:03:00+10:00,2023-08-12,06:03,0,1,1
6,2023-08-12T06:05:00+10:00,2023-08-12,06:05,0,1,1
6,2023-08-12T06:07:00+10:00,2023-08-12,06:07,1,0,1
8,2023-08-12T06:07:00+10:00,2023-08-12,06:07,0,1,1
14,2023-08-12T05:57:00+10:00,2023-08-12,05:57,1,0,1
14,2023-08-12T05:59:00+10:00,2023-08-12,05:59,0,1,1
14,2023-08-12T06:05:00+10:00,2023-08-12,06:05,1,0,1
21,2023-08-12T05:59:00+10:00,2023-08-12,05:59,0,1,1
21,2023-08-12T06:00:00+10:00,2023-08-12,06:00,2,2,4
21,2023-08-12T06:03:00+10:00,2023-08-12,06:03,0,3,3
21,2023-08-12T06:06:00+10:00,2023-08-12,06:06,0,2,2
21,2023-08-12T06:08:00+10:00,2023-08-12,06:08,2,3,5
28,2023-08-12T05:55:00+10:00,2023-08-12,05:55,2,1,3
28,2023-08-12T06:02:00+10:00,2023-08-12,06:02,0,1,1
39,2023-08-12T05:57:00+10:00,2023-08-12,05:57,0,1,1
41,2023-08-12T05:59:00+10:00,2023-08-12,05:59,1,3,4
41,2023-08-12T06:06:00+10:00,2023-08-12,06:06,1,1,2
55,2023-08-12T05:56:00+10:00,2023-08-12,05:56,0,7,7
55,2023-08-12T06:06:00+10:00,2023-08-12,06:06,2,1,3
59,2023-08-12T05:55:00+10:00,2023-08-12,05:55,1,4,5
61,2023-08-12T05:56:00+10:00,2023-08-12,05:56,0,1,1
61,2023-08-12T06:03:00+10:00,2023-08-12,06:03,0,1,1
65,2023-08-12T05:59:00+10:00,2023-08-12,05:59,1,0,1
65,2023-08-12T06:00:00+10:00,2023-08-12,06:00,0,1,1
65,2023-08-12T06:03:00+10:00,2023-08-12,06:03,0,1,1
65,2023-08-12T06:06:00+10:00,2023-08-12,06:06,0,1,1
66,2023-08-12T05:56:00+10:00,2023-08-12,05:56,1,1,2
66,2023-08-12T06:04:00+10:00,2023-08-12,06:04,0,1,1
69,2023-08-12T06:06:00+10:00,2023-08-12,06:06,1,0,1
1,2023-08-12T05:57:00+10:00,2023-08-12,05:57,1,1,2
2,2023-08-12T05:55:00+10:00,2023-08-12,05:55,1,0,1
9,2023-08-12T06:03:00+10:00,2023-08-12,06:03,1,0,1
9,2023-08-12T06:06:00+10:00,2023-08-12,06:06,0,2,2
11,2023-08-12T06:05:00+10:00,2023-08-12,06:05,0,1,1
12,2023-08-12T06:04:00+10:00,2023-08-12,06:04,0,1,1
17,2023-08-12T05:55:00+10:00,2023-08-12,05:55,1,0,1
17,2023-08-12T06:05:00+10:00,2023-08-12,06:05,1,1,2
24,2023-08-12T05:57:00+10:00,2023-08-12,05:57,2,0,2
24,2023-08-12T06:03:00+10:00,2023-08-12,06:03,2,0,2
24,2023-08-12T06:08:00+10:00,2023-08-12,06:08,2,0,2
27,2023-08-12T05:57:00+10:00,2023-08-12,05:57,1,0,1
35,2023-08-12T05:59:00+10:00,2023-08-12,05:59,0,1,1
35,2023-08-12T06:00:00+10:00,2023-08-12,06:00,1,0,1
35,2023-08-12T06:05:00+10:00,2023-08-12,06:05,1,2,3
35,2023-08-12T06:06:00+10:00,2023-08-12,06:06,0,1,1
35,2023-08-12T06:09:00+10:00,2023-08-12,06:09,2,0,2
53,2023-08-12T06:08:00+10:00,2023-08-12,06:08,0,1,1
58,2023-08-12T05:56:00+10:00,2023-08-12,05:56,1,0,1
58,2023-08-12T05:58:00+10:00,2023-08-12,05:58,1,0,1
62,2023-08-12T05:58:00+10:00,2023-08-12,05:58,1,0,1
62,2023-08-12T06:05:00+10:00,2023-08-12,06:05,2,0,2
62,2023-08-12T06:07:00+10:00,2023-08-12,06:07,0,1,1
62,2023-08-12T06:08:00+10:00,2023-08-12,06:08,0,1,1
63,2023-08-12T06:07:00+10:00,2023-08-12,06:07,1,0,1
67,2023-08-12T06:05:00+10:00,2023-08-12,06:05,0,1,1
67,2023-08-12T06:07:00+10:00,2023-08-12,06:07,2,0,2
67,2023-08-12T06:08:00+10:00,2023-08-12,06:08,0,1,1
68,2023-08-12T06:08:00+10:00,2023-08-12,06:08,1,0,1
79,2023-08-12T06:00:00+10:00,2023-08-12,06:00,0,1,1
79,2023-08-12T06:02:00+10:00,2023-08-12,06:02,1,0,1
85,2023-08-12T05:56:00+10:00,2023-08-12,05:56,1,0,1
85,2023-08-12T06:08:00+10:00,2023-08-12,06:08,0,3,3
86,2023-08-12T06:09:00+10:00,2023-08-12,06:09,1,0,1
109,2023-08-12T05:55:00+10:00,2023-08-12,05:55,1,2,3
109,2023-08-12T06:00:00+10:00,2023-08-12,06:00,0,1,1
117,2023-08-12T06:00:00+10:00,2023-08-12,06:00,1,0,1
3,2023-08-12T06:13:00+10:00,2023-08-12,06:13,1,0,1
3,2023-08-12T06:15:00+10:00,2023-08-12,06:15,4,3,7
3,2023-08-12T06:17:00+10:00,2023-08-12,06:17,2,0,2
3,2023-08-12T06:20:00+10:00,2023-08-12,06:20,1,0,1
3,2023-08-12T06:22:00+10:00,2023-08-12,06:22,0,1,1
3,2023-08-12T06:23:00+10:00,2023-08-12,06:23,1,1,2
4,2023-08-12T06:12:00+10:00,2023-08-12,06:12,1,2,3
4,2023-08-12T06:20:00+10:00,2023-08-12,06:20,3,1,4
6,2023-08-12T06:14:00+10:00,2023-08-12,06:14,1,1,2
6,2023-08-12T06:17:00+10:00,2023-08-12,06:17,2,3,5
8,2023-08-12T06:24:00+10:00,2023-08-12,06:24,1,0,1
14,2023-08-12T06:19:00+10:00,2023-08-12,06:19,1,0,1
21,2023-08-12T06:10:00+10:00,2023-08-12,06:10,1,0,1
21,2023-08-12T06:19:00+10:00,2023-08-12,06:19,0,4,4
28,2023-08-12T06:19:00+10:00,2023-08-12,06:19,0,1,1
41,2023-08-12T06:11:00+10:00,2023-08-12,06:11,5,6,11
41,2023-08-12T06:13:00+10:00,2023-08-12,06:13,4,1,5
41,2023-08-12T06:15:00+10:00,2023-08-12,06:15,3,0,3
41,2023-08-12T06:17:00+10:00,2023-08-12,06:17,1,2,3
41,2023-08-12T06:19:00+10:00,2023-08-12,06:19,0,2,2
41,2023-08-12T06:20:00+10:00,2023-08-12,06:20,2,0,2
54,2023-08-12T06:24:00+10:00,2023-08-12,06:24,0,1,1
55,2023-08-12T06:14:00+10:00,2023-08-12,06:14,1,0,1
55,2023-08-12T06:17:00+10:00,2023-08-12,06:17,1,1,2
55,2023-08-12T06:22:00+10:00,2023-08-12,06:22,1,1,2
55,2023-08-12T06:24:00+10:00,2023-08-12,06:24,3,1,4
59,2023-08-12T06:10:00+10:00,2023-08-12,06:10,2,2,4
59,2023-08-12T06:15:00+10:00,2023-08-12,06:15,3,0,3
61,2023-08-12T06:11:00+10:00,2023-08-12,06:11,0,1,1
61,2023-08-12T06:12:00+10:00,2023-08-12,06:12,1,0,1
61,2023-08-12T06:15:00+10:00,2023-08-12,06:15,0,1,1
65,2023-08-12T06:10:00+10:00,2023-08-12,06:10,1,1,2
65,2023-08-12T06:17:00+10:00,2023-08-12,06:17,0,1,1
65,2023-08-12T06:21:00+10:00,2023-08-12,06:21,1,0,1
66,2023-08-12T06:23:00+10:00,2023-08-12,06:23,1,0,1
69,2023-08-12T06:22:00+10:00,2023-08-12,06:22,1,1,2
75,2023-08-12T06:11:00+10:00,2023-08-12,06:11,0,2,2
84,2023-08-12T06:10:00+10:00,2023-08-12,06:10,4,5,9
84,2023-08-12T06:20:00+10:00,2023-08-12,06:20,10,7,17
107,2023-08-12T06:10:00+10:00,2023-08-12,06:10,0,2,2
108,2023-08-12T06:11:00+10:00,2023-08-12,06:11,1,0,1
108,2023-08-12T06:24:00+10:00,2023-08-12,06:24,1,0,1
1,2023-08-12T06:17:00+10:00,2023-08-12,06:17,0,1,1
1,2023-08-12T06:19:00+10:00,2023-08-12,06:19,0,1,1
2,2023-08-12T06:16:00+10:00,2023-08-12,06:16,1,0,1
2,2023-08-12T06:22:00+10:00,2023-08-12,06:22,0,3,3
9,2023-08-12T06:15:00+10:00,2023-08-12,06:15,1,0,1
17,2023-08-12T06:12:00+10:00,2023-08-12,06:12,2,0,2
24,2023-08-12T06:11:00+10:00,2023-08-12,06:11,0,3,3
24,2023-08-12T06:13:00+10:00,2023-08-12,06:13,0,2,2
24,2023-08-12T06:14:00+10:00,2023-08-12,06:14,0,1,1
24,2023-08-12T06:16:00+10:00,2023-08-12,06:16,1,3,4
24,2023-08-12T06:19:00+10:00,2023-08-12,06:19,2,0,2
24,2023-08-12T06:20:00+10:00,2023-08-12,06:20,0,2,2
24,2023-08-12T06:23:00+10:00,2023-08-12,06:23,1,0,1
27,2023-08-12T06:13:00+10:00,2023-08-12,06:13,0,1,1
27,2023-08-12T06:14:00+10:00,2023-08-12,06:14,0,1,1
35,2023-08-12T06:16:00+10:00,2023-08-12,06:16,1,1,2
35,2023-08-12T06:18:00+10:00,2023-08-12,06:18,1,1,2
35,2023-08-12T06:19:00+10:00,2023-08-12,06:19,3,0,3
35,2023-08-12T06:22:00+10:00,2023-08-12,06:22,0,1,1
35,2023-08-12T06:24:00+10:00,2023-08-12,06:24,2,0,2
57,2023-08-12T06:21:00+10:00,2023-08-12,06:21,2,0,2
58,2023-08-12T06:14:00+10:00,2023-08-12,06:14,1,0,1
58,2023-08-12T06:17:00+10:00,2023-08-12,06:17,1,0,1
58,2023-08-12T06:24:00+10:00,2023-08-12,06:24,2,1,3
62,2023-08-12T06:12:00+10:00,2023-08-12,06:12,1,0,1
62,2023-08-12T06:18:00+10:00,2023-08-12,06:18,1,1,2
67,2023-08-12T06:11:00+10:00,2023-08-12,06:11,1,1,2
67,2023-08-12T06:15:00+10:00,2023-08-12,06:15,1,0,1
67,2023-08-12T06:16:00+10:00,2023-08-12,06:16,1,1,2
67,2023-08-12T06:17:00+10:00,2023-08-12,06:17,1,0,1
67,2023-08-12T06:24:00+10:00,2023-08-12,06:24,2,0,2
76,2023-08-12T06:10:00+10:00,2023-08-12,06:10,1,0,1
79,2023-08-12T06:10:00+10:00,2023-08-12,06:10,2,0,2
79,2023-08-12T06:11:00+10:00,2023-08-12,06:11,0,1,1
79,2023-08-12T06:12:00+10:00,2023-08-12,06:12,0,2,2
79,2023-08-12T06:14:00+10:00,2023-08-12,06:14,0,1,1
86,2023-08-12T06:11:00+10:00,2023-08-12,06:11,0,1,1
122,2023-08-12T06:20:00+10:00,2023-08-12,06:20,0,1,1
3,2023-08-12T06:26:00+10:00,2023-08-12,06:26,1,0,1
4,2023-08-12T06:31:00+10:00,2023-08-12,06:31,2,0,2
4,2023-08-12T06:33:00+10:00,2023-08-12,06:33,3,0,3
4,2023-08-12T06:35:00+10:00,2023-08-12,06:35,1,0,1
4,2023-08-12T06:39:00+10:00,2023-08-12,06:39,1,1,2
6,2023-08-12T06:25:00+10:00,2023-08-12,06:25,2,1,3
6,2023-08-12T06:28:00+10:00,2023-08-12,06:28,0,1,1
6,2023-08-12T06:36:00+10:00,2023-08-12,06:36,0,1,1
8,2023-08-12T06:37:00+10:00,2023-08-12,06:37,2,0,2
14,2023-08-12T06:26:00+10:00,2023-08-12,06:26,1,0,1
14,2023-08-12T06:28:00+10:00,2023-08-12,06:28,1,1,2
21,2023-08-12T06:26:00+10:00,2023-08-12,06:26,4,4,8
21,2023-08-12T06:30:00+10:00,2023-08-12,06:30,1,0,1
28,2023-08-12T06:36:00+10:00,2023-08-12,06:36,1,0,1
28,2023-08-12T06:37:00+10:00,2023-08-12,06:37,1,0,1
29,2023-08-12T06:25:00+10:00,2023-08-12,06:25,0,1,1
29,2023-08-12T06:28:00+10:00,2023-08-12,06:28,0,1,1
29,2023-08-12T06:32:00+10:00,2023-08-12,06:32,3,0,3
29,2023-08-12T06:33:00+10:00,2023-08-12,06:33,0,2,2
29,2023-08-12T06:34:00+10:00,2023-08-12,06:34,2,0,2
29,2023-08-12T06:38:00+10:00,2023-08-12,06:38,1,0,1
41,2023-08-12T06:29:00+10:00,2023-08-12,06:29,7,3,10
41,2023-08-12T06:30:00+10:00,2023-08-12,06:30,5,0,5
41,2023-08-12T06:32:00+10:00,2023-08-12,06:32,2,0,2
41,2023-08-12T06:38:00+10:00,2023-08-12,06:38,3,1,4
41,2023-08-12T06:39:00+10:00,2023-08-12,06:39,5,1,6
54,2023-08-12T06:26:00+10:00,2023-08-12,06:26,1,0,1
55,2023-08-12T06:25:00+10:00,2023-08-12,06:25,2,2,4
55,2023-08-12T06:26:00+10:00,2023-08-12,06:26,0,2,2
55,2023-08-12T06:27:00+10:00,2023-08-12,06:27,0,1,1
55,2023-08-12T06:29:00+10:00,2023-08-12,06:29,1,2,3
55,2023-08-12T06:30:00+10:00,2023-08-12,06:30,0,2,2
55,2023-08-12T06:31:00+10:00,2023-08-12,06:31,0,2,2
55,2023-08-12T06:38:00+10:00,2023-08-12,06:38,3,7,10
55,2023-08-12T06:39:00+10:00,2023-08-12,06:39,0,4,4
59,2023-08-12T06:30:00+10:00,2023-08-12,06:30,0,1,1
59,2023-08-12T06:35:00+10:00,2023-08-12,06:35,4,6,10
61,2023-08-12T06:25:00+10:00,2023-08-12,06:25,0,1,1
61,2023-08-12T06:27:00+10:00,2023-08-12,06:27,1,1,2
65,2023-08-12T06:29:00+10:00,2023-08-12,06:29,1,0,1
65,2023-08-12T06:30:00+10:00,2023-08-12,06:30,0,1,1
65,2023-08-12T06:31:00+10:00,2023-08-12,06:31,1,2,3
65,2023-08-12T06:38:00+10:00,2023-08-12,06:38,0,1,1
66,2023-08-12T06:32:00+10:00,2023-08-12,06:32,1,0,1
66,2023-08-12T06:39:00+10:00,2023-08-12,06:39,5,0,5
69,2023-08-12T06:34:00+10:00,2023-08-12,06:34,1,1,2
69,2023-08-12T06:35:00+10:00,2023-08-12,06:35,0,1,1
70,2023-08-12T06:27:00+10:00,2023-08-12,06:27,0,1,1
70,2023-08-12T06:32:00+10:00,2023-08-12,06:32,0,1,1
75,2023-08-12T06:25:00+10:00,2023-08-12,06:25,3,0,3
75,2023-08-12T06:30:00+10:00,2023-08-12,06:30,0,1,1
75,2023-08-12T06:35:00+10:00,2023-08-12,06:35,2,0,2
75,2023-08-12T06:39:00+10:00,2023-08-12,06:39,1,0,1
77,2023-08-12T06:35:00+10:00,2023-08-12,06:35,1,0,1
77,2023-08-12T06:36:00+10:00,2023-08-12,06:36,0,2,2
84,2023-08-12T06:30:00+10:00,2023-08-12,06:30,8,3,11
84,2023-08-12T06:35:00+10:00,2023-08-12,06:35,7,13,20
108,2023-08-12T06:36:00+10:00,2023-08-12,06:36,1,2,3
108,2023-08-12T06:38:00+10:00,2023-08-12,06:38,0,2,2
118,2023-08-12T06:35:00+10:00,2023-08-12,06:35,1,0,1
1,2023-08-12T06:33:00+10:00,2023-08-12,06:33,0,2,2
1,2023-08-12T06:37:00+10:00,2023-08-12,06:37,2,0,2
2,2023-08-12T06:35:00+10:00,2023-08-12,06:35,0,1,1
2,2023-08-12T06:36:00+10:00,2023-08-12,06:36,0,2,2
7,2023-08-12T06:28:00+10:00,2023-08-12,06:28,1,1,2
9,2023-08-12T06:31:00+10:00,2023-08-12,06:31,2,0,2
9,2023-08-12T06:37:00+10:00,2023-08-12,06:37,1,0,1
12,2023-08-12T06:36:00+10:00,2023-08-12,06:36,0,1,1
12,2023-08-12T06:38:00+10:00,2023-08-12,06:38,0,1,1
17,2023-08-12T06:28:00+10:00,2023-08-12,06:28,2,0,2
17,2023-08-12T06:36:00+10:00,2023-08-12,06:36,0,1,1
17,2023-08-12T06:38:00+10:00,2023-08-12,06:38,1,0,1
18,2023-08-12T06:28:00+10:00,2023-08-12,06:28,0,1,1
24,2023-08-12T06:28:00+10:00,2023-08-12,06:28,0,1,1
24,2023-08-12T06:29:00+10:00,2023-08-12,06:29,1,3,4
24,2023-08-12T06:30:00+10:00,2023-08-12,06:30,0,3,3
24,2023-08-12T06:32:00+10:00,2023-08-12,06:32,0,1,1
24,2023-08-12T06:34:00+10:00,2023-08-12,06:34,0,2,2
24,2023-08-12T06:37:00+10:00,2023-08-12,06:37,1,0,1
24,2023-08-12T06:38:00+10:00,2023-08-12,06:38,5,0,5
27,2023-08-12T06:28:00+10:00,2023-08-12,06:28,1,0,1
35,2023-08-12T06:25:00+10:00,2023-08-12,06:25,0,2,2
35,2023-08-12T06:30:00+10:00,2023-08-12,06:30,2,1,3
35,2023-08-12T06:33:00+10:00,2023-08-12,06:33,2,1,3
35,2023-08-12T06:35:00+10:00,2023-08-12,06:35,1,0,1
35,2023-08-12T06:38:00+10:00,2023-08-12,06:38,1,1,2
53,2023-08-12T06:27:00+10:00,2023-08-12,06:27,2,0,2
56,2023-08-12T06:36:00+10:00,2023-08-12,06:36,1,0,1
56,2023-08-12T06:38:00+10:00,2023-08-12,06:38,1,1,2
57,2023-08-12T06:26:00+10:00,2023-08-12,06:26,1,0,1
58,2023-08-12T06:31:00+10:00,2023-08-12,06:31,0,1,1
58,2023-08-12T06:34:00+10:00,2023-08-12,06:34,2,0,2
58,2023-08-12T06:36:00+10:00,2023-08-12,06:36,1,2,3
58,2023-08-12T06:37:00+10:00,2023-08-12,06:37,5,2,7
58,2023-08-12T06:38:00+10:00,2023-08-12,06:38,10,0,10
62,2023-08-12T06:26:00+10:00,2023-08-12,06:26,1,0,1
62,2023-08-12T06:28:00+10:00,2023-08-12,06:28,3,0,3
62,2023-08-12T06:39:00+10:00,2023-08-12,06:39,1,1,2
63,2023-08-12T06:31:00+10:00,2023-08-12,06:31,1,0,1
67,2023-08-12T06:27:00+10:00,2023-08-12,06:27,0,1,1
67,2023-08-12T06:37:00+10:00,2023-08-12,06:37,0,1,1
72,2023-08-12T06:39:00+10:00,2023-08-12,06:39,2,1,3
79,2023-08-12T06:28:00+10:00,2023-08-12,06:28,2,1,3
79,2023-08-12T06:29:00+10:00,2023-08-12,06:29,2,0,2
79,2023-08-12T06:39:00+10:00,2023-08-12,06:39,1,0,1
117,2023-08-12T06:25:00+10:00,2023-08-12,06:25,1,3,4
117,2023-08-12T06:35:00+10:00,2023-08-12,06:35,1,3,4
122,2023-08-12T06:34:00+10:00,2023-08-12,06:34,2,0,2
3,2023-08-12T06:54:00+10:00,2023-08-12,06:54,0,3,3
4,2023-08-12T06:46:00+10:00,2023-08-12,06:46,3,0,3
4,2023-08-12T06:48:00+10:00,2023-08-12,06:48,0,2,2
4,2023-08-12T06:49:00+10:00,2023-08-12,06:49,1,0,1
6,2023-08-12T06:41:00+10:00,2023-08-12,06:41,2,1,3
6,2023-08-12T06:43:00+10:00,2023-08-12,06:43,0,4,4
6,2023-08-12T06:45:00+10:00,2023-08-12,06:45,0,2,2
6,2023-08-12T06:51:00+10:00,2023-08-12,06:51,1,1,2
6,2023-08-12T06:53:00+10:00,2023-08-12,06:53,0,1,1
6,2023-08-12T06:54:00+10:00,2023-08-12,06:54,0,2,2
8,2023-08-12T06:52:00+10:00,2023-08-12,06:52,1,0,1
14,2023-08-12T06:41:00+10:00,2023-08-12,06:41,1,0,1
14,2023-08-12T06:43:00+10:00,2023-08-12,06:43,0,1,1
14,2023-08-12T06:46:00+10:00,2023-08-12,06:46,0,7,7
14,2023-08-12T06:47:00+10:00,2023-08-12,06:47,2,1,3
14,2023-08-12T06:51:00+10:00,2023-08-12,06:51,2,1,3
21,2023-08-12T06:41:00+10:00,2023-08-12,06:41,1,2,3
28,2023-08-12T06:42:00+10:00,2023-08-12,06:42,0,1,1
28,2023-08-12T06:50:00+10:00,2023-08-12,06:50,2,0,2
28,2023-08-12T06:52:00+10:00,2023-08-12,06:52,1,2,3
28,2023-08-12T06:53:00+10:00,2023-08-12,06:53,0,1,1
29,2023-08-12T06:40:00+10:00,2023-08-12,06:40,0,1,1
29,2023-08-12T06:44:00+10:00,2023-08-12,06:44,0,1,1
29,2023-08-12T06:50:00+10:00,2023-08-12,06:50,1,0,1
29,2023-08-12T06:53:00+10:00,2023-08-12,06:53,4,1,5
39,2023-08-12T06:48:00+10:00,2023-08-12,06:48,1,0,1
41,2023-08-12T06:43:00+10:00,2023-08-12,06:43,12,5,17
41,2023-08-12T06:44:00+10:00,2023-08-12,06:44,11,4,15
41,2023-08-12T06:54:00+10:00,2023-08-12,06:54,3,3,6
54,2023-08-12T06:41:00+10:00,2023-08-12,06:41,1,0,1
55,2023-08-12T06:43:00+10:00,2023-08-12,06:43,1,2,3
55,2023-08-12T06:53:00+10:00,2023-08-12,06:53,0,1,1
55,2023-08-12T06:54:00+10:00,2023-08-12,06:54,1,0,1
59,2023-08-12T06:45:00+10:00,2023-08-12,06:45,3,0,3
59,2023-08-12T06:50:00+10:00,2023-08-12,06:50,2,1,3
61,2023-08-12T06:44:00+10:00,2023-08-12,06:44,1,0,1
61,2023-08-12T06:48:00+10:00,2023-08-12,06:48,0,1,1
61,2023-08-12T06:51:00+10:00,2023-08-12,06:51,0,1,1
65,2023-08-12T06:40:00+10:00,2023-08-12,06:40,0,1,1
65,2023-08-12T06:44:00+10:00,2023-08-12,06:44,0,5,5
65,2023-08-12T06:53:00+10:00,2023-08-12,06:53,1,0,1
66,2023-08-12T06:44:00+10:00,2023-08-12,06:44,0,2,2
66,2023-08-12T06:50:00+10:00,2023-08-12,06:50,0,3,3
66,2023-08-12T06:51:00+10:00,2023-08-12,06:51,0,1,1
66,2023-08-12T06:52:00+10:00,2023-08-12,06:52,0,1,1
75,2023-08-12T06:40:00+10:00,2023-08-12,06:40,0,1,1
75,2023-08-12T06:46:00+10:00,2023-08-12,06:46,0,1,1
75,2023-08-12T06:47:00+10:00,2023-08-12,06:47,1,1,2
75,2023-08-12T06:49:00+10:00,2023-08-12,06:49,1,0,1
77,2023-08-12T06:40:00+10:00,2023-08-12,06:40,1,0,1
77,2023-08-12T06:54:00+10:00,2023-08-12,06:54,0,1,1
78,2023-08-12T06:48:00+10:00,2023-08-12,06:48,0,1,1
84,2023-08-12T06:45:00+10:00,2023-08-12,06:45,4,8,12
108,2023-08-12T06:44:00+10:00,2023-08-12,06:44,0,1,1
108,2023-08-12T06:45:00+10:00,2023-08-12,06:45,0,1,1
108,2023-08-12T06:46:00+10:00,2023-08-12,06:46,1,1,2
108,2023-08-12T06:52:00+10:00,2023-08-12,06:52,0,1,1
1,2023-08-12T06:46:00+10:00,2023-08-12,06:46,1,0,1
1,2023-08-12T06:54:00+10:00,2023-08-12,06:54,2,0,2
2,2023-08-12T06:53:00+10:00,2023-08-12,06:53,2,2,4
2,2023-08-12T06:54:00+10:00,2023-08-12,06:54,0,2,2
9,2023-08-12T06:40:00+10:00,2023-08-12,06:40,1,0,1
9,2023-08-12T06:45:00+10:00,2023-08-12,06:45,1,0,1
9,2023-08-12T06:50:00+10:00,2023-08-12,06:50,1,0,1
9,2023-08-12T06:52:00+10:00,2023-08-12,06:52,1,2,3
10,2023-08-12T06:51:00+10:00,2023-08-12,06:51,1,0,1
11,2023-08-12T06:50:00+10:00,2023-08-12,06:50,1,1,2
12,2023-08-12T06:42:00+10:00,2023-08-12,06:42,0,1,1
12,2023-08-12T06:45:00+10:00,2023-08-12,06:45,0,2,2
12,2023-08-12T06:47:00+10:00,2023-08-12,06:47,1,0,1
12,2023-08-12T06:50:00+10:00,2023-08-12,06:50,0,1,1
12,2023-08-12T06:51:00+10:00,2023-08-12,06:51,1,0,1
17,2023-08-12T06:43:00+10:00,2023-08-12,06:43,1,0,1
17,2023-08-12T06:49:00+10:00,2023-08-12,06:49,1,0,1
17,2023-08-12T06:52:00+10:00,2023-08-12,06:52,0,2,2
17,2023-08-12T06:54:00+10:00,2023-08-12,06:54,0,1,1
24,2023-08-12T06:40:00+10:00,2023-08-12,06:40,2,4,6
24,2023-08-12T06:45:00+10:00,2023-08-12,06:45,1,1,2
24,2023-08-12T06:52:00+10:00,2023-08-12,06:52,2,1,3
35,2023-08-12T06:44:00+10:00,2023-08-12,06:44,2,2,4
35,2023-08-12T06:47:00+10:00,2023-08-12,06:47,3,2,5
35,2023-08-12T06:48:00+10:00,2023-08-12,06:48,2,1,3
35,2023-08-12T06:50:00+10:00,2023-08-12,06:50,1,1,2
56,2023-08-12T06:43:00+10:00,2023-08-12,06:43,0,1,1
56,2023-08-12T06:45:00+10:00,2023-08-12,06:45,1,0,1
56,2023-08-12T06:47:00+10:00,2023-08-12,06:47,1,2,3
57,2023-08-12T06:43:00+10:00,2023-08-12,06:43,2,0,2
57,2023-08-12T06:46:00+10:00,2023-08-12,06:46,2,2,4
57,2023-08-12T06:49:00+10:00,2023-08-12,06:49,0,1,1
58,2023-08-12T06:42:00+10:00,2023-08-12,06:42,3,0,3
58,2023-08-12T06:45:00+10:00,2023-08-12,06:45,0,2,2
58,2023-08-12T06:47:00+10:00,2023-08-12,06:47,1,0,1
62,2023-08-12T06:44:00+10:00,2023-08-12,06:44,2,3,5
62,2023-08-12T06:51:00+10:00,2023-08-12,06:51,1,2,3
62,2023-08-12T06:52:00+10:00,2023-08-12,06:52,6,1,7
67,2023-08-12T06:40:00+10:00,2023-08-12,06:40,0,1,1
67,2023-08-12T06:41:00+10:00,2023-08-12,06:41,1,0,1
67,2023-08-12T06:46:00+10:00,2023-08-12,06:46,0,1,1
67,2023-08-12T06:49:00+10:00,2023-08-12,06:49,1,4,5
72,2023-08-12T06:46:00+10:00,2023-08-12,06:46,1,0,1
72,2023-08-12T06:52:00+10:00,2023-08-12,06:52,1,2,3
76,2023-08-12T06:52:00+10:00,2023-08-12,06:52,1,0,1
79,2023-08-12T06:41:00+10:00,2023-08-12,06:41,8,3,11
79,2023-08-12T06:43:00+10:00,2023-08-12,06:43,0,1,1
79,2023-08-12T06:47:00+10:00,2023-08-12,06:47,2,1,3
79,2023-08-12T06:50:00+10:00,2023-08-12,06:50,1,2,3
86,2023-08-12T06:44:00+10:00,2023-08-12,06:44,1,1,2
122,2023-08-12T06:48:00+10:00,2023-08-12,06:48,1,0,1
3,2023-08-12T06:55:00+10:00,2023-08-12,06:55,2,1,3
3,2023-08-12T06:58:00+10:00,2023-08-12,06:58,0,2,2
4,2023-08-12T06:55:00+10:00,2023-08-12,06:55,2,0,2
4,2023-08-12T07:05:00+10:00,2023-08-12,07:05,1,0,1
4,2023-08-12T07:08:00+10:00,2023-08-12,07:08,0,1,1
4,2023-08-12T07:09:00+10:00,2023-08-12,07:09,0,1,1
6,2023-08-12T06:55:00+10:00,2023-08-12,06:55,1,0,1
6,2023-08-12T06:57:00+10:00,2023-08-12,06:57,0,3,3
6,2023-08-12T06:59:00+10:00,2023-08-12,06:59,2,2,4
6,2023-08-12T07:04:00+10:00,2023-08-12,07:04,0,1,1
6,2023-08-12T07:09:00+10:00,2023-08-12,07:09,3,1,4
8,2023-08-12T07:02:00+10:00,2023-08-12,07:02,0,2,2
14,2023-08-12T07:03:00+10:00,2023-08-12,07:03,1,1,2
14,2023-08-12T07:05:00+10:00,2023-08-12,07:05,1,0,1
14,2023-08-12T07:06:00+10:00,2023-08-12,07:06,1,0,1
14,2023-08-12T07:07:00+10:00,2023-08-12,07:07,1,0,1
14,2023-08-12T07:09:00+10:00,2023-08-12,07:09,2,1,3
21,2023-08-12T06:58:00+10:00,2023-08-12,06:58,0,5,5
21,2023-08-12T07:00:00+10:00,2023-08-12,07:00,2,1,3
21,2023-08-12T07:02:00+10:00,2023-08-12,07:02,0,1,1
28,2023-08-12T07:06:00+10:00,2023-08-12,07:06,0,4,4
29,2023-08-12T06:57:00+10:00,2023-08-12,06:57,0,2,2
29,2023-08-12T06:58:00+10:00,2023-08-12,06:58,0,1,1
29,2023-08-12T07:06:00+10:00,2023-08-12,07:06,4,1,5
29,2023-08-12T07:09:00+10:00,2023-08-12,07:09,0,2,2
41,2023-08-12T07:01:00+10:00,2023-08-12,07:01,4,4,8
41,2023-08-12T07:03:00+10:00,2023-08-12,07:03,4,2,6
55,2023-08-12T06:55:00+10:00,2023-08-12,06:55,0,1,1
55,2023-08-12T06:59:00+10:00,2023-08-12,06:59,1,4,5
55,2023-08-12T07:01:00+10:00,2023-08-12,07:01,7,4,11
55,2023-08-12T07:04:00+10:00,2023-08-12,07:04,0,2,2
55,2023-08-12T07:05:00+10:00,2023-08-12,07:05,1,1,2
55,2023-08-12T07:09:00+10:00,2023-08-12,07:09,1,0,1
59,2023-08-12T06:55:00+10:00,2023-08-12,06:55,3,1,4
61,2023-08-12T06:58:00+10:00,2023-08-12,06:58,1,0,1
61,2023-08-12T07:00:00+10:00,2023-08-12,07:00,0,1,1
61,2023-08-12T07:03:00+10:00,2023-08-12,07:03,0,2,2
65,2023-08-12T06:58:00+10:00,2023-08-12,06:58,0,3,3
65,2023-08-12T07:00:00+10:00,2023-08-12,07:00,1,0,1
66,2023-08-12T06:57:00+10:00,2023-08-12,06:57,0,1,1
66,2023-08-12T07:04:00+10:00,2023-08-12,07:04,0,1,1
66,2023-08-12T07:05:00+10:00,2023-08-12,07:05,0,2,2
66,2023-08-12T07:06:00+10:00,2023-08-12,07:06,0,1,1
70,2023-08-12T06:55:00+10:00,2023-08-12,06:55,0,1,1
70,2023-08-12T07:01:00+10:00,2023-08-12,07:01,2,0,2
71,2023-08-12T07:03:00+10:00,2023-08-12,07:03,1,0,1
75,2023-08-12T07:02:00+10:00,2023-08-12,07:02,1,0,1
77,2023-08-12T06:57:00+10:00,2023-08-12,06:57,1,0,1
77,2023-08-12T07:01:00+10:00,2023-08-12,07:01,0,1,1
77,2023-08-12T07:05:00+10:00,2023-08-12,07:05,1,0,1
77,2023-08-12T07:06:00+10:00,2023-08-12,07:06,1,0,1
87,2023-08-12T06:58:00+10:00,2023-08-12,06:58,1,0,1
87,2023-08-12T07:00:00+10:00,2023-08-12,07:00,0,1,1
107,2023-08-12T06:55:00+10:00,2023-08-12,06:55,0,4,4
107,2023-08-12T07:00:00+10:00,2023-08-12,07:00,1,2,3
108,2023-08-12T07:07:00+10:00,2023-08-12,07:07,1,0,1
1,2023-08-12T07:00:00+10:00,2023-08-12,07:00,0,1,1
2,2023-08-12T06:58:00+10:00,2023-08-12,06:58,0,1,1
2,2023-08-12T07:09:00+10:00,2023-08-12,07:09,1,1,2
7,2023-08-12T06:59:00+10:00,2023-08-12,06:59,1,0,1
7,2023-08-12T07:06:00+10:00,2023-08-12,07:06,1,0,1
9,2023-08-12T06:56:00+10:00,2023-08-12,06:56,1,0,1
10,2023-08-12T07:03:00+10:00,2023-08-12,07:03,0,1,1
11,2023-08-12T07:00:00+10:00,2023-08-12,07:00,1,3,4
12,2023-08-12T06:59:00+10:00,2023-08-12,06:59,1,0,1
12,2023-08-12T07:03:00+10:00,2023-08-12,07:03,0,3,3
12,2023-08-12T07:05:00+10:00,2023-08-12,07:05,0,3,3
17,2023-08-12T06:55:00+10:00,2023-08-12,06:55,1,0,1
17,2023-08-12T07:02:00+10:00,2023-08-12,07:02,1,0,1
17,2023-08-12T07:05:00+10:00,2023-08-12,07:05,1,1,2
18,2023-08-12T06:55:00+10:00,2023-08-12,06:55,0,1,1
18,2023-08-12T07:07:00+10:00,2023-08-12,07:07,2,0,2
24,2023-08-12T06:55:00+10:00,2023-08-12,06:55,1,3,4
24,2023-08-12T06:58:00+10:00,2023-08-12,06:58,0,1,1
24,2023-08-12T06:59:00+10:00,2023-08-12,06:59,0,1,1
24,2023-08-12T07:05:00+10:00,2023-08-12,07:05,0,3,3
24,2023-08-12T07:07:00+10:00,2023-08-12,07:07,1,0,1
27,2023-08-12T07:03:00+10:00,2023-08-12,07:03,0,1,1
27,2023-08-12T07:04:00+10:00,2023-08-12,07:04,1,0,1
27,2023-08-12T07:05:00+10:00,2023-08-12,07:05,3,0,3
35,2023-08-12T06:55:00+10:00,2023-08-12,06:55,3,1,4
35,2023-08-12T06:57:00+10:00,2023-08-12,06:57,4,0,4
35,2023-08-12T06:58:00+10:00,2023-08-12,06:58,2,2,4
35,2023-08-12T06:59:00+10:00,2023-08-12,06:59,4,1,5
35,2023-08-12T07:00:00+10:00,2023-08-12,07:00,4,1,5
35,2023-08-12T07:03:00+10:00,2023-08-12,07:03,3,0,3
35,2023-08-12T07:06:00+10:00,2023-08-12,07:06,3,0,3
35,2023-08-12T07:07:00+10:00,2023-08-12,07:07,1,0,1
53,2023-08-12T07:03:00+10:00,2023-08-12,07:03,1,0,1
53,2023-08-12T07:08:00+10:00,2023-08-12,07:08,1,0,1
56,2023-08-12T07:05:00+10:00,2023-08-12,07:05,3,0,3
57,2023-08-12T07:05:00+10:00,2023-08-12,07:05,0,1,1
58,2023-08-12T06:55:00+10:00,2023-08-12,06:55,1,0,1
58,2023-08-12T07:01:00+10:00,2023-08-12,07:01,2,0,2
58,2023-08-12T07:04:00+10:00,2023-08-12,07:04,2,0,2
58,2023-08-12T07:05:00+10:00,2023-08-12,07:05,3,0,3
63,2023-08-12T07:05:00+10:00,2023-08-12,07:05,0,1,1
67,2023-08-12T06:56:00+10:00,2023-08-12,06:56,0,1,1
67,2023-08-12T06:58:00+10:00,2023-08-12,06:58,4,0,4
67,2023-08-12T07:02:00+10:00,2023-08-12,07:02,3,0,3
67,2023-08-12T07:07:00+10:00,2023-08-12,07:07,0,1,1
72,2023-08-12T06:58:00+10:00,2023-08-12,06:58,0,2,2
72,2023-08-12T07:03:00+10:00,2023-08-12,07:03,2,0,2
72,2023-08-12T07:04:00+10:00,2023-08-12,07:04,0,1,1
72,2023-08-12T07:07:00+10:00,2023-08-12,07:07,1,0,1
76,2023-08-12T06:57:00+10:00,2023-08-12,06:57,0,3,3
76,2023-08-12T07:00:00+10:00,2023-08-12,07:00,1,0,1
79,2023-08-12T06:55:00+10:00,2023-08-12,06:55,1,0,1
79,2023-08-12T07:00:00+10:00,2023-08-12,07:00,1,0,1
79,2023-08-12T07:04:00+10:00,2023-08-12,07:04,1,0,1
79,2023-08-12T07:07:00+10:00,2023-08-12,07:07,1,1,2
85,2023-08-12T07:09:00+10:00,2023-08-12,07:09,1,1,2
86,2023-08-12T07:04:00+10:00,2023-08-12,07:04,1,0,1
86,2023-08-12T07:07:00+10:00,2023-08-12,07:07,0,1,1
109,2023-08-12T07:05:00+10:00,2023-08-12,07:05,2,0,2
117,2023-08-12T07:00:00+10:00,2023-08-12,07:00,1,0,1
122,2023-08-12T06:58:00+10:00,2023-08-12,06:58,0,1,1
122,2023-08-12T07:04:00+10:00,2023-08-12,07:04,0,2,2
3,2023-08-12T07:18:00+10:00,2023-08-12,07:18,0,1,1
3,2023-08-12T07:24:00+10:00,2023-08-12,07:24,0,1,1
4,2023-08-12T07:15:00+10:00,2023-08-12,07:15,6,2,8
4,2023-08-12T07:16:00+10:00,2023-08-12,07:16,1,1,2
4,2023-08-12T07:17:00+10:00,2023-08-12,07:17,5,1,6
4,2023-08-12T07:22:00+10:00,2023-08-12,07:22,0,1,1
6,2023-08-12T07:12:00+10:00,2023-08-12,07:12,1,0,1
6,2023-08-12T07:15:00+10:00,2023-08-12,07:15,0,2,2
6,2023-08-12T07:18:00+10:00,2023-08-12,07:18,1,2,3
6,2023-08-12T07:21:00+10:00,2023-08-12,07:21,1,0,1
6,2023-08-12T07:23:00+10:00,2023-08-12,07:23,2,0,2
6,2023-08-12T07:24:00+10:00,2023-08-12,07:24,0,2,2
14,2023-08-12T07:10:00+10:00,2023-08-12,07:10,1,1,2
14,2023-08-12T07:14:00+10:00,2023-08-12,07:14,1,2,3
14,2023-08-12T07:20:00+10:00,2023-08-12,07:20,4,0,4
21,2023-08-12T07:19:00+10:00,2023-08-12,07:19,0,2,2
21,2023-08-12T07:24:00+10:00,2023-08-12,07:24,2,0,2
29,2023-08-12T07:15:00+10:00,2023-08-12,07:15,1,0,1
29,2023-08-12T07:17:00+10:00,2023-08-12,07:17,0,1,1
29,2023-08-12T07:20:00+10:00,2023-08-12,07:20,0,3,3
39,2023-08-12T07:15:00+10:00,2023-08-12,07:15,1,0,1
39,2023-08-12T07:18:00+10:00,2023-08-12,07:18,1,0,1
39,2023-08-12T07:24:00+10:00,2023-08-12,07:24,1,0,1
41,2023-08-12T07:11:00+10:00,2023-08-12,07:11,10,2,12
41,2023-08-12T07:17:00+10:00,2023-08-12,07:17,1,6,7
41,2023-08-12T07:18:00+10:00,2023-08-12,07:18,0,3,3
41,2023-08-12T07:20:00+10:00,2023-08-12,07:20,6,2,8
41,2023-08-12T07:24:00+10:00,2023-08-12,07:24,2,1,3
54,2023-08-12T07:13:00+10:00,2023-08-12,07:13,1,0,1
54,2023-08-12T07:24:00+10:00,2023-08-12,07:24,1,0,1
55,2023-08-12T07:12:00+10:00,2023-08-12,07:12,0,6,6
55,2023-08-12T07:17:00+10:00,2023-08-12,07:17,0,3,3
55,2023-08-12T07:21:00+10:00,2023-08-12,07:21,4,3,7
59,2023-08-12T07:15:00+10:00,2023-08-12,07:15,3,2,5
59,2023-08-12T07:20:00+10:00,2023-08-12,07:20,1,1,2
61,2023-08-12T07:15:00+10:00,2023-08-12,07:15,0,3,3
61,2023-08-12T07:20:00+10:00,2023-08-12,07:20,2,0,2
65,2023-08-12T07:12:00+10:00,2023-08-12,07:12,0,1,1
65,2023-08-12T07:16:00+10:00,2023-08-12,07:16,1,0,1
65,2023-08-12T07:17:00+10:00,2023-08-12,07:17,0,1,1
65,2023-08-12T07:20:00+10:00,2023-08-12,07:20,2,1,3
66,2023-08-12T07:10:00+10:00,2023-08-12,07:10,2,0,2
66,2023-08-12T07:13:00+10:00,2023-08-12,07:13,0,1,1
69,2023-08-12T07:17:00+10:00,2023-08-12,07:17,2,0,2
70,2023-08-12T07:20:00+10:00,2023-08-12,07:20,0,1,1
75,2023-08-12T07:18:00+10:00,2023-08-12,07:18,4,0,4
75,2023-08-12T07:20:00+10:00,2023-08-12,07:20,0,1,1
77,2023-08-12T07:12:00+10:00,2023-08-12,07:12,1,0,1
77,2023-08-12T07:14:00+10:00,2023-08-12,07:14,1,0,1
77,2023-08-12T07:16:00+10:00,2023-08-12,07:16,0,1,1
77,2023-08-12T07:17:00+10:00,2023-08-12,07:17,0,1,1
78,2023-08-12T07:10:00+10:00,2023-08-12,07:10,0,1,1
84,2023-08-12T07:10:00+10:00,2023-08-12,07:10,5,6,11
84,2023-08-12T07:15:00+10:00,2023-08-12,07:15,6,5,11
84,2023-08-12T07:20:00+10:00,2023-08-12,07:20,10,6,16
87,2023-08-12T07:14:00+10:00,2023-08-12,07:14,2,1,3
87,2023-08-12T07:19:00+10:00,2023-08-12,07:19,0,2,2
107,2023-08-12T07:20:00+10:00,2023-08-12,07:20,0,2,2
108,2023-08-12T07:10:00+10:00,2023-08-12,07:10,0,2,2
108,2023-08-12T07:13:00+10:00,2023-08-12,07:13,0,1,1
1,2023-08-12T07:24:00+10:00,2023-08-12,07:24,3,0,3
7,2023-08-12T07:14:00+10:00,2023-08-12,07:14,2,0,2
7,2023-08-12T07:16:00+10:00,2023-08-12,07:16,0,1,1
9,2023-08-12T07:17:00+10:00,2023-08-12,07:17,1,0,1
9,2023-08-12T07:23:00+10:00,2023-08-12,07:23,1,1,2
11,2023-08-12T07:10:00+10:00,2023-08-12,07:10,0,1,1
11,2023-08-12T07:20:00+10:00,2023-08-12,07:20,4,1,5
12,2023-08-12T07:12:00+10:00,2023-08-12,07:12,5,1,6
12,2023-08-12T07:16:00+10:00,2023-08-12,07:16,0,1,1
12,2023-08-12T07:19:00+10:00,2023-08-12,07:19,2,0,2
12,2023-08-12T07:20:00+10:00,2023-08-12,07:20,1,0,1
17,2023-08-12T07:10:00+10:00,2023-08-12,07:10,0,1,1
17,2023-08-12T07:21:00+10:00,2023-08-12,07:21,1,2,3
17,2023-08-12T07:23:00+10:00,2023-08-12,07:23,1,0,1
18,2023-08-12T07:24:00+10:00,2023-08-12,07:24,1,0,1
24,2023-08-12T07:18:00+10:00,2023-08-12,07:18,3,2,5
24,2023-08-12T07:19:00+10:00,2023-08-12,07:19,6,1,7
24,2023-08-12T07:20:00+10:00,2023-08-12,07:20,2,3,5
27,2023-08-12T07:18:00+10:00,2023-08-12,07:18,1,0,1
35,2023-08-12T07:17:00+10:00,2023-08-12,07:17,5,2,7
35,2023-08-12T07:22:00+10:00,2023-08-12,07:22,1,0,1
35,2023-08-12T07:24:00+10:00,2023-08-12,07:24,3,3,6
53,2023-08-12T07:11:00+10:00,2023-08-12,07:11,0,1,1
56,2023-08-12T07:18:00+10:00,2023-08-12,07:18,1,0,1
56,2023-08-12T07:19:00+10:00,2023-08-12,07:19,1,0,1
56,2023-08-12T07:22:00+10:00,2023-08-12,07:22,1,0,1
57,2023-08-12T07:19:00+10:00,2023-08-12,07:19,2,1,3
57,2023-08-12T07:22:00+10:00,2023-08-12,07:22,1,0,1
57,2023-08-12T07:24:00+10:00,2023-08-12,07:24,0,1,1
58,2023-08-12T07:11:00+10:00,2023-08-12,07:11,4,2,6
58,2023-08-12T07:14:00+10:00,2023-08-12,07:14,1,0,1
58,2023-08-12T07:18:00+10:00,2023-08-12,07:18,3,0,3
58,2023-08-12T07:19:00+10:00,2023-08-12,07:19,6,1,7
58,2023-08-12T07:24:00+10:00,2023-08-12,07:24,1,0,1
62,2023-08-12T07:15:00+10:00,2023-08-12,07:15,0,1,1
62,2023-08-12T07:17:00+10:00,2023-08-12,07:17,1,1,2
62,2023-08-12T07:18:00+10:00,2023-08-12,07:18,1,4,5
62,2023-08-12T07:21:00+10:00,2023-08-12,07:21,2,0,2
63,2023-08-12T07:10:00+10:00,2023-08-12,07:10,1,0,1
63,2023-08-12T07:16:00+10:00,2023-08-12,07:16,1,0,1
63,2023-08-12T07:18:00+10:00,2023-08-12,07:18,1,0,1
63,2023-08-12T07:22:00+10:00,2023-08-12,07:22,1,0,1
63,2023-08-12T07:24:00+10:00,2023-08-12,07:24,1,0,1
67,2023-08-12T07:11:00+10:00,2023-08-12,07:11,3,0,3
67,2023-08-12T07:14:00+10:00,2023-08-12,07:14,1,0,1
72,2023-08-12T07:22:00+10:00,2023-08-12,07:22,1,2,3
76,2023-08-12T07:16:00+10:00,2023-08-12,07:16,1,0,1
76,2023-08-12T07:24:00+10:00,2023-08-12,07:24,0,1,1
79,2023-08-12T07:13:00+10:00,2023-08-12,07:13,1,0,1
79,2023-08-12T07:15:00+10:00,2023-08-12,07:15,3,0,3
79,2023-08-12T07:16:00+10:00,2023-08-12,07:16,0,1,1
79,2023-08-12T07:21:00+10:00,2023-08-12,07:21,2,1,3
85,2023-08-12T07:17:00+10:00,2023-08-12,07:17,0,1,1
86,2023-08-12T07:19:00+10:00,2023-08-12,07:19,1,0,1
86,2023-08-12T07:22:00+10:00,2023-08-12,07:22,0,1,1
86,2023-08-12T07:24:00+10:00,2023-08-12,07:24,1,0,1
117,2023-08-12T07:15:00+10:00,2023-08-12,07:15,2,1,3
122,2023-08-12T07:12:00+10:00,2023-08-12,07:12,0,1,1
3,2023-08-12T07:25:00+10:00,2023-08-12,07:25,0,1,1
3,2023-08-12T07:30:00+10:00,2023-08-12,07:30,2,1,3
3,2023-08-12T07:31:00+10:00,2023-08-12,07:31,0,2,2
3,2023-08-12T07:32:00+10:00,2023-08-12,07:32,0,2,2
3,2023-08-12T07:37:00+10:00,2023-08-12,07:37,0,5,5
4,2023-08-12T07:29:00+10:00,2023-08-12,07:29,0,2,2
4,2023-08-12T07:30:00+10:00,2023-08-12,07:30,2,1,3
4,2023-08-12T07:31:00+10:00,2023-08-12,07:31,1,3,4
4,2023-08-12T07:38:00+10:00,2023-08-12,07:38,2,1,3
6,2023-08-12T07:31:00+10:00,2023-08-12,07:31,0,1,1
6,2023-08-12T07:32:00+10:00,2023-08-12,07:32,3,3,6
6,2023-08-12T07:35:00+10:00,2023-08-12,07:35,3,2,5
6,2023-08-12T07:36:00+10:00,2023-08-12,07:36,2,1,3
8,2023-08-12T07:25:00+10:00,2023-08-12,07:25,0,1,1
8,2023-08-12T07:29:00+10:00,2023-08-12,07:29,1,0,1
8,2023-08-12T07:39:00+10:00,2023-08-12,07:39,2,0,2
14,2023-08-12T07:28:00+10:00,2023-08-12,07:28,0,1,1
14,2023-08-12T07:29:00+10:00,2023-08-12,07:29,2,0,2
14,2023-08-12T07:32:00+10:00,2023-08-12,07:32,2,1,3
14,2023-08-12T07:34:00+10:00,2023-08-12,07:34,1,2,3
14,2023-08-12T07:38:00+10:00,2023-08-12,07:38,1,0,1
21,2023-08-12T07:35:00+10:00,2023-08-12,07:35,0,1,1
21,2023-08-12T07:36:00+10:00,2023-08-12,07:36,2,1,3
28,2023-08-12T07:29:00+10:00,2023-08-12,07:29,0,1,1
28,2023-08-12T07:33:00+10:00,2023-08-12,07:33,0,1,1
28,2023-08-12T07:36:00+10:00,2023-08-12,07:36,0,1,1
29,2023-08-12T07:25:00+10:00,2023-08-12,07:25,0,2,2
29,2023-08-12T07:31:00+10:00,2023-08-12,07:31,0,1,1
29,2023-08-12T07:37:00+10:00,2023-08-12,07:37,0,1,1
39,2023-08-12T07:37:00+10:00,2023-08-12,07:37,0,1,1
41,2023-08-12T07:27:00+10:00,2023-08-12,07:27,3,2,5
41,2023-08-12T07:37:00+10:00,2023-08-12,07:37,1,7,8
41,2023-08-12T07:39:00+10:00,2023-08-12,07:39,4,12,16
54,2023-08-12T07:25:00+10:00,2023-08-12,07:25,0,2,2
54,2023-08-12T07:37:00+10:00,2023-08-12,07:37,1,0,1
54,2023-08-12T07:39:00+10:00,2023-08-12,07:39,0,1,1
55,2023-08-12T07:27:00+10:00,2023-08-12,07:27,0,1,1
55,2023-08-12T07:35:00+10:00,2023-08-12,07:35,1,1,2
55,2023-08-12T07:37:00+10:00,2023-08-12,07:37,1,1,2
55,2023-08-12T07:39:00+10:00,2023-08-12,07:39,1,1,2
65,2023-08-12T07:31:00+10:00,2023-08-12,07:31,1,1,2
66,2023-08-12T07:33:00+10:00,2023-08-12,07:33,1,0,1
66,2023-08-12T07:35:00+10:00,2023-08-12,07:35,1,0,1
66,2023-08-12T07:38:00+10:00,2023-08-12,07:38,0,3,3
69,2023-08-12T07:25:00+10:00,2023-08-12,07:25,1,1,2
75,2023-08-12T07:26:00+10:00,2023-08-12,07:26,1,1,2
75,2023-08-12T07:31:00+10:00,2023-08-12,07:31,0,3,3
75,2023-08-12T07:34:00+10:00,2023-08-12,07:34,1,0,1
75,2023-08-12T07:35:00+10:00,2023-08-12,07:35,1,0,1
77,2023-08-12T07:26:00+10:00,2023-08-12,07:26,0,1,1
77,2023-08-12T07:31:00+10:00,2023-08-12,07:31,1,0,1
77,2023-08-12T07:39:00+10:00,2023-08-12,07:39,0,1,1
78,2023-08-12T07:26:00+10:00,2023-08-12,07:26,1,1,2
78,2023-08-12T07:27:00+10:00,2023-08-12,07:27,0,4,4
78,2023-08-12T07:37:00+10:00,2023-08-12,07:37,0,1,1
84,2023-08-12T07:25:00+10:00,2023-08-12,07:25,13,4,17
84,2023-08-12T07:35:00+10:00,2023-08-12,07:35,7,4,11
87,2023-08-12T07:27:00+10:00,2023-08-12,07:27,1,0,1
87,2023-08-12T07:29:00+10:00,2023-08-12,07:29,0,1,1
107,2023-08-12T07:25:00+10:00,2023-08-12,07:25,1,1,2
107,2023-08-12T07:35:00+10:00,2023-08-12,07:35,1,4,5
108,2023-08-12T07:29:00+10:00,2023-08-12,07:29,0,1,1
108,2023-08-12T07:38:00+10:00,2023-08-12,07:38,1,0,1
108,2023-08-12T07:39:00+10:00,2023-08-12,07:39,0,1,1
118,2023-08-12T07:35:00+10:00,2023-08-12,07:35,1,0,1
1,2023-08-12T07:29:00+10:00,2023-08-12,07:29,2,0,2
1,2023-08-12T07:37:00+10:00,2023-08-12,07:37,1,0,1
2,2023-08-12T07:25:00+10:00,2023-08-12,07:25,0,1,1
2,2023-08-12T07:32:00+10:00,2023-08-12,07:32,1,0,1
2,2023-08-12T07:35:00+10:00,2023-08-12,07:35,0,1,1
7,2023-08-12T07:25:00+10:00,2023-08-12,07:25,2,0,2
7,2023-08-12T07:29:00+10:00,2023-08-12,07:29,2,0,2
9,2023-08-12T07:29:00+10:00,2023-08-12,07:29,1,0,1
11,2023-08-12T07:36:00+10:00,2023-08-12,07:36,1,0,1
12,2023-08-12T07:27:00+10:00,2023-08-12,07:27,1,0,1
12,2023-08-12T07:29:00+10:00,2023-08-12,07:29,1,1,2
12,2023-08-12T07:31:00+10:00,2023-08-12,07:31,2,0,2
12,2023-08-12T07:34:00+10:00,2023-08-12,07:34,0,1,1
12,2023-08-12T07:38:00+10:00,2023-08-12,07:38,0,1,1
17,2023-08-12T07:27:00+10:00,2023-08-12,07:27,2,0,2
17,2023-08-12T07:36:00+10:00,2023-08-12,07:36,1,0,1
18,2023-08-12T07:33:00+10:00,2023-08-12,07:33,0,1,1
24,2023-08-12T07:25:00+10:00,2023-08-12,07:25,4,1,5
24,2023-08-12T07:28:00+10:00,2023-08-12,07:28,0,1,1
24,2023-08-12T07:29:00+10:00,2023-08-12,07:29,0,13,13
24,2023-08-12T07:31:00+10:00,2023-08-12,07:31,4,0,4
24,2023-08-12T07:32:00+10:00,2023-08-12,07:32,0,3,3
24,2023-08-12T07:34:00+10:00,2023-08-12,07:34,1,0,1
24,2023-08-12T07:37:00+10:00,2023-08-12,07:37,1,11,12
27,2023-08-12T07:26:00+10:00,2023-08-12,07:26,0,1,1
35,2023-08-12T07:27:00+10:00,2023-08-12,07:27,4,2,6
35,2023-08-12T07:29:00+10:00,2023-08-12,07:29,4,4,8
35,2023-08-12T07:33:00+10:00,2023-08-12,07:33,3,1,4
35,2023-08-12T07:38:00+10:00,2023-08-12,07:38,2,0,2
35,2023-08-12T07:39:00+10:00,2023-08-12,07:39,6,3,9
53,2023-08-12T07:34:00+10:00,2023-08-12,07:34,1,0,1
56,2023-08-12T07:35:00+10:00,2023-08-12,07:35,2,0,2
56,2023-08-12T07:36:00+10:00,2023-08-12,07:36,2,0,2
57,2023-08-12T07:36:00+10:00,2023-08-12,07:36,0,1,1
58,2023-08-12T07:25:00+10:00,2023-08-12,07:25,0,2,2
58,2023-08-12T07:36:00+10:00,2023-08-12,07:36,3,0,3
58,2023-08-12T07:39:00+10:00,2023-08-12,07:39,5,1,6
62,2023-08-12T07:26:00+10:00,2023-08-12,07:26,3,0,3
62,2023-08-12T07:38:00+10:00,2023-08-12,07:38,2,1,3
63,2023-08-12T07:25:00+10:00,2023-08-12,07:25,0,1,1
63,2023-08-12T07:28:00+10:00,2023-08-12,07:28,1,0,1
63,2023-08-12T07:29:00+10:00,2023-08-12,07:29,1,0,1
63,2023-08-12T07:34:00+10:00,2023-08-12,07:34,2,0,2
67,2023-08-12T07:29:00+10:00,2023-08-12,07:29,1,4,5
67,2023-08-12T07:32:00+10:00,2023-08-12,07:32,2,2,4
67,2023-08-12T07:38:00+10:00,2023-08-12,07:38,4,0,4
68,2023-08-12T07:25:00+10:00,2023-08-12,07:25,1,0,1
68,2023-08-12T07:32:00+10:00,2023-08-12,07:32,1,1,2
68,2023-08-12T07:33:00+10:00,2023-08-12,07:33,1,0,1
72,2023-08-12T07:32:00+10:00,2023-08-12,07:32,1,0,1
72,2023-08-12T07:34:00+10:00,2023-08-12,07:34,1,0,1
72,2023-08-12T07:36:00+10:00,2023-08-12,07:36,0,3,3
79,2023-08-12T07:30:00+10:00,2023-08-12,07:30,0,2,2
79,2023-08-12T07:35:00+10:00,2023-08-12,07:35,0,1,1
79,2023-08-12T07:36:00+10:00,2023-08-12,07:36,4,0,4
85,2023-08-12T07:25:00+10:00,2023-08-12,07:25,1,0,1
85,2023-08-12T07:29:00+10:00,2023-08-12,07:29,0,1,1
85,2023-08-12T07:35:00+10:00,2023-08-12,07:35,0,1,1
85,2023-08-12T07:39:00+10:00,2023-08-12,07:39,1,0,1
117,2023-08-12T07:30:00+10:00,2023-08-12,07:30,4,1,5
122,2023-08-12T07:38:00+10:00,2023-08-12,07:38,0,1,1
3,2023-08-12T07:49:00+10:00,2023-08-12,07:49,3,0,3
3,2023-08-12T07:53:00+10:00,2023-08-12,07:53,3,4,7
4,2023-08-12T07:40:00+10:00,2023-08-12,07:40,1,4,5
4,2023-08-12T07:41:00+10:00,2023-08-12,07:41,1,0,1
4,2023-08-12T07:42:00+10:00,2023-08-12,07:42,0,2,2
4,2023-08-12T07:44:00+10:00,2023-08-12,07:44,2,2,4
4,2023-08-12T07:47:00+10:00,2023-08-12,07:47,3,0,3
4,2023-08-12T07:52:00+10:00,2023-08-12,07:52,4,2,6
4,2023-08-12T07:53:00+10:00,2023-08-12,07:53,4,4,8
6,2023-08-12T07:42:00+10:00,2023-08-12,07:42,0,6,6
6,2023-08-12T07:47:00+10:00,2023-08-12,07:47,1,13,14
6,2023-08-12T07:50:00+10:00,2023-08-12,07:50,0,2,2
6,2023-08-12T07:51:00+10:00,2023-08-12,07:51,1,1,2
6,2023-08-12T07:52:00+10:00,2023-08-12,07:52,3,1,4
8,2023-08-12T07:42:00+10:00,2023-08-12,07:42,0,1,1
8,2023-08-12T07:53:00+10:00,2023-08-12,07:53,0,1,1
14,2023-08-12T07:43:00+10:00,2023-08-12,07:43,1,1,2
14,2023-08-12T07:44:00+10:00,2023-08-12,07:44,2,2,4
14,2023-08-12T07:46:00+10:00,2023-08-12,07:46,2,0,2
14,2023-08-12T07:51:00+10:00,2023-08-12,07:51,1,3,4
14,2023-08-12T07:53:00+10:00,2023-08-12,07:53,0,1,1
21,2023-08-12T07:48:00+10:00,2023-08-12,07:48,0,2,2
21,2023-08-12T07:52:00+10:00,2023-08-12,07:52,1,1,2
28,2023-08-12T07:46:00+10:00,2023-08-12,07:46,0,4,4
28,2023-08-12T07:47:00+10:00,2023-08-12,07:47,0,1,1
28,2023-08-12T07:51:00+10:00,2023-08-12,07:51,3,0,3
28,2023-08-12T07:53:00+10:00,2023-08-12,07:53,2,0,2
29,2023-08-12T07:41:00+10:00,2023-08-12,07:41,0,2,2
29,2023-08-12T07:50:00+10:00,2023-08-12,07:50,3,2,5
29,2023-08-12T07:51:00+10:00,2023-08-12,07:51,0,1,1
29,2023-08-12T07:53:00+10:00,2023-08-12,07:53,1,0,1
39,2023-08-12T07:42:00+10:00,2023-08-12,07:42,0,2,2
39,2023-08-12T07:46:00+10:00,2023-08-12,07:46,1,0,1
39,2023-08-12T07:53:00+10:00,2023-08-12,07:53,2,0,2
41,2023-08-12T07:45:00+10:00,2023-08-12,07:45,5,3,8
41,2023-08-12T07:46:00+10:00,2023-08-12,07:46,3,1,4
41,2023-08-12T07:53:00+10:00,2023-08-12,07:53,7,2,9
41,2023-08-12T07:54:00+10:00,2023-08-12,07:54,1,9,10
54,2023-08-12T07:49:00+10:00,2023-08-12,07:49,1,2,3
54,2023-08-12T07:50:00+10:00,2023-08-12,07:50,1,0,1
54,2023-08-12T07:51:00+10:00,2023-08-12,07:51,2,0,2
55,2023-08-12T07:43:00+10:00,2023-08-12,07:43,0,1,1
55,2023-08-12T07:47:00+10:00,2023-08-12,07:47,1,2,3
55,2023-08-12T07:50:00+10:00,2023-08-12,07:50,2,3,5
59,2023-08-12T07:40:00+10:00,2023-08-12,07:40,6,3,9
59,2023-08-12T07:45:00+10:00,2023-08-12,07:45,2,1,3
61,2023-08-12T07:41:00+10:00,2023-08-12,07:41,0,2,2
61,2023-08-12T07:44:00+10:00,2023-08-12,07:44,1,2,3
61,2023-08-12T07:46:00+10:00,2023-08-12,07:46,0,1,1
61,2023-08-12T07:48:00+10:00,2023-08-12,07:48,0,1,1
61,2023-08-12T07:51:00+10:00,2023-08-12,07:51,0,3,3
65,2023-08-12T07:40:00+10:00,2023-08-12,07:40,1,0,1
65,2023-08-12T07:47:00+10:00,2023-08-12,07:47,3,1,4
65,2023-08-12T07:51:00+10:00,2023-08-12,07:51,0,1,1
66,2023-08-12T07:40:00+10:00,2023-08-12,07:40,0,1,1
66,2023-08-12T07:41:00+10:00,2023-08-12,07:41,0,1,1
66,2023-08-12T07:45:00+10:00,2023-08-12,07:45,0,1,1
66,2023-08-12T07:47:00+10:00,2023-08-12,07:47,0,2,2
66,2023-08-12T07:49:00+10:00,2023-08-12,07:49,0,1,1
66,2023-08-12T07:50:00+10:00,2023-08-12,07:50,0,4,4
66,2023-08-12T07:53:00+10:00,2023-08-12,07:53,1,0,1
66,2023-08-12T07:54:00+10:00,2023-08-12,07:54,0,1,1
70,2023-08-12T07:42:00+10:00,2023-08-12,07:42,1,0,1
70,2023-08-12T07:44:00+10:00,2023-08-12,07:44,0,1,1
75,2023-08-12T07:45:00+10:00,2023-08-12,07:45,1,1,2
77,2023-08-12T07:52:00+10:00,2023-08-12,07:52,5,0,5
77,2023-08-12T07:54:00+10:00,2023-08-12,07:54,1,1,2
84,2023-08-12T07:50:00+10:00,2023-08-12,07:50,11,8,19
87,2023-08-12T07:44:00+10:00,2023-08-12,07:44,1,1,2
87,2023-08-12T07:48:00+10:00,2023-08-12,07:48,1,1,2
87,2023-08-12T07:52:00+10:00,2023-08-12,07:52,1,1,2
107,2023-08-12T07:50:00+10:00,2023-08-12,07:50,3,4,7
108,2023-08-12T07:43:00+10:00,2023-08-12,07:43,1,2,3
108,2023-08-12T07:44:00+10:00,2023-08-12,07:44,2,2,4
108,2023-08-12T07:50:00+10:00,2023-08-12,07:50,1,2,3
118,2023-08-12T07:40:00+10:00,2023-08-12,07:40,2,1,3
1,2023-08-12T07:54:00+10:00,2023-08-12,07:54,6,4,10
2,2023-08-12T07:45:00+10:00,2023-08-12,07:45,1,0,1
7,2023-08-12T07:43:00+10:00,2023-08-12,07:43,0,1,1
7,2023-08-12T07:45:00+10:00,2023-08-12,07:45,0,1,1
7,2023-08-12T07:49:00+10:00,2023-08-12,07:49,0,1,1
9,2023-08-12T07:50:00+10:00,2023-08-12,07:50,1,1,2
9,2023-08-12T07:52:00+10:00,2023-08-12,07:52,0,2,2
10,2023-08-12T07:45:00+10:00,2023-08-12,07:45,1,0,1
10,2023-08-12T07:51:00+10:00,2023-08-12,07:51,1,0,1
11,2023-08-12T07:40:00+10:00,2023-08-12,07:40,1,0,1
11,2023-08-12T07:45:00+10:00,2023-08-12,07:45,0,2,2
11,2023-08-12T07:47:00+10:00,2023-08-12,07:47,1,1,2
12,2023-08-12T07:43:00+10:00,2023-08-12,07:43,2,1,3
12,2023-08-12T07:49:00+10:00,2023-08-12,07:49,1,0,1
17,2023-08-12T07:45:00+10:00,2023-08-12,07:45,4,0,4
17,2023-08-12T07:47:00+10:00,2023-08-12,07:47,2,2,4
17,2023-08-12T07:48:00+10:00,2023-08-12,07:48,6,0,6
17,2023-08-12T07:49:00+10:00,2023-08-12,07:49,1,0,1
17,2023-08-12T07:50:00+10:00,2023-08-12,07:50,2,3,5
17,2023-08-12T07:52:00+10:00,2023-08-12,07:52,0,1,1
18,2023-08-12T07:48:00+10:00,2023-08-12,07:48,0,1,1
18,2023-08-12T07:50:00+10:00,2023-08-12,07:50,2,0,2
24,2023-08-12T07:41:00+10:00,2023-08-12,07:41,6,0,6
24,2023-08-12T07:43:00+10:00,2023-08-12,07:43,0,3,3
24,2023-08-12T07:45:00+10:00,2023-08-12,07:45,0,1,1
24,2023-08-12T07:46:00+10:00,2023-08-12,07:46,6,0,6
24,2023-08-12T07:48:00+10:00,2023-08-12,07:48,0,3,3
24,2023-08-12T07:51:00+10:00,2023-08-12,07:51,4,1,5
24,2023-08-12T07:52:00+10:00,2023-08-12,07:52,3,9,12
24,2023-08-12T07:54:00+10:00,2023-08-12,07:54,5,0,5
27,2023-08-12T07:43:00+10:00,2023-08-12,07:43,1,1,2
27,2023-08-12T07:47:00+10:00,2023-08-12,07:47,1,0,1
35,2023-08-12T07:40:00+10:00,2023-08-12,07:40,1,5,6
35,2023-08-12T07:43:00+10:00,2023-08-12,07:43,3,0,3
35,2023-08-12T07:44:00+10:00,2023-08-12,07:44,1,9,10
35,2023-08-12T07:49:00+10:00,2023-08-12,07:49,3,9,12
35,2023-08-12T07:50:00+10:00,2023-08-12,07:50,1,3,4
35,2023-08-12T07:53:00+10:00,2023-08-12,07:53,1,2,3
53,2023-08-12T07:42:00+10:00,2023-08-12,07:42,3,1,4
53,2023-08-12T07:46:00+10:00,2023-08-12,07:46,1,1,2
53,2023-08-12T07:49:00+10:00,2023-08-12,07:49,1,0,1
53,2023-08-12T07:50:00+10:00,2023-08-12,07:50,1,0,1
56,2023-08-12T07:40:00+10:00,2023-08-12,07:40,1,0,1
56,2023-08-12T07:42:00+10:00,2023-08-12,07:42,0,1,1
56,2023-08-12T07:43:00+10:00,2023-08-12,07:43,1,0,1
56,2023-08-12T07:50:00+10:00,2023-08-12,07:50,2,0,2
57,2023-08-12T07:52:00+10:00,2023-08-12,07:52,1,0,1
57,2023-08-12T07:54:00+10:00,2023-08-12,07:54,1,1,2
58,2023-08-12T07:40:00+10:00,2023-08-12,07:40,1,2,3
58,2023-08-12T07:42:00+10:00,2023-08-12,07:42,3,2,5
62,2023-08-12T07:42:00+10:00,2023-08-12,07:42,7,3,10
62,2023-08-12T07:44:00+10:00,2023-08-12,07:44,5,2,7
62,2023-08-12T07:45:00+10:00,2023-08-12,07:45,1,0,1
62,2023-08-12T07:51:00+10:00,2023-08-12,07:51,1,3,4
63,2023-08-12T07:42:00+10:00,2023-08-12,07:42,0,1,1
63,2023-08-12T07:47:00+10:00,2023-08-12,07:47,0,3,3
63,2023-08-12T07:54:00+10:00,2023-08-12,07:54,2,3,5
67,2023-08-12T07:40:00+10:00,2023-08-12,07:40,2,3,5
67,2023-08-12T07:43:00+10:00,2023-08-12,07:43,1,6,7
67,2023-08-12T07:44:00+10:00,2023-08-12,07:44,1,2,3
67,2023-08-12T07:48:00+10:00,2023-08-12,07:48,1,2,3
67,2023-08-12T07:50:00+10:00,2023-08-12,07:50,0,3,3
67,2023-08-12T07:51:00+10:00,2023-08-12,07:51,2,0,2
67,2023-08-12T07:54:00+10:00,2023-08-12,07:54,0,3,3
68,2023-08-12T07:40:00+10:00,2023-08-12,07:40,3,1,4
68,2023-08-12T07:50:00+10:00,2023-08-12,07:50,0,1,1
68,2023-08-12T07:51:00+10:00,2023-08-12,07:51,1,1,2
68,2023-08-12T07:54:00+10:00,2023-08-12,07:54,1,0,1
72,2023-08-12T07:40:00+10:00,2023-08-12,07:40,2,0,2
72,2023-08-12T07:42:00+10:00,2023-08-12,07:42,0,2,2
72,2023-08-12T07:49:00+10:00,2023-08-12,07:49,1,1,2
72,2023-08-12T07:53:00+10:00,2023-08-12,07:53,0,3,3
76,2023-08-12T07:46:00+10:00,2023-08-12,07:46,2,0,2
76,2023-08-12T07:51:00+10:00,2023-08-12,07:51,1,0,1
79,2023-08-12T07:44:00+10:00,2023-08-12,07:44,1,3,4
79,2023-08-12T07:46:00+10:00,2023-08-12,07:46,1,2,3
79,2023-08-12T07:49:00+10:00,2023-08-12,07:49,0,1,1
79,2023-08-12T07:51:00+10:00,2023-08-12,07:51,4,1,5
79,2023-08-12T07:53:00+10:00,2023-08-12,07:53,2,0,2
85,2023-08-12T07:40:00+10:00,2023-08-12,07:40,0,1,1
85,2023-08-12T07:50:00+10:00,2023-08-12,07:50,0,3,3
86,2023-08-12T07:54:00+10:00,2023-08-12,07:54,0,1,1
109,2023-08-12T07:50:00+10:00,2023-08-12,07:50,0,2,2
122,2023-08-12T07:49:00+10:00,2023-08-12,07:49,1,0,1
122,2023-08-12T07:50:00+10:00,2023-08-12,07:50,2,0,2
122,2023-08-12T07:51:00+10:00,2023-08-12,07:51,1,0,1
122,2023-08-12T07:53:00+10:00,2023-08-12,07:53,1,0,1
3,2023-08-12T07:56:00+10:00,2023-08-12,07:56,3,0,3
3,2023-08-12T07:58:00+10:00,2023-08-12,07:58,2,4,6
3,2023-08-12T08:01:00+10:00,2023-08-12,08:01,1,2,3
3,2023-08-12T08:04:00+10:00,2023-08-12,08:04,0,6,6
3,2023-08-12T08:05:00+10:00,2023-08-12,08:05,2,3,5
3,2023-08-12T08:08:00+10:00,2023-08-12,08:08,1,2,3
4,2023-08-12T07:55:00+10:00,2023-08-12,07:55,0,2,2
4,2023-08-12T08:01:00+10:00,2023-08-12,08:01,5,0,5
4,2023-08-12T08:03:00+10:00,2023-08-12,08:03,0,1,1
4,2023-08-12T08:07:00+10:00,2023-08-12,08:07,5,4,9
6,2023-08-12T07:57:00+10:00,2023-08-12,07:57,2,2,4
6,2023-08-12T08:02:00+10:00,2023-08-12,08:02,0,1,1
8,2023-08-12T07:57:00+10:00,2023-08-12,07:57,0,1,1
8,2023-08-12T08:03:00+10:00,2023-08-12,08:03,0,1,1
8,2023-08-12T08:07:00+10:00,2023-08-12,08:07,0,1,1
14,2023-08-12T08:01:00+10:00,2023-08-12,08:01,1,3,4
14,2023-08-12T08:02:00+10:00,2023-08-12,08:02,1,1,2
14,2023-08-12T08:03:00+10:00,2023-08-12,08:03,3,2,5
14,2023-08-12T08:06:00+10:00,2023-08-12,08:06,3,0,3
14,2023-08-12T08:09:00+10:00,2023-08-12,08:09,1,0,1
21,2023-08-12T07:56:00+10:00,2023-08-12,07:56,0,2,2
21,2023-08-12T08:05:00+10:00,2023-08-12,08:05,6,0,6
21,2023-08-12T08:09:00+10:00,2023-08-12,08:09,1,0,1
28,2023-08-12T07:56:00+10:00,2023-08-12,07:56,1,1,2
28,2023-08-12T07:59:00+10:00,2023-08-12,07:59,1,1,2
28,2023-08-12T08:09:00+10:00,2023-08-12,08:09,0,1,1
29,2023-08-12T08:01:00+10:00,2023-08-12,08:01,0,1,1
29,2023-08-12T08:02:00+10:00,2023-08-12,08:02,1,1,2
29,2023-08-12T08:05:00+10:00,2023-08-12,08:05,1,1,2
29,2023-08-12T08:07:00+10:00,2023-08-12,08:07,2,0,2
29,2023-08-12T08:09:00+10:00,2023-08-12,08:09,0,1,1
39,2023-08-12T07:57:00+10:00,2023-08-12,07:57,0,1,1
39,2023-08-12T08:01:00+10:00,2023-08-12,08:01,1,2,3
41,2023-08-12T08:06:00+10:00,2023-08-12,08:06,0,1,1
41,2023-08-12T08:09:00+10:00,2023-08-12,08:09,6,1,7
54,2023-08-12T07:56:00+10:00,2023-08-12,07:56,2,0,2
55,2023-08-12T07:57:00+10:00,2023-08-12,07:57,0,4,4
55,2023-08-12T08:01:00+10:00,2023-08-12,08:01,2,2,4
55,2023-08-12T08:03:00+10:00,2023-08-12,08:03,0,2,2
55,2023-08-12T08:05:00+10:00,2023-08-12,08:05,2,3,5
55,2023-08-12T08:07:00+10:00,2023-08-12,08:07,3,3,6
55,2023-08-12T08:09:00+10:00,2023-08-12,08:09,1,4,5
59,2023-08-12T07:55:00+10:00,2023-08-12,07:55,3,6,9
61,2023-08-12T07:57:00+10:00,2023-08-12,07:57,2,3,5
61,2023-08-12T08:03:00+10:00,2023-08-12,08:03,0,2,2
61,2023-08-12T08:05:00+10:00,2023-08-12,08:05,0,3,3
61,2023-08-12T08:06:00+10:00,2023-08-12,08:06,0,5,5
61,2023-08-12T08:07:00+10:00,2023-08-12,08:07,0,4,4
61,2023-08-12T08:09:00+10:00,2023-08-12,08:09,0,2,2
65,2023-08-12T07:56:00+10:00,2023-08-12,07:56,0,1,1
65,2023-08-12T07:58:00+10:00,2023-08-12,07:58,0,2,2
65,2023-08-12T08:00:00+10:00,2023-08-12,08:00,4,1,5
65,2023-08-12T08:02:00+10:00,2023-08-12,08:02,2,0,2
65,2023-08-12T08:06:00+10:00,2023-08-12,08:06,1,0,1
65,2023-08-12T08:08:00+10:00,2023-08-12,08:08,1,2,3
66,2023-08-12T07:55:00+10:00,2023-08-12,07:55,0,1,1
66,2023-08-12T07:59:00+10:00,2023-08-12,07:59,0,2,2
66,2023-08-12T08:03:00+10:00,2023-08-12,08:03,0,2,2
66,2023-08-12T08:08:00+10:00,2023-08-12,08:08,1,0,1
66,2023-08-12T08:09:00+10:00,2023-08-12,08:09,2,1,3
70,2023-08-12T07:57:00+10:00,2023-08-12,07:57,1,0,1
70,2023-08-12T08:04:00+10:00,2023-08-12,08:04,0,1,1
77,2023-08-12T07:58:00+10:00,2023-08-12,07:58,0,4,4
77,2023-08-12T08:03:00+10:00,2023-08-12,08:03,2,1,3
78,2023-08-12T07:59:00+10:00,2023-08-12,07:59,0,1,1
78,2023-08-12T08:08:00+10:00,2023-08-12,08:08,0,1,1
84,2023-08-12T08:05:00+10:00,2023-08-12,08:05,15,15,30
87,2023-08-12T08:08:00+10:00,2023-08-12,08:08,1,1,2
87,2023-08-12T08:09:00+10:00,2023-08-12,08:09,3,1,4
107,2023-08-12T08:05:00+10:00,2023-08-12,08:05,0,4,4
108,2023-08-12T07:57:00+10:00,2023-08-12,07:57,0,1,1
108,2023-08-12T07:59:00+10:00,2023-08-12,07:59,1,0,1
1,2023-08-12T07:55:00+10:00,2023-08-12,07:55,1,0,1
1,2023-08-12T07:56:00+10:00,2023-08-12,07:56,1,0,1
1,2023-08-12T07:58:00+10:00,2023-08-12,07:58,1,1,2
1,2023-08-12T07:59:00+10:00,2023-08-12,07:59,0,4,4
1,2023-08-12T08:00:00+10:00,2023-08-12,08:00,2,0,2
1,2023-08-12T08:01:00+10:00,2023-08-12,08:01,0,1,1
1,2023-08-12T08:06:00+10:00,2023-08-12,08:06,1,0,1
1,2023-08-12T08:08:00+10:00,2023-08-12,08:08,1,3,4
7,2023-08-12T07:58:00+10:00,2023-08-12,07:58,0,2,2
7,2023-08-12T08:04:00+10:00,2023-08-12,08:04,0,2,2
9,2023-08-12T07:56:00+10:00,2023-08-12,07:56,0,1,1
9,2023-08-12T08:02:00+10:00,2023-08-12,08:02,0,1,1
9,2023-08-12T08:07:00+10:00,2023-08-12,08:07,1,0,1
10,2023-08-12T08:04:00+10:00,2023-08-12,08:04,1,0,1
11,2023-08-12T08:05:00+10:00,2023-08-12,08:05,0,5,5
11,2023-08-12T08:09:00+10:00,2023-08-12,08:09,1,1,2
12,2023-08-12T07:55:00+10:00,2023-08-12,07:55,0,2,2
12,2023-08-12T07:56:00+10:00,2023-08-12,07:56,2,0,2
12,2023-08-12T07:58:00+10:00,2023-08-12,07:58,0,1,1
12,2023-08-12T08:09:00+10:00,2023-08-12,08:09,1,2,3
17,2023-08-12T07:55:00+10:00,2023-08-12,07:55,3,1,4
17,2023-08-12T07:58:00+10:00,2023-08-12,07:58,5,0,5
17,2023-08-12T08:00:00+10:00,2023-08-12,08:00,1,0,1
17,2023-08-12T08:03:00+10:00,2023-08-12,08:03,0,3,3
17,2023-08-12T08:06:00+10:00,2023-08-12,08:06,3,1,4
17,2023-08-12T08:07:00+10:00,2023-08-12,08:07,2,1,3
17,2023-08-12T08:09:00+10:00,2023-08-12,08:09,1,0,1
18,2023-08-12T08:05:00+10:00,2023-08-12,08:05,0,1,1
24,2023-08-12T08:00:00+10:00,2023-08-12,08:00,3,3,6
24,2023-08-12T08:01:00+10:00,2023-08-12,08:01,5,1,6
24,2023-08-12T08:06:00+10:00,2023-08-12,08:06,8,0,8
24,2023-08-12T08:07:00+10:00,2023-08-12,08:07,4,1,5
27,2023-08-12T07:57:00+10:00,2023-08-12,07:57,1,0,1
27,2023-08-12T07:58:00+10:00,2023-08-12,07:58,1,0,1
27,2023-08-12T08:02:00+10:00,2023-08-12,08:02,2,0,2
27,2023-08-12T08:08:00+10:00,2023-08-12,08:08,1,0,1
35,2023-08-12T07:56:00+10:00,2023-08-12,07:56,5,2,7
35,2023-08-12T08:00:00+10:00,2023-08-12,08:00,2,4,6
53,2023-08-12T07:55:00+10:00,2023-08-12,07:55,2,1,3
53,2023-08-12T08:01:00+10:00,2023-08-12,08:01,1,0,1
53,2023-08-12T08:04:00+10:00,2023-08-12,08:04,1,0,1
53,2023-08-12T08:06:00+10:00,2023-08-12,08:06,0,1,1
56,2023-08-12T08:01:00+10:00,2023-08-12,08:01,1,0,1
56,2023-08-12T08:06:00+10:00,2023-08-12,08:06,5,1,6
57,2023-08-12T08:02:00+10:00,2023-08-12,08:02,1,0,1
57,2023-08-12T08:05:00+10:00,2023-08-12,08:05,0,2,2
57,2023-08-12T08:07:00+10:00,2023-08-12,08:07,0,6,6
58,2023-08-12T07:55:00+10:00,2023-08-12,07:55,4,3,7
58,2023-08-12T07:59:00+10:00,2023-08-12,07:59,5,0,5
58,2023-08-12T08:00:00+10:00,2023-08-12,08:00,3,5,8
58,2023-08-12T08:01:00+10:00,2023-08-12,08:01,1,0,1
58,2023-08-12T08:03:00+10:00,2023-08-12,08:03,2,0,2
58,2023-08-12T08:08:00+10:00,2023-08-12,08:08,4,5,9
62,2023-08-12T07:56:00+10:00,2023-08-12,07:56,1,2,3
62,2023-08-12T07:58:00+10:00,2023-08-12,07:58,2,0,2
62,2023-08-12T07:59:00+10:00,2023-08-12,07:59,1,1,2
62,2023-08-12T08:09:00+10:00,2023-08-12,08:09,1,1,2
63,2023-08-12T08:04:00+10:00,2023-08-12,08:04,0,2,2
67,2023-08-12T07:55:00+10:00,2023-08-12,07:55,1,0,1
67,2023-08-12T07:57:00+10:00,2023-08-12,07:57,1,4,5
67,2023-08-12T07:58:00+10:00,2023-08-12,07:58,0,1,1
67,2023-08-12T07:59:00+10:00,2023-08-12,07:59,3,2,5
67,2023-08-12T08:05:00+10:00,2023-08-12,08:05,2,1,3
67,2023-08-12T08:06:00+10:00,2023-08-12,08:06,2,1,3
67,2023-08-12T08:07:00+10:00,2023-08-12,08:07,3,0,3
67,2023-08-12T08:08:00+10:00,2023-08-12,08:08,1,3,4
68,2023-08-12T07:59:00+10:00,2023-08-12,07:59,1,2,3
68,2023-08-12T08:00:00+10:00,2023-08-12,08:00,2,0,2
68,2023-08-12T08:03:00+10:00,2023-08-12,08:03,2,1,3
68,2023-08-12T08:04:00+10:00,2023-08-12,08:04,2,0,2
72,2023-08-12T07:55:00+10:00,2023-08-12,07:55,0,1,1
72,2023-08-12T07:57:00+10:00,2023-08-12,07:57,1,0,1
72,2023-08-12T07:58:00+10:00,2023-08-12,07:58,3,0,3
72,2023-08-12T07:59:00+10:00,2023-08-12,07:59,4,1,5
72,2023-08-12T08:00:00+10:00,2023-08-12,08:00,0,2,2
72,2023-08-12T08:06:00+10:00,2023-08-12,08:06,1,2,3
76,2023-08-12T08:05:00+10:00,2023-08-12,08:05,0,2,2
76,2023-08-12T08:06:00+10:00,2023-08-12,08:06,1,1,2
76,2023-08-12T08:09:00+10:00,2023-08-12,08:09,1,0,1
79,2023-08-12T07:58:00+10:00,2023-08-12,07:58,5,1,6
79,2023-08-12T07:59:00+10:00,2023-08-12,07:59,5,0,5
79,2023-08-12T08:03:00+10:00,2023-08-12,08:03,2,1,3
79,2023-08-12T08:04:00+10:00,2023-08-12,08:04,1,4,5
79,2023-08-12T08:07:00+10:00,2023-08-12,08:07,3,0,3
85,2023-08-12T08:04:00+10:00,2023-08-12,08:04,2,1,3
85,2023-08-12T08:05:00+10:00,2023-08-12,08:05,1,2,3
85,2023-08-12T08:07:00+10:00,2023-08-12,08:07,1,0,1
85,2023-08-12T08:08:00+10:00,2023-08-12,08:08,2,1,3
86,2023-08-12T07:55:00+10:00,2023-08-12,07:55,2,0,2
109,2023-08-12T07:55:00+10:00,2023-08-12,07:55,1,4,5
117,2023-08-12T07:55:00+10:00,2023-08-12,07:55,2,5,7
122,2023-08-12T08:04:00+10:00,2023-08-12,08:04,1,0,1
122,2023-08-12T08:05:00+10:00,2023-08-12,08:05,0,1,1
3,2023-08-12T08:11:00+10:00,2023-08-12,08:11,2,0,2
3,2023-08-12T08:13:00+10:00,2023-08-12,08:13,2,1,3
3,2023-08-12T08:15:00+10:00,2023-08-12,08:15,2,2,4
3,2023-08-12T08:17:00+10:00,2023-08-12,08:17,2,1,3
3,2023-08-12T08:19:00+10:00,2023-08-12,08:19,4,0,4
3,2023-08-12T08:22:00+10:00,2023-08-12,08:22,4,2,6
3,2023-08-12T08:23:00+10:00,2023-08-12,08:23,2,1,3
4,2023-08-12T08:13:00+10:00,2023-08-12,08:13,4,3,7
4,2023-08-12T08:18:00+10:00,2023-08-12,08:18,0,3,3
4,2023-08-12T08:19:00+10:00,2023-08-12,08:19,2,1,3
6,2023-08-12T08:15:00+10:00,2023-08-12,08:15,1,3,4
6,2023-08-12T08:16:00+10:00,2023-08-12,08:16,6,1,7
6,2023-08-12T08:17:00+10:00,2023-08-12,08:17,2,1,3
6,2023-08-12T08:21:00+10:00,2023-08-12,08:21,2,3,5
6,2023-08-12T08:22:00+10:00,2023-08-12,08:22,4,1,5
8,2023-08-12T08:10:00+10:00,2023-08-12,08:10,1,1,2
8,2023-08-12T08:13:00+10:00,2023-08-12,08:13,2,0,2
8,2023-08-12T08:15:00+10:00,2023-08-12,08:15,1,0,1
8,2023-08-12T08:18:00+10:00,2023-08-12,08:18,3,0,3
8,2023-08-12T08:24:00+10:00,2023-08-12,08:24,2,0,2
14,2023-08-12T08:16:00+10:00,2023-08-12,08:16,1,0,1
14,2023-08-12T08:17:00+10:00,2023-08-12,08:17,3,4,7
21,2023-08-12T08:10:00+10:00,2023-08-12,08:10,1,0,1
21,2023-08-12T08:14:00+10:00,2023-08-12,08:14,1,2,3
21,2023-08-12T08:16:00+10:00,2023-08-12,08:16,0,1,1
21,2023-08-12T08:18:00+10:00,2023-08-12,08:18,3,1,4
21,2023-08-12T08:23:00+10:00,2023-08-12,08:23,4,0,4
21,2023-08-12T08:24:00+10:00,2023-08-12,08:24,2,0,2
28,2023-08-12T08:13:00+10:00,2023-08-12,08:13,0,2,2
28,2023-08-12T08:15:00+10:00,2023-08-12,08:15,1,1,2
28,2023-08-12T08:17:00+10:00,2023-08-12,08:17,0,1,1
28,2023-08-12T08:23:00+10:00,2023-08-12,08:23,1,0,1
29,2023-08-12T08:13:00+10:00,2023-08-12,08:13,1,1,2
29,2023-08-12T08:14:00+10:00,2023-08-12,08:14,0,1,1
29,2023-08-12T08:22:00+10:00,2023-08-12,08:22,6,1,7
29,2023-08-12T08:23:00+10:00,2023-08-12,08:23,0,2,2
39,2023-08-12T08:13:00+10:00,2023-08-12,08:13,0,1,1
39,2023-08-12T08:18:00+10:00,2023-08-12,08:18,0,1,1
39,2023-08-12T08:23:00+10:00,2023-08-12,08:23,0,3,3
41,2023-08-12T08:13:00+10:00,2023-08-12,08:13,7,6,13
41,2023-08-12T08:21:00+10:00,2023-08-12,08:21,7,7,14
41,2023-08-12T08:23:00+10:00,2023-08-12,08:23,10,2,12
54,2023-08-12T08:10:00+10:00,2023-08-12,08:10,2,0,2
54,2023-08-12T08:21:00+10:00,2023-08-12,08:21,1,0,1
54,2023-08-12T08:24:00+10:00,2023-08-12,08:24,0,2,2
55,2023-08-12T08:14:00+10:00,2023-08-12,08:14,1,3,4
55,2023-08-12T08:15:00+10:00,2023-08-12,08:15,2,3,5
55,2023-08-12T08:21:00+10:00,2023-08-12,08:21,1,1,2
61,2023-08-12T08:15:00+10:00,2023-08-12,08:15,0,1,1
61,2023-08-12T08:20:00+10:00,2023-08-12,08:20,4,2,6
65,2023-08-12T08:10:00+10:00,2023-08-12,08:10,0,1,1
65,2023-08-12T08:17:00+10:00,2023-08-12,08:17,0,1,1
65,2023-08-12T08:18:00+10:00,2023-08-12,08:18,0,1,1
65,2023-08-12T08:20:00+10:00,2023-08-12,08:20,2,1,3
65,2023-08-12T08:23:00+10:00,2023-08-12,08:23,1,0,1
66,2023-08-12T08:16:00+10:00,2023-08-12,08:16,2,3,5
66,2023-08-12T08:18:00+10:00,2023-08-12,08:18,0,1,1
66,2023-08-12T08:19:00+10:00,2023-08-12,08:19,3,1,4
66,2023-08-12T08:20:00+10:00,2023-08-12,08:20,0,2,2
66,2023-08-12T08:22:00+10:00,2023-08-12,08:22,0,1,1
69,2023-08-12T08:10:00+10:00,2023-08-12,08:10,1,0,1
69,2023-08-12T08:16:00+10:00,2023-08-12,08:16,1,0,1
69,2023-08-12T08:17:00+10:00,2023-08-12,08:17,2,0,2
69,2023-08-12T08:18:00+10:00,2023-08-12,08:18,2,0,2
69,2023-08-12T08:21:00+10:00,2023-08-12,08:21,0,1,1
70,2023-08-12T08:17:00+10:00,2023-08-12,08:17,1,0,1
70,2023-08-12T08:18:00+10:00,2023-08-12,08:18,0,2,2
71,2023-08-12T08:15:00+10:00,2023-08-12,08:15,1,2,3
75,2023-08-12T08:10:00+10:00,2023-08-12,08:10,0,1,1
75,2023-08-12T08:22:00+10:00,2023-08-12,08:22,0,1,1
77,2023-08-12T08:10:00+10:00,2023-08-12,08:10,1,0,1
77,2023-08-12T08:16:00+10:00,2023-08-12,08:16,0,3,3
77,2023-08-12T08:18:00+10:00,2023-08-12,08:18,0,3,3
78,2023-08-12T08:18:00+10:00,2023-08-12,08:18,0,3,3
84,2023-08-12T08:10:00+10:00,2023-08-12,08:10,21,14,35
87,2023-08-12T08:17:00+10:00,2023-08-12,08:17,1,0,1
87,2023-08-12T08:23:00+10:00,2023-08-12,08:23,2,1,3
87,2023-08-12T08:24:00+10:00,2023-08-12,08:24,1,1,2
108,2023-08-12T08:11:00+10:00,2023-08-12,08:11,0,2,2
108,2023-08-12T08:12:00+10:00,2023-08-12,08:12,1,0,1
108,2023-08-12T08:14:00+10:00,2023-08-12,08:14,0,1,1
108,2023-08-12T08:18:00+10:00,2023-08-12,08:18,0,1,1
108,2023-08-12T08:20:00+10:00,2023-08-12,08:20,1,2,3
108,2023-08-12T08:24:00+10:00,2023-08-12,08:24,2,1,3
1,2023-08-12T08:10:00+10:00,2023-08-12,08:10,1,2,3
1,2023-08-12T08:14:00+10:00,2023-08-12,08:14,4,0,4
1,2023-08-12T08:16:00+10:00,2023-08-12,08:16,1,0,1
1,2023-08-12T08:20:00+10:00,2023-08-12,08:20,0,2,2
1,2023-08-12T08:22:00+10:00,2023-08-12,08:22,2,1,3
2,2023-08-12T08:14:00+10:00,2023-08-12,08:14,0,1,1
2,2023-08-12T08:17:00+10:00,2023-08-12,08:17,0,1,1
2,2023-08-12T08:22:00+10:00,2023-08-12,08:22,0,1,1
7,2023-08-12T08:13:00+10:00,2023-08-12,08:13,1,0,1
7,2023-08-12T08:19:00+10:00,2023-08-12,08:19,1,0,1
7,2023-08-12T08:23:00+10:00,2023-08-12,08:23,0,1,1
9,2023-08-12T08:12:00+10:00,2023-08-12,08:12,1,1,2
9,2023-08-12T08:14:00+10:00,2023-08-12,08:14,1,0,1
9,2023-08-12T08:15:00+10:00,2023-08-12,08:15,0,1,1
11,2023-08-12T08:13:00+10:00,2023-08-12,08:13,1,0,1
11,2023-08-12T08:15:00+10:00,2023-08-12,08:15,4,1,5
11,2023-08-12T08:18:00+10:00,2023-08-12,08:18,1,0,1
12,2023-08-12T08:13:00+10:00,2023-08-12,08:13,0,1,1
12,2023-08-12T08:21:00+10:00,2023-08-12,08:21,2,1,3
12,2023-08-12T08:22:00+10:00,2023-08-12,08:22,1,1,2
12,2023-08-12T08:24:00+10:00,2023-08-12,08:24,1,0,1
17,2023-08-12T08:10:00+10:00,2023-08-12,08:10,0,1,1
17,2023-08-12T08:24:00+10:00,2023-08-12,08:24,1,0,1
18,2023-08-12T08:14:00+10:00,2023-08-12,08:14,0,1,1
18,2023-08-12T08:22:00+10:00,2023-08-12,08:22,1,0,1
24,2023-08-12T08:11:00+10:00,2023-08-12,08:11,3,2,5
24,2023-08-12T08:12:00+10:00,2023-08-12,08:12,2,0,2
24,2023-08-12T08:14:00+10:00,2023-08-12,08:14,14,0,14
24,2023-08-12T08:18:00+10:00,2023-08-12,08:18,3,6,9
27,2023-08-12T08:20:00+10:00,2023-08-12,08:20,2,0,2
35,2023-08-12T08:13:00+10:00,2023-08-12,08:13,3,2,5
35,2023-08-12T08:21:00+10:00,2023-08-12,08:21,4,2,6
35,2023-08-12T08:22:00+10:00,2023-08-12,08:22,3,4,7
53,2023-08-12T08:10:00+10:00,2023-08-12,08:10,4,2,6
53,2023-08-12T08:14:00+10:00,2023-08-12,08:14,4,0,4
53,2023-08-12T08:16:00+10:00,2023-08-12,08:16,2,0,2
53,2023-08-12T08:20:00+10:00,2023-08-12,08:20,0,1,1
56,2023-08-12T08:10:00+10:00,2023-08-12,08:10,3,0,3
56,2023-08-12T08:12:00+10:00,2023-08-12,08:12,1,1,2
56,2023-08-12T08:14:00+10:00,2023-08-12,08:14,3,0,3
56,2023-08-12T08:15:00+10:00,2023-08-12,08:15,1,0,1
56,2023-08-12T08:19:00+10:00,2023-08-12,08:19,2,1,3
56,2023-08-12T08:20:00+10:00,2023-08-12,08:20,0,1,1
56,2023-08-12T08:22:00+10:00,2023-08-12,08:22,1,0,1
57,2023-08-12T08:17:00+10:00,2023-08-12,08:17,2,1,3
57,2023-08-12T08:18:00+10:00,2023-08-12,08:18,0,1,1
57,2023-08-12T08:19:00+10:00,2023-08-12,08:19,2,3,5
58,2023-08-12T08:13:00+10:00,2023-08-12,08:13,5,3,8
58,2023-08-12T08:14:00+10:00,2023-08-12,08:14,2,1,3
58,2023-08-12T08:18:00+10:00,2023-08-12,08:18,0,4,4
58,2023-08-12T08:20:00+10:00,2023-08-12,08:20,1,2,3
58,2023-08-12T08:22:00+10:00,2023-08-12,08:22,3,0,3
58,2023-08-12T08:24:00+10:00,2023-08-12,08:24,6,0,6
62,2023-08-12T08:18:00+10:00,2023-08-12,08:18,1,2,3
62,2023-08-12T08:22:00+10:00,2023-08-12,08:22,0,4,4
63,2023-08-12T08:10:00+10:00,2023-08-12,08:10,1,1,2
63,2023-08-12T08:13:00+10:00,2023-08-12,08:13,2,0,2
67,2023-08-12T08:13:00+10:00,2023-08-12,08:13,2,4,6
67,2023-08-12T08:14:00+10:00,2023-08-12,08:14,2,1,3
67,2023-08-12T08:15:00+10:00,2023-08-12,08:15,1,5,6
67,2023-08-12T08:21:00+10:00,2023-08-12,08:21,5,3,8
67,2023-08-12T08:22:00+10:00,2023-08-12,08:22,3,6,9
67,2023-08-12T08:23:00+10:00,2023-08-12,08:23,4,1,5
68,2023-08-12T08:11:00+10:00,2023-08-12,08:11,0,1,1
68,2023-08-12T08:14:00+10:00,2023-08-12,08:14,4,0,4
68,2023-08-12T08:16:00+10:00,2023-08-12,08:16,0,1,1
68,2023-08-12T08:18:00+10:00,2023-08-12,08:18,1,1,2
72,2023-08-12T08:12:00+10:00,2023-08-12,08:12,1,6,7
72,2023-08-12T08:14:00+10:00,2023-08-12,08:14,0,1,1
72,2023-08-12T08:15:00+10:00,2023-08-12,08:15,1,0,1
72,2023-08-12T08:22:00+10:00,2023-08-12,08:22,0,2,2
72,2023-08-12T08:24:00+10:00,2023-08-12,08:24,2,3,5
76,2023-08-12T08:10:00+10:00,2023-08-12,08:10,0,1,1
76,2023-08-12T08:17:00+10:00,2023-08-12,08:17,1,0,1
76,2023-08-12T08:22:00+10:00,2023-08-12,08:22,1,1,2
79,2023-08-12T08:11:00+10:00,2023-08-12,08:11,0,2,2
79,2023-08-12T08:14:00+10:00,2023-08-12,08:14,1,1,2
79,2023-08-12T08:15:00+10:00,2023-08-12,08:15,0,2,2
79,2023-08-12T08:16:00+10:00,2023-08-12,08:16,0,3,3
79,2023-08-12T08:17:00+10:00,2023-08-12,08:17,0,5,5
79,2023-08-12T08:19:00+10:00,2023-08-12,08:19,4,0,4
79,2023-08-12T08:20:00+10:00,2023-08-12,08:20,0,4,4
79,2023-08-12T08:21:00+10:00,2023-08-12,08:21,0,1,1
79,2023-08-12T08:23:00+10:00,2023-08-12,08:23,1,0,1
85,2023-08-12T08:10:00+10:00,2023-08-12,08:10,1,0,1
85,2023-08-12T08:14:00+10:00,2023-08-12,08:14,1,0,1
85,2023-08-12T08:19:00+10:00,2023-08-12,08:19,0,2,2
85,2023-08-12T08:21:00+10:00,2023-08-12,08:21,1,0,1
86,2023-08-12T08:12:00+10:00,2023-08-12,08:12,3,0,3
86,2023-08-12T08:17:00+10:00,2023-08-12,08:17,1,0,1
117,2023-08-12T08:20:00+10:00,2023-08-12,08:20,2,3,5
122,2023-08-12T08:15:00+10:00,2023-08-12,08:15,0,3,3
122,2023-08-12T08:17:00+10:00,2023-08-12,08:17,1,0,1
122,2023-08-12T08:18:00+10:00,2023-08-12,08:18,1,0,1
3,2023-08-12T08:32:00+10:00,2023-08-12,08:32,2,3,5
3,2023-08-12T08:36:00+10:00,2023-08-12,08:36,4,2,6
4,2023-08-12T08:26:00+10:00,2023-08-12,08:26,3,3,6
4,2023-08-12T08:27:00+10:00,2023-08-12,08:27,1,8,9
4,2023-08-12T08:31:00+10:00,2023-08-12,08:31,7,7,14
4,2023-08-12T08:34:00+10:00,2023-08-12,08:34,10,4,14
4,2023-08-12T08:37:00+10:00,2023-08-12,08:37,5,3,8
4,2023-08-12T08:38:00+10:00,2023-08-12,08:38,7,1,8
4,2023-08-12T08:39:00+10:00,2023-08-12,08:39,3,1,4
6,2023-08-12T08:25:00+10:00,2023-08-12,08:25,3,4,7
6,2023-08-12T08:28:00+10:00,2023-08-12,08:28,1,2,3
6,2023-08-12T08:30:00+10:00,2023-08-12,08:30,6,5,11
6,2023-08-12T08:34:00+10:00,2023-08-12,08:34,3,3,6
8,2023-08-12T08:29:00+10:00,2023-08-12,08:29,2,2,4
8,2023-08-12T08:30:00+10:00,2023-08-12,08:30,0,1,1
8,2023-08-12T08:33:00+10:00,2023-08-12,08:33,1,0,1
14,2023-08-12T08:26:00+10:00,2023-08-12,08:26,2,2,4
14,2023-08-12T08:32:00+10:00,2023-08-12,08:32,3,1,4
14,2023-08-12T08:37:00+10:00,2023-08-12,08:37,5,1,6
14,2023-08-12T08:39:00+10:00,2023-08-12,08:39,0,1,1
21,2023-08-12T08:30:00+10:00,2023-08-12,08:30,2,0,2
21,2023-08-12T08:36:00+10:00,2023-08-12,08:36,0,3,3
21,2023-08-12T08:37:00+10:00,2023-08-12,08:37,1,0,1
28,2023-08-12T08:26:00+10:00,2023-08-12,08:26,0,1,1
28,2023-08-12T08:28:00+10:00,2023-08-12,08:28,0,1,1
28,2023-08-12T08:33:00+10:00,2023-08-12,08:33,2,1,3
28,2023-08-12T08:36:00+10:00,2023-08-12,08:36,2,0,2
28,2023-08-12T08:39:00+10:00,2023-08-12,08:39,1,1,2
29,2023-08-12T08:25:00+10:00,2023-08-12,08:25,1,3,4
29,2023-08-12T08:27:00+10:00,2023-08-12,08:27,1,1,2
29,2023-08-12T08:30:00+10:00,2023-08-12,08:30,0,4,4
29,2023-08-12T08:32:00+10:00,2023-08-12,08:32,1,2,3
29,2023-08-12T08:35:00+10:00,2023-08-12,08:35,1,1,2
29,2023-08-12T08:36:00+10:00,2023-08-12,08:36,3,0,3
29,2023-08-12T08:38:00+10:00,2023-08-12,08:38,3,2,5
39,2023-08-12T08:25:00+10:00,2023-08-12,08:25,1,0,1
39,2023-08-12T08:28:00+10:00,2023-08-12,08:28,2,2,4
39,2023-08-12T08:31:00+10:00,2023-08-12,08:31,1,3,4
39,2023-08-12T08:35:00+10:00,2023-08-12,08:35,0,1,1
41,2023-08-12T08:25:00+10:00,2023-08-12,08:25,7,2,9
41,2023-08-12T08:26:00+10:00,2023-08-12,08:26,5,4,9
41,2023-08-12T08:29:00+10:00,2023-08-12,08:29,12,3,15
41,2023-08-12T08:30:00+10:00,2023-08-12,08:30,10,7,17
41,2023-08-12T08:31:00+10:00,2023-08-12,08:31,5,3,8
41,2023-08-12T08:32:00+10:00,2023-08-12,08:32,25,1,26
41,2023-08-12T08:38:00+10:00,2023-08-12,08:38,3,2,5
54,2023-08-12T08:28:00+10:00,2023-08-12,08:28,1,0,1
54,2023-08-12T08:34:00+10:00,2023-08-12,08:34,2,2,4
55,2023-08-12T08:25:00+10:00,2023-08-12,08:25,1,5,6
55,2023-08-12T08:31:00+10:00,2023-08-12,08:31,4,5,9
55,2023-08-12T08:33:00+10:00,2023-08-12,08:33,0,6,6
55,2023-08-12T08:35:00+10:00,2023-08-12,08:35,4,9,13
55,2023-08-12T08:36:00+10:00,2023-08-12,08:36,3,6,9
55,2023-08-12T08:37:00+10:00,2023-08-12,08:37,2,6,8
59,2023-08-12T08:35:00+10:00,2023-08-12,08:35,6,4,10
61,2023-08-12T08:25:00+10:00,2023-08-12,08:25,1,7,8
65,2023-08-12T08:31:00+10:00,2023-08-12,08:31,0,1,1
65,2023-08-12T08:33:00+10:00,2023-08-12,08:33,0,1,1
65,2023-08-12T08:34:00+10:00,2023-08-12,08:34,1,0,1
65,2023-08-12T08:38:00+10:00,2023-08-12,08:38,1,1,2
66,2023-08-12T08:26:00+10:00,2023-08-12,08:26,0,3,3
66,2023-08-12T08:29:00+10:00,2023-08-12,08:29,0,1,1
66,2023-08-12T08:30:00+10:00,2023-08-12,08:30,1,3,4
66,2023-08-12T08:31:00+10:00,2023-08-12,08:31,1,2,3
66,2023-08-12T08:32:00+10:00,2023-08-12,08:32,0,1,1
66,2023-08-12T08:33:00+10:00,2023-08-12,08:33,1,6,7
66,2023-08-12T08:36:00+10:00,2023-08-12,08:36,3,0,3
66,2023-08-12T08:37:00+10:00,2023-08-12,08:37,0,1,1
66,2023-08-12T08:38:00+10:00,2023-08-12,08:38,1,5,6
66,2023-08-12T08:39:00+10:00,2023-08-12,08:39,3,2,5
69,2023-08-12T08:32:00+10:00,2023-08-12,08:32,1,1,2
69,2023-08-12T08:34:00+10:00,2023-08-12,08:34,2,0,2
69,2023-08-12T08:36:00+10:00,2023-08-12,08:36,3,1,4
69,2023-08-12T08:37:00+10:00,2023-08-12,08:37,1,2,3
69,2023-08-12T08:39:00+10:00,2023-08-12,08:39,4,1,5
70,2023-08-12T08:29:00+10:00,2023-08-12,08:29,0,1,1
70,2023-08-12T08:30:00+10:00,2023-08-12,08:30,1,4,5
70,2023-08-12T08:34:00+10:00,2023-08-12,08:34,0,2,2
70,2023-08-12T08:35:00+10:00,2023-08-12,08:35,1,0,1
75,2023-08-12T08:30:00+10:00,2023-08-12,08:30,2,1,3
75,2023-08-12T08:34:00+10:00,2023-08-12,08:34,1,0,1
77,2023-08-12T08:28:00+10:00,2023-08-12,08:28,0,1,1
77,2023-08-12T08:29:00+10:00,2023-08-12,08:29,0,2,2
77,2023-08-12T08:30:00+10:00,2023-08-12,08:30,0,2,2
77,2023-08-12T08:34:00+10:00,2023-08-12,08:34,2,0,2
78,2023-08-12T08:35:00+10:00,2023-08-12,08:35,0,5,5
84,2023-08-12T08:30:00+10:00,2023-08-12,08:30,31,15,46
87,2023-08-12T08:25:00+10:00,2023-08-12,08:25,0,1,1
87,2023-08-12T08:35:00+10:00,2023-08-12,08:35,2,0,2
87,2023-08-12T08:36:00+10:00,2023-08-12,08:36,1,0,1
107,2023-08-12T08:25:00+10:00,2023-08-12,08:25,2,3,5
108,2023-08-12T08:29:00+10:00,2023-08-12,08:29,2,0,2
108,2023-08-12T08:30:00+10:00,2023-08-12,08:30,2,1,3
108,2023-08-12T08:34:00+10:00,2023-08-12,08:34,3,2,5
108,2023-08-12T08:37:00+10:00,2023-08-12,08:37,1,2,3
118,2023-08-12T08:35:00+10:00,2023-08-12,08:35,2,1,3
1,2023-08-12T08:26:00+10:00,2023-08-12,08:26,5,1,6
1,2023-08-12T08:27:00+10:00,2023-08-12,08:27,2,0,2
1,2023-08-12T08:35:00+10:00,2023-08-12,08:35,0,1,1
1,2023-08-12T08:37:00+10:00,2023-08-12,08:37,2,4,6
2,2023-08-12T08:28:00+10:00,2023-08-12,08:28,0,1,1
2,2023-08-12T08:35:00+10:00,2023-08-12,08:35,0,2,2
7,2023-08-12T08:26:00+10:00,2023-08-12,08:26,2,3,5
7,2023-08-12T08:29:00+10:00,2023-08-12,08:29,1,0,1
7,2023-08-12T08:31:00+10:00,2023-08-12,08:31,0,1,1
7,2023-08-12T08:32:00+10:00,2023-08-12,08:32,1,1,2
7,2023-08-12T08:35:00+10:00,2023-08-12,08:35,1,0,1
7,2023-08-12T08:37:00+10:00,2023-08-12,08:37,0,1,1
9,2023-08-12T08:27:00+10:00,2023-08-12,08:27,0,2,2
9,2023-08-12T08:30:00+10:00,2023-08-12,08:30,3,1,4
9,2023-08-12T08:37:00+10:00,2023-08-12,08:37,0,3,3
10,2023-08-12T08:27:00+10:00,2023-08-12,08:27,0,1,1
10,2023-08-12T08:30:00+10:00,2023-08-12,08:30,2,2,4
10,2023-08-12T08:32:00+10:00,2023-08-12,08:32,0,1,1
11,2023-08-12T08:33:00+10:00,2023-08-12,08:33,0,1,1
11,2023-08-12T08:35:00+10:00,2023-08-12,08:35,9,1,10
11,2023-08-12T08:37:00+10:00,2023-08-12,08:37,0,1,1
12,2023-08-12T08:25:00+10:00,2023-08-12,08:25,0,1,1
12,2023-08-12T08:29:00+10:00,2023-08-12,08:29,0,1,1
12,2023-08-12T08:32:00+10:00,2023-08-12,08:32,2,0,2
12,2023-08-12T08:33:00+10:00,2023-08-12,08:33,0,3,3
12,2023-08-12T08:35:00+10:00,2023-08-12,08:35,2,1,3
12,2023-08-12T08:37:00+10:00,2023-08-12,08:37,1,4,5
12,2023-08-12T08:38:00+10:00,2023-08-12,08:38,0,3,3
17,2023-08-12T08:27:00+10:00,2023-08-12,08:27,0,1,1
17,2023-08-12T08:30:00+10:00,2023-08-12,08:30,2,1,3
17,2023-08-12T08:34:00+10:00,2023-08-12,08:34,1,1,2
17,2023-08-12T08:36:00+10:00,2023-08-12,08:36,1,0,1
17,2023-08-12T08:38:00+10:00,2023-08-12,08:38,0,1,1
17,2023-08-12T08:39:00+10:00,2023-08-12,08:39,2,1,3
18,2023-08-12T08:29:00+10:00,2023-08-12,08:29,0,1,1
24,2023-08-12T08:26:00+10:00,2023-08-12,08:26,3,1,4
24,2023-08-12T08:28:00+10:00,2023-08-12,08:28,3,7,10
24,2023-08-12T08:29:00+10:00,2023-08-12,08:29,7,3,10
24,2023-08-12T08:36:00+10:00,2023-08-12,08:36,2,1,3
24,2023-08-12T08:38:00+10:00,2023-08-12,08:38,8,0,8
27,2023-08-12T08:25:00+10:00,2023-08-12,08:25,0,3,3
27,2023-08-12T08:29:00+10:00,2023-08-12,08:29,0,3,3
27,2023-08-12T08:31:00+10:00,2023-08-12,08:31,2,0,2
27,2023-08-12T08:32:00+10:00,2023-08-12,08:32,0,1,1
27,2023-08-12T08:36:00+10:00,2023-08-12,08:36,0,1,1
35,2023-08-12T08:25:00+10:00,2023-08-12,08:25,2,6,8
35,2023-08-12T08:29:00+10:00,2023-08-12,08:29,4,3,7
35,2023-08-12T08:30:00+10:00,2023-08-12,08:30,2,4,6
35,2023-08-12T08:32:00+10:00,2023-08-12,08:32,1,5,6
35,2023-08-12T08:34:00+10:00,2023-08-12,08:34,5,0,5
35,2023-08-12T08:37:00+10:00,2023-08-12,08:37,3,6,9
35,2023-08-12T08:39:00+10:00,2023-08-12,08:39,2,2,4
53,2023-08-12T08:29:00+10:00,2023-08-12,08:29,2,1,3
53,2023-08-12T08:32:00+10:00,2023-08-12,08:32,3,0,3
53,2023-08-12T08:33:00+10:00,2023-08-12,08:33,12,3,15
53,2023-08-12T08:36:00+10:00,2023-08-12,08:36,5,0,5
53,2023-08-12T08:37:00+10:00,2023-08-12,08:37,4,4,8
56,2023-08-12T08:26:00+10:00,2023-08-12,08:26,3,1,4
56,2023-08-12T08:30:00+10:00,2023-08-12,08:30,0,5,5
56,2023-08-12T08:35:00+10:00,2023-08-12,08:35,2,1,3
56,2023-08-12T08:36:00+10:00,2023-08-12,08:36,1,1,2
57,2023-08-12T08:26:00+10:00,2023-08-12,08:26,0,1,1
57,2023-08-12T08:27:00+10:00,2023-08-12,08:27,1,0,1
57,2023-08-12T08:37:00+10:00,2023-08-12,08:37,0,1,1
57,2023-08-12T08:38:00+10:00,2023-08-12,08:38,5,0,5
58,2023-08-12T08:25:00+10:00,2023-08-12,08:25,2,0,2
58,2023-08-12T08:26:00+10:00,2023-08-12,08:26,2,1,3
58,2023-08-12T08:28:00+10:00,2023-08-12,08:28,4,1,5
58,2023-08-12T08:29:00+10:00,2023-08-12,08:29,4,1,5
58,2023-08-12T08:30:00+10:00,2023-08-12,08:30,0,2,2
58,2023-08-12T08:39:00+10:00,2023-08-12,08:39,3,5,8
62,2023-08-12T08:28:00+10:00,2023-08-12,08:28,0,1,1
62,2023-08-12T08:39:00+10:00,2023-08-12,08:39,0,1,1
63,2023-08-12T08:29:00+10:00,2023-08-12,08:29,2,0,2
63,2023-08-12T08:32:00+10:00,2023-08-12,08:32,2,4,6
63,2023-08-12T08:38:00+10:00,2023-08-12,08:38,1,2,3
67,2023-08-12T08:25:00+10:00,2023-08-12,08:25,5,3,8
67,2023-08-12T08:27:00+10:00,2023-08-12,08:27,1,3,4
67,2023-08-12T08:29:00+10:00,2023-08-12,08:29,5,6,11
67,2023-08-12T08:33:00+10:00,2023-08-12,08:33,4,1,5
67,2023-08-12T08:34:00+10:00,2023-08-12,08:34,1,1,2
67,2023-08-12T08:37:00+10:00,2023-08-12,08:37,1,6,7
68,2023-08-12T08:27:00+10:00,2023-08-12,08:27,3,1,4
68,2023-08-12T08:28:00+10:00,2023-08-12,08:28,0,1,1
68,2023-08-12T08:31:00+10:00,2023-08-12,08:31,2,0,2
68,2023-08-12T08:33:00+10:00,2023-08-12,08:33,0,2,2
68,2023-08-12T08:36:00+10:00,2023-08-12,08:36,2,0,2
68,2023-08-12T08:39:00+10:00,2023-08-12,08:39,2,0,2
72,2023-08-12T08:28:00+10:00,2023-08-12,08:28,0,1,1
72,2023-08-12T08:32:00+10:00,2023-08-12,08:32,0,2,2
72,2023-08-12T08:33:00+10:00,2023-08-12,08:33,3,3,6
76,2023-08-12T08:30:00+10:00,2023-08-12,08:30,1,0,1
76,2023-08-12T08:31:00+10:00,2023-08-12,08:31,1,0,1
76,2023-08-12T08:32:00+10:00,2023-08-12,08:32,1,0,1
76,2023-08-12T08:37:00+10:00,2023-08-12,08:37,0,1,1
79,2023-08-12T08:28:00+10:00,2023-08-12,08:28,2,5,7
79,2023-08-12T08:30:00+10:00,2023-08-12,08:30,6,5,11
79,2023-08-12T08:33:00+10:00,2023-08-12,08:33,0,1,1
79,2023-08-12T08:34:00+10:00,2023-08-12,08:34,1,0,1
79,2023-08-12T08:35:00+10:00,2023-08-12,08:35,5,1,6
79,2023-08-12T08:36:00+10:00,2023-08-12,08:36,6,6,12
79,2023-08-12T08:38:00+10:00,2023-08-12,08:38,5,3,8
79,2023-08-12T08:39:00+10:00,2023-08-12,08:39,3,0,3
85,2023-08-12T08:29:00+10:00,2023-08-12,08:29,0,1,1
85,2023-08-12T08:35:00+10:00,2023-08-12,08:35,2,1,3
85,2023-08-12T08:39:00+10:00,2023-08-12,08:39,3,0,3
86,2023-08-12T08:31:00+10:00,2023-08-12,08:31,0,2,2
86,2023-08-12T08:35:00+10:00,2023-08-12,08:35,2,0,2
109,2023-08-12T08:25:00+10:00,2023-08-12,08:25,0,5,5
109,2023-08-12T08:30:00+10:00,2023-08-12,08:30,2,3,5
122,2023-08-12T08:27:00+10:00,2023-08-12,08:27,3,0,3
122,2023-08-12T08:29:00+10:00,2023-08-12,08:29,0,1,1
122,2023-08-12T08:31:00+10:00,2023-08-12,08:31,0,2,2
122,2023-08-12T08:32:00+10:00,2023-08-12,08:32,2,0,2
122,2023-08-12T08:34:00+10:00,2023-08-12,08:34,1,0,1
122,2023-08-12T08:39:00+10:00,2023-08-12,08:39,1,0,1
3,2023-08-12T08:42:00+10:00,2023-08-12,08:42,2,3,5
3,2023-08-12T08:50:00+10:00,2023-08-12,08:50,1,3,4
3,2023-08-12T08:52:00+10:00,2023-08-12,08:52,1,4,5
4,2023-08-12T08:49:00+10:00,2023-08-12,08:49,2,0,2
4,2023-08-12T08:50:00+10:00,2023-08-12,08:50,2,5,7
4,2023-08-12T08:52:00+10:00,2023-08-12,08:52,12,5,17
4,2023-08-12T08:54:00+10:00,2023-08-12,08:54,5,5,10
6,2023-08-12T08:44:00+10:00,2023-08-12,08:44,4,0,4
6,2023-08-12T08:45:00+10:00,2023-08-12,08:45,3,1,4
6,2023-08-12T08:47:00+10:00,2023-08-12,08:47,3,3,6
6,2023-08-12T08:51:00+10:00,2023-08-12,08:51,4,3,7
6,2023-08-12T08:52:00+10:00,2023-08-12,08:52,3,1,4
6,2023-08-12T08:54:00+10:00,2023-08-12,08:54,4,3,7
8,2023-08-12T08:41:00+10:00,2023-08-12,08:41,0,1,1
8,2023-08-12T08:47:00+10:00,2023-08-12,08:47,0,12,12
8,2023-08-12T08:48:00+10:00,2023-08-12,08:48,1,3,4
8,2023-08-12T08:50:00+10:00,2023-08-12,08:50,0,1,1
8,2023-08-12T08:54:00+10:00,2023-08-12,08:54,2,3,5
14,2023-08-12T08:40:00+10:00,2023-08-12,08:40,2,0,2
14,2023-08-12T08:42:00+10:00,2023-08-12,08:42,4,2,6
14,2023-08-12T08:44:00+10:00,2023-08-12,08:44,1,2,3
14,2023-08-12T08:45:00+10:00,2023-08-12,08:45,4,2,6
14,2023-08-12T08:49:00+10:00,2023-08-12,08:49,5,1,6
14,2023-08-12T08:50:00+10:00,2023-08-12,08:50,4,0,4
14,2023-08-12T08:54:00+10:00,2023-08-12,08:54,1,1,2
21,2023-08-12T08:42:00+10:00,2023-08-12,08:42,3,2,5
21,2023-08-12T08:44:00+10:00,2023-08-12,08:44,1,0,1
21,2023-08-12T08:46:00+10:00,2023-08-12,08:46,5,0,5
21,2023-08-12T08:48:00+10:00,2023-08-12,08:48,2,1,3
21,2023-08-12T08:50:00+10:00,2023-08-12,08:50,5,1,6
21,2023-08-12T08:52:00+10:00,2023-08-12,08:52,2,0,2
28,2023-08-12T08:40:00+10:00,2023-08-12,08:40,3,0,3
28,2023-08-12T08:42:00+10:00,2023-08-12,08:42,1,0,1
28,2023-08-12T08:44:00+10:00,2023-08-12,08:44,2,0,2
28,2023-08-12T08:45:00+10:00,2023-08-12,08:45,0,1,1
28,2023-08-12T08:46:00+10:00,2023-08-12,08:46,1,1,2
28,2023-08-12T08:49:00+10:00,2023-08-12,08:49,0,2,2
28,2023-08-12T08:51:00+10:00,2023-08-12,08:51,0,3,3
28,2023-08-12T08:52:00+10:00,2023-08-12,08:52,3,5,8
28,2023-08-12T08:54:00+10:00,2023-08-12,08:54,0,2,2
29,2023-08-12T08:41:00+10:00,2023-08-12,08:41,1,8,9
29,2023-08-12T08:44:00+10:00,2023-08-12,08:44,0,3,3
29,2023-08-12T08:47:00+10:00,2023-08-12,08:47,1,0,1
29,2023-08-12T08:49:00+10:00,2023-08-12,08:49,1,3,4
29,2023-08-12T08:50:00+10:00,2023-08-12,08:50,4,0,4
29,2023-08-12T08:52:00+10:00,2023-08-12,08:52,1,2,3
29,2023-08-12T08:54:00+10:00,2023-08-12,08:54,1,0,1
39,2023-08-12T08:51:00+10:00,2023-08-12,08:51,1,0,1
41,2023-08-12T08:43:00+10:00,2023-08-12,08:43,11,13,24
41,2023-08-12T08:47:00+10:00,2023-08-12,08:47,8,0,8
41,2023-08-12T08:48:00+10:00,2023-08-12,08:48,26,1,27
41,2023-08-12T08:52:00+10:00,2023-08-12,08:52,6,4,10
54,2023-08-12T08:40:00+10:00,2023-08-12,08:40,0,2,2
54,2023-08-12T08:44:00+10:00,2023-08-12,08:44,2,0,2
54,2023-08-12T08:46:00+10:00,2023-08-12,08:46,2,0,2
54,2023-08-12T08:53:00+10:00,2023-08-12,08:53,0,2,2
55,2023-08-12T08:44:00+10:00,2023-08-12,08:44,0,11,11
55,2023-08-12T08:47:00+10:00,2023-08-12,08:47,5,2,7
55,2023-08-12T08:48:00+10:00,2023-08-12,08:48,0,4,4
61,2023-08-12T08:40:00+10:00,2023-08-12,08:40,3,3,6
61,2023-08-12T08:44:00+10:00,2023-08-12,08:44,4,2,6
61,2023-08-12T08:51:00+10:00,2023-08-12,08:51,1,0,1
65,2023-08-12T08:43:00+10:00,2023-08-12,08:43,3,0,3
65,2023-08-12T08:44:00+10:00,2023-08-12,08:44,3,1,4
65,2023-08-12T08:46:00+10:00,2023-08-12,08:46,4,3,7
65,2023-08-12T08:49:00+10:00,2023-08-12,08:49,4,1,5
65,2023-08-12T08:54:00+10:00,2023-08-12,08:54,1,2,3
66,2023-08-12T08:43:00+10:00,2023-08-12,08:43,0,1,1
66,2023-08-12T08:49:00+10:00,2023-08-12,08:49,1,2,3
66,2023-08-12T08:53:00+10:00,2023-08-12,08:53,1,3,4
66,2023-08-12T08:54:00+10:00,2023-08-12,08:54,1,3,4
69,2023-08-12T08:41:00+10:00,2023-08-12,08:41,0,6,6
69,2023-08-12T08:47:00+10:00,2023-08-12,08:47,0,1,1
69,2023-08-12T08:52:00+10:00,2023-08-12,08:52,1,0,1
70,2023-08-12T08:42:00+10:00,2023-08-12,08:42,0,1,1
70,2023-08-12T08:44:00+10:00,2023-08-12,08:44,3,0,3
70,2023-08-12T08:54:00+10:00,2023-08-12,08:54,2,1,3
71,2023-08-12T08:46:00+10:00,2023-08-12,08:46,1,1,2
71,2023-08-12T08:54:00+10:00,2023-08-12,08:54,1,0,1
75,2023-08-12T08:41:00+10:00,2023-08-12,08:41,0,1,1
75,2023-08-12T08:47:00+10:00,2023-08-12,08:47,0,2,2
77,2023-08-12T08:42:00+10:00,2023-08-12,08:42,2,2,4
78,2023-08-12T08:43:00+10:00,2023-08-12,08:43,0,3,3
78,2023-08-12T08:49:00+10:00,2023-08-12,08:49,1,0,1
78,2023-08-12T08:50:00+10:00,2023-08-12,08:50,1,0,1
78,2023-08-12T08:51:00+10:00,2023-08-12,08:51,1,1,2
78,2023-08-12T08:54:00+10:00,2023-08-12,08:54,1,0,1
87,2023-08-12T08:48:00+10:00,2023-08-12,08:48,2,0,2
107,2023-08-12T08:40:00+10:00,2023-08-12,08:40,5,13,18
108,2023-08-12T08:44:00+10:00,2023-08-12,08:44,0,1,1
108,2023-08-12T08:50:00+10:00,2023-08-12,08:50,3,0,3
118,2023-08-12T08:45:00+10:00,2023-08-12,08:45,0,2,2
1,2023-08-12T08:40:00+10:00,2023-08-12,08:40,1,5,6
1,2023-08-12T08:42:00+10:00,2023-08-12,08:42,1,10,11
1,2023-08-12T08:43:00+10:00,2023-08-12,08:43,2,2,4
1,2023-08-12T08:46:00+10:00,2023-08-12,08:46,1,9,10
1,2023-08-12T08:48:00+10:00,2023-08-12,08:48,1,2,3
1,2023-08-12T08:49:00+10:00,2023-08-12,08:49,4,7,11
1,2023-08-12T08:50:00+10:00,2023-08-12,08:50,2,10,12
2,2023-08-12T08:40:00+10:00,2023-08-12,08:40,1,1,2
2,2023-08-12T08:53:00+10:00,2023-08-12,08:53,1,1,2
2,2023-08-12T08:54:00+10:00,2023-08-12,08:54,2,0,2
7,2023-08-12T08:41:00+10:00,2023-08-12,08:41,1,0,1
7,2023-08-12T08:46:00+10:00,2023-08-12,08:46,1,3,4
7,2023-08-12T08:49:00+10:00,2023-08-12,08:49,1,0,1
7,2023-08-12T08:54:00+10:00,2023-08-12,08:54,2,4,6
9,2023-08-12T08:40:00+10:00,2023-08-12,08:40,0,3,3
9,2023-08-12T08:43:00+10:00,2023-08-12,08:43,0,1,1
9,2023-08-12T08:45:00+10:00,2023-08-12,08:45,0,1,1
9,2023-08-12T08:47:00+10:00,2023-08-12,08:47,0,1,1
9,2023-08-12T08:50:00+10:00,2023-08-12,08:50,1,5,6
9,2023-08-12T08:51:00+10:00,2023-08-12,08:51,0,2,2
9,2023-08-12T08:52:00+10:00,2023-08-12,08:52,0,8,8
10,2023-08-12T08:50:00+10:00,2023-08-12,08:50,1,0,1
10,2023-08-12T08:53:00+10:00,2023-08-12,08:53,1,1,2
11,2023-08-12T08:43:00+10:00,2023-08-12,08:43,1,0,1
12,2023-08-12T08:41:00+10:00,2023-08-12,08:41,1,1,2
12,2023-08-12T08:43:00+10:00,2023-08-12,08:43,1,0,1
12,2023-08-12T08:48:00+10:00,2023-08-12,08:48,3,1,4
12,2023-08-12T08:49:00+10:00,2023-08-12,08:49,3,0,3
17,2023-08-12T08:41:00+10:00,2023-08-12,08:41,2,0,2
17,2023-08-12T08:43:00+10:00,2023-08-12,08:43,0,2,2
17,2023-08-12T08:47:00+10:00,2023-08-12,08:47,2,0,2
17,2023-08-12T08:53:00+10:00,2023-08-12,08:53,1,2,3
17,2023-08-12T08:54:00+10:00,2023-08-12,08:54,0,3,3
24,2023-08-12T08:46:00+10:00,2023-08-12,08:46,4,0,4
24,2023-08-12T08:49:00+10:00,2023-08-12,08:49,3,4,7
24,2023-08-12T08:50:00+10:00,2023-08-12,08:50,8,2,10
24,2023-08-12T08:52:00+10:00,2023-08-12,08:52,3,4,7
24,2023-08-12T08:53:00+10:00,2023-08-12,08:53,1,1,2
24,2023-08-12T08:54:00+10:00,2023-08-12,08:54,8,2,10
27,2023-08-12T08:41:00+10:00,2023-08-12,08:41,1,0,1
27,2023-08-12T08:45:00+10:00,2023-08-12,08:45,3,2,5
27,2023-08-12T08:48:00+10:00,2023-08-12,08:48,7,1,8
27,2023-08-12T08:50:00+10:00,2023-08-12,08:50,4,1,5
27,2023-08-12T08:51:00+10:00,2023-08-12,08:51,0,1,1
27,2023-08-12T08:52:00+10:00,2023-08-12,08:52,2,7,9
27,2023-08-12T08:54:00+10:00,2023-08-12,08:54,2,0,2
35,2023-08-12T08:40:00+10:00,2023-08-12,08:40,3,3,6
35,2023-08-12T08:41:00+10:00,2023-08-12,08:41,8,3,11
35,2023-08-12T08:42:00+10:00,2023-08-12,08:42,6,4,10
35,2023-08-12T08:43:00+10:00,2023-08-12,08:43,6,2,8
35,2023-08-12T08:50:00+10:00,2023-08-12,08:50,3,5,8
35,2023-08-12T08:52:00+10:00,2023-08-12,08:52,4,3,7
53,2023-08-12T08:42:00+10:00,2023-08-12,08:42,5,1,6
53,2023-08-12T08:47:00+10:00,2023-08-12,08:47,2,2,4
56,2023-08-12T08:41:00+10:00,2023-08-12,08:41,0,1,1
56,2023-08-12T08:45:00+10:00,2023-08-12,08:45,0,2,2
56,2023-08-12T08:46:00+10:00,2023-08-12,08:46,1,0,1
56,2023-08-12T08:49:00+10:00,2023-08-12,08:49,4,1,5
56,2023-08-12T08:52:00+10:00,2023-08-12,08:52,2,1,3
56,2023-08-12T08:54:00+10:00,2023-08-12,08:54,0,2,2
57,2023-08-12T08:40:00+10:00,2023-08-12,08:40,1,3,4
57,2023-08-12T08:45:00+10:00,2023-08-12,08:45,0,1,1
57,2023-08-12T08:54:00+10:00,2023-08-12,08:54,3,0,3
58,2023-08-12T08:42:00+10:00,2023-08-12,08:42,18,3,21
58,2023-08-12T08:44:00+10:00,2023-08-12,08:44,5,0,5
58,2023-08-12T08:45:00+10:00,2023-08-12,08:45,4,0,4
58,2023-08-12T08:47:00+10:00,2023-08-12,08:47,8,6,14
58,2023-08-12T08:52:00+10:00,2023-08-12,08:52,3,2,5
58,2023-08-12T08:53:00+10:00,2023-08-12,08:53,2,1,3
58,2023-08-12T08:54:00+10:00,2023-08-12,08:54,6,1,7
62,2023-08-12T08:46:00+10:00,2023-08-12,08:46,1,0,1
62,2023-08-12T08:52:00+10:00,2023-08-12,08:52,0,1,1
62,2023-08-12T08:53:00+10:00,2023-08-12,08:53,0,1,1
63,2023-08-12T08:43:00+10:00,2023-08-12,08:43,2,2,4
63,2023-08-12T08:44:00+10:00,2023-08-12,08:44,2,3,5
63,2023-08-12T08:45:00+10:00,2023-08-12,08:45,3,1,4
63,2023-08-12T08:47:00+10:00,2023-08-12,08:47,3,2,5
63,2023-08-12T08:48:00+10:00,2023-08-12,08:48,3,2,5
63,2023-08-12T08:53:00+10:00,2023-08-12,08:53,0,3,3
67,2023-08-12T08:44:00+10:00,2023-08-12,08:44,2,2,4
67,2023-08-12T08:47:00+10:00,2023-08-12,08:47,9,10,19
67,2023-08-12T08:48:00+10:00,2023-08-12,08:48,6,3,9
67,2023-08-12T08:49:00+10:00,2023-08-12,08:49,2,4,6
67,2023-08-12T08:51:00+10:00,2023-08-12,08:51,5,1,6
67,2023-08-12T08:52:00+10:00,2023-08-12,08:52,2,3,5
68,2023-08-12T08:40:00+10:00,2023-08-12,08:40,2,3,5
68,2023-08-12T08:42:00+10:00,2023-08-12,08:42,1,1,2
68,2023-08-12T08:47:00+10:00,2023-08-12,08:47,0,1,1
68,2023-08-12T08:51:00+10:00,2023-08-12,08:51,1,2,3
68,2023-08-12T08:52:00+10:00,2023-08-12,08:52,0,3,3
72,2023-08-12T08:41:00+10:00,2023-08-12,08:41,0,3,3
72,2023-08-12T08:52:00+10:00,2023-08-12,08:52,2,4,6
76,2023-08-12T08:54:00+10:00,2023-08-12,08:54,1,0,1
79,2023-08-12T08:40:00+10:00,2023-08-12,08:40,4,1,5
79,2023-08-12T08:42:00+10:00,2023-08-12,08:42,2,1,3
79,2023-08-12T08:45:00+10:00,2023-08-12,08:45,5,2,7
79,2023-08-12T08:47:00+10:00,2023-08-12,08:47,5,1,6
85,2023-08-12T08:43:00+10:00,2023-08-12,08:43,0,2,2
85,2023-08-12T08:44:00+10:00,2023-08-12,08:44,1,0,1
85,2023-08-12T08:47:00+10:00,2023-08-12,08:47,2,0,2
85,2023-08-12T08:48:00+10:00,2023-08-12,08:48,0,1,1
85,2023-08-12T08:50:00+10:00,2023-08-12,08:50,0,1,1
85,2023-08-12T08:54:00+10:00,2023-08-12,08:54,0,1,1
86,2023-08-12T08:40:00+10:00,2023-08-12,08:40,0,1,1
86,2023-08-12T08:41:00+10:00,2023-08-12,08:41,3,2,5
109,2023-08-12T08:40:00+10:00,2023-08-12,08:40,8,3,11
109,2023-08-12T08:50:00+10:00,2023-08-12,08:50,4,18,22
3,2023-08-12T08:58:00+10:00,2023-08-12,08:58,2,3,5
3,2023-08-12T08:59:00+10:00,2023-08-12,08:59,6,3,9
3,2023-08-12T09:08:00+10:00,2023-08-12,09:08,1,10,11
4,2023-08-12T08:59:00+10:00,2023-08-12,08:59,7,2,9
4,2023-08-12T09:02:00+10:00,2023-08-12,09:02,5,0,5
4,2023-08-12T09:03:00+10:00,2023-08-12,09:03,5,0,5
4,2023-08-12T09:04:00+10:00,2023-08-12,09:04,4,2,6
4,2023-08-12T09:06:00+10:00,2023-08-12,09:06,2,4,6
4,2023-08-12T09:07:00+10:00,2023-08-12,09:07,10,4,14
6,2023-08-12T08:55:00+10:00,2023-08-12,08:55,1,0,1
6,2023-08-12T08:58:00+10:00,2023-08-12,08:58,5,3,8
6,2023-08-12T08:59:00+10:00,2023-08-12,08:59,5,5,10
6,2023-08-12T09:01:00+10:00,2023-08-12,09:01,5,1,6
6,2023-08-12T09:06:00+10:00,2023-08-12,09:06,1,2,3
6,2023-08-12T09:08:00+10:00,2023-08-12,09:08,9,1,10
6,2023-08-12T09:09:00+10:00,2023-08-12,09:09,5,0,5
8,2023-08-12T08:55:00+10:00,2023-08-12,08:55,1,3,4
8,2023-08-12T08:58:00+10:00,2023-08-12,08:58,0,2,2
8,2023-08-12T08:59:00+10:00,2023-08-12,08:59,2,4,6
8,2023-08-12T09:00:00+10:00,2023-08-12,09:00,0,4,4
8,2023-08-12T09:03:00+10:00,2023-08-12,09:03,1,0,1
8,2023-08-12T09:04:00+10:00,2023-08-12,09:04,0,1,1
8,2023-08-12T09:07:00+10:00,2023-08-12,09:07,14,1,15
8,2023-08-12T09:09:00+10:00,2023-08-12,09:09,1,1,2
14,2023-08-12T08:58:00+10:00,2023-08-12,08:58,3,0,3
14,2023-08-12T09:00:00+10:00,2023-08-12,09:00,4,5,9
14,2023-08-12T09:06:00+10:00,2023-08-12,09:06,4,2,6
21,2023-08-12T08:57:00+10:00,2023-08-12,08:57,2,1,3
21,2023-08-12T08:58:00+10:00,2023-08-12,08:58,0,1,1
21,2023-08-12T08:59:00+10:00,2023-08-12,08:59,1,0,1
21,2023-08-12T09:02:00+10:00,2023-08-12,09:02,1,3,4
21,2023-08-12T09:06:00+10:00,2023-08-12,09:06,3,5,8
28,2023-08-12T08:59:00+10:00,2023-08-12,08:59,2,2,4
28,2023-08-12T09:01:00+10:00,2023-08-12,09:01,3,2,5
28,2023-08-12T09:02:00+10:00,2023-08-12,09:02,4,1,5
28,2023-08-12T09:03:00+10:00,2023-08-12,09:03,2,2,4
28,2023-08-12T09:05:00+10:00,2023-08-12,09:05,3,1,4
28,2023-08-12T09:06:00+10:00,2023-08-12,09:06,2,1,3
28,2023-08-12T09:08:00+10:00,2023-08-12,09:08,3,0,3
29,2023-08-12T08:55:00+10:00,2023-08-12,08:55,2,3,5
29,2023-08-12T08:59:00+10:00,2023-08-12,08:59,4,0,4
29,2023-08-12T09:03:00+10:00,2023-08-12,09:03,2,3,5
29,2023-08-12T09:07:00+10:00,2023-08-12,09:07,0,1,1
29,2023-08-12T09:09:00+10:00,2023-08-12,09:09,1,0,1
39,2023-08-12T08:55:00+10:00,2023-08-12,08:55,0,1,1
39,2023-08-12T09:00:00+10:00,2023-08-12,09:00,0,4,4
39,2023-08-12T09:06:00+10:00,2023-08-12,09:06,4,0,4
41,2023-08-12T08:59:00+10:00,2023-08-12,08:59,14,7,21
41,2023-08-12T09:01:00+10:00,2023-08-12,09:01,25,4,29
41,2023-08-12T09:06:00+10:00,2023-08-12,09:06,18,0,18
41,2023-08-12T09:09:00+10:00,2023-08-12,09:09,3,2,5
54,2023-08-12T08:57:00+10:00,2023-08-12,08:57,1,1,2
54,2023-08-12T08:58:00+10:00,2023-08-12,08:58,1,2,3
54,2023-08-12T09:02:00+10:00,2023-08-12,09:02,0,1,1
54,2023-08-12T09:03:00+10:00,2023-08-12,09:03,0,1,1
54,2023-08-12T09:05:00+10:00,2023-08-12,09:05,0,1,1
54,2023-08-12T09:06:00+10:00,2023-08-12,09:06,2,0,2
54,2023-08-12T09:07:00+10:00,2023-08-12,09:07,1,0,1
55,2023-08-12T08:58:00+10:00,2023-08-12,08:58,1,5,6
55,2023-08-12T09:00:00+10:00,2023-08-12,09:00,4,5,9
55,2023-08-12T09:03:00+10:00,2023-08-12,09:03,3,2,5
55,2023-08-12T09:04:00+10:00,2023-08-12,09:04,9,0,9
55,2023-08-12T09:07:00+10:00,2023-08-12,09:07,3,1,4
59,2023-08-12T09:00:00+10:00,2023-08-12,09:00,16,21,37
61,2023-08-12T08:56:00+10:00,2023-08-12,08:56,0,4,4
61,2023-08-12T08:59:00+10:00,2023-08-12,08:59,1,1,2
61,2023-08-12T09:03:00+10:00,2023-08-12,09:03,2,2,4
61,2023-08-12T09:04:00+10:00,2023-08-12,09:04,0,1,1
61,2023-08-12T09:08:00+10:00,2023-08-12,09:08,0,7,7
61,2023-08-12T09:09:00+10:00,2023-08-12,09:09,4,0,4
65,2023-08-12T08:55:00+10:00,2023-08-12,08:55,2,2,4
65,2023-08-12T08:58:00+10:00,2023-08-12,08:58,1,5,6
65,2023-08-12T09:03:00+10:00,2023-08-12,09:03,4,0,4
65,2023-08-12T09:09:00+10:00,2023-08-12,09:09,1,0,1
66,2023-08-12T08:55:00+10:00,2023-08-12,08:55,2,7,9
66,2023-08-12T08:57:00+10:00,2023-08-12,08:57,0,2,2
66,2023-08-12T08:58:00+10:00,2023-08-12,08:58,3,1,4
66,2023-08-12T09:00:00+10:00,2023-08-12,09:00,1,4,5
66,2023-08-12T09:02:00+10:00,2023-08-12,09:02,1,1,2
66,2023-08-12T09:06:00+10:00,2023-08-12,09:06,1,3,4
66,2023-08-12T09:07:00+10:00,2023-08-12,09:07,4,0,4
66,2023-08-12T09:08:00+10:00,2023-08-12,09:08,1,1,2
69,2023-08-12T08:55:00+10:00,2023-08-12,08:55,4,0,4
69,2023-08-12T08:56:00+10:00,2023-08-12,08:56,2,0,2
69,2023-08-12T09:00:00+10:00,2023-08-12,09:00,1,1,2
69,2023-08-12T09:01:00+10:00,2023-08-12,09:01,0,3,3
69,2023-08-12T09:09:00+10:00,2023-08-12,09:09,0,1,1
70,2023-08-12T08:55:00+10:00,2023-08-12,08:55,0,1,1
70,2023-08-12T08:56:00+10:00,2023-08-12,08:56,0,1,1
70,2023-08-12T08:59:00+10:00,2023-08-12,08:59,4,1,5
70,2023-08-12T09:00:00+10:00,2023-08-12,09:00,0,1,1
70,2023-08-12T09:04:00+10:00,2023-08-12,09:04,1,3,4
70,2023-08-12T09:06:00+10:00,2023-08-12,09:06,1,1,2
75,2023-08-12T09:04:00+10:00,2023-08-12,09:04,1,0,1
77,2023-08-12T09:00:00+10:00,2023-08-12,09:00,0,3,3
77,2023-08-12T09:02:00+10:00,2023-08-12,09:02,1,3,4
77,2023-08-12T09:03:00+10:00,2023-08-12,09:03,0,2,2
77,2023-08-12T09:07:00+10:00,2023-08-12,09:07,0,3,3
77,2023-08-12T09:09:00+10:00,2023-08-12,09:09,2,0,2
78,2023-08-12T08:55:00+10:00,2023-08-12,08:55,0,1,1
78,2023-08-12T09:04:00+10:00,2023-08-12,09:04,1,0,1
78,2023-08-12T09:05:00+10:00,2023-08-12,09:05,1,0,1
87,2023-08-12T08:55:00+10:00,2023-08-12,08:55,2,2,4
87,2023-08-12T09:00:00+10:00,2023-08-12,09:00,1,2,3
87,2023-08-12T09:01:00+10:00,2023-08-12,09:01,2,0,2
87,2023-08-12T09:05:00+10:00,2023-08-12,09:05,3,6,9
87,2023-08-12T09:07:00+10:00,2023-08-12,09:07,4,2,6
87,2023-08-12T09:08:00+10:00,2023-08-12,09:08,3,1,4
108,2023-08-12T09:04:00+10:00,2023-08-12,09:04,1,2,3
108,2023-08-12T09:07:00+10:00,2023-08-12,09:07,1,0,1
108,2023-08-12T09:09:00+10:00,2023-08-12,09:09,2,2,4
1,2023-08-12T08:56:00+10:00,2023-08-12,08:56,2,3,5
1,2023-08-12T08:58:00+10:00,2023-08-12,08:58,1,8,9
1,2023-08-12T09:00:00+10:00,2023-08-12,09:00,1,7,8
1,2023-08-12T09:02:00+10:00,2023-08-12,09:02,1,3,4
1,2023-08-12T09:03:00+10:00,2023-08-12,09:03,4,4,8
1,2023-08-12T09:04:00+10:00,2023-08-12,09:04,0,3,3
1,2023-08-12T09:05:00+10:00,2023-08-12,09:05,1,4,5
1,2023-08-12T09:08:00+10:00,2023-08-12,09:08,6,3,9
2,2023-08-12T08:59:00+10:00,2023-08-12,08:59,6,5,11
2,2023-08-12T09:04:00+10:00,2023-08-12,09:04,2,3,5
7,2023-08-12T08:59:00+10:00,2023-08-12,08:59,0,2,2
7,2023-08-12T09:04:00+10:00,2023-08-12,09:04,3,0,3
7,2023-08-12T09:05:00+10:00,2023-08-12,09:05,0,2,2
7,2023-08-12T09:06:00+10:00,2023-08-12,09:06,1,0,1
7,2023-08-12T09:07:00+10:00,2023-08-12,09:07,1,1,2
9,2023-08-12T08:57:00+10:00,2023-08-12,08:57,0,1,1
9,2023-08-12T08:59:00+10:00,2023-08-12,08:59,3,2,5
9,2023-08-12T09:01:00+10:00,2023-08-12,09:01,0,2,2
9,2023-08-12T09:03:00+10:00,2023-08-12,09:03,0,6,6
9,2023-08-12T09:05:00+10:00,2023-08-12,09:05,0,4,4
9,2023-08-12T09:07:00+10:00,2023-08-12,09:07,1,0,1
9,2023-08-12T09:08:00+10:00,2023-08-12,09:08,0,1,1
10,2023-08-12T09:05:00+10:00,2023-08-12,09:05,1,0,1
10,2023-08-12T09:07:00+10:00,2023-08-12,09:07,1,0,1
10,2023-08-12T09:09:00+10:00,2023-08-12,09:09,2,0,2
11,2023-08-12T08:55:00+10:00,2023-08-12,08:55,3,0,3
11,2023-08-12T09:05:00+10:00,2023-08-12,09:05,1,1,2
11,2023-08-12T09:09:00+10:00,2023-08-12,09:09,0,1,1
12,2023-08-12T08:58:00+10:00,2023-08-12,08:58,0,1,1
12,2023-08-12T08:59:00+10:00,2023-08-12,08:59,1,0,1
12,2023-08-12T09:06:00+10:00,2023-08-12,09:06,1,2,3
12,2023-08-12T09:08:00+10:00,2023-08-12,09:08,7,0,7
12,2023-08-12T09:09:00+10:00,2023-08-12,09:09,0,2,2
17,2023-08-12T09:07:00+10:00,2023-08-12,09:07,0,2,2
18,2023-08-12T08:56:00+10:00,2023-08-12,08:56,0,1,1
18,2023-08-12T08:59:00+10:00,2023-08-12,08:59,0,1,1
18,2023-08-12T09:02:00+10:00,2023-08-12,09:02,1,0,1
18,2023-08-12T09:03:00+10:00,2023-08-12,09:03,4,0,4
24,2023-08-12T08:58:00+10:00,2023-08-12,08:58,9,4,13
24,2023-08-12T09:02:00+10:00,2023-08-12,09:02,5,7,12
24,2023-08-12T09:03:00+10:00,2023-08-12,09:03,1,9,10
24,2023-08-12T09:05:00+10:00,2023-08-12,09:05,5,2,7
24,2023-08-12T09:07:00+10:00,2023-08-12,09:07,5,6,11
27,2023-08-12T09:00:00+10:00,2023-08-12,09:00,1,1,2
27,2023-08-12T09:08:00+10:00,2023-08-12,09:08,1,0,1
35,2023-08-12T09:02:00+10:00,2023-08-12,09:02,4,3,7
35,2023-08-12T09:05:00+10:00,2023-08-12,09:05,2,1,3
35,2023-08-12T09:07:00+10:00,2023-08-12,09:07,9,6,15
35,2023-08-12T09:08:00+10:00,2023-08-12,09:08,4,7,11
53,2023-08-12T08:56:00+10:00,2023-08-12,08:56,9,2,11
53,2023-08-12T08:57:00+10:00,2023-08-12,08:57,2,2,4
53,2023-08-12T08:58:00+10:00,2023-08-12,08:58,3,0,3
53,2023-08-12T09:00:00+10:00,2023-08-12,09:00,3,2,5
53,2023-08-12T09:07:00+10:00,2023-08-12,09:07,2,0,2
53,2023-08-12T09:09:00+10:00,2023-08-12,09:09,4,3,7
56,2023-08-12T08:58:00+10:00,2023-08-12,08:58,0,1,1
56,2023-08-12T08:59:00+10:00,2023-08-12,08:59,0,3,3
56,2023-08-12T09:03:00+10:00,2023-08-12,09:03,1,1,2
56,2023-08-12T09:04:00+10:00,2023-08-12,09:04,3,7,10
57,2023-08-12T08:57:00+10:00,2023-08-12,08:57,4,1,5
57,2023-08-12T08:58:00+10:00,2023-08-12,08:58,0,1,1
57,2023-08-12T09:00:00+10:00,2023-08-12,09:00,1,0,1
57,2023-08-12T09:01:00+10:00,2023-08-12,09:01,3,2,5
57,2023-08-12T09:03:00+10:00,2023-08-12,09:03,0,2,2
57,2023-08-12T09:04:00+10:00,2023-08-12,09:04,1,0,1
57,2023-08-12T09:08:00+10:00,2023-08-12,09:08,3,1,4
57,2023-08-12T09:09:00+10:00,2023-08-12,09:09,2,0,2
58,2023-08-12T08:57:00+10:00,2023-08-12,08:57,14,0,14
58,2023-08-12T08:58:00+10:00,2023-08-12,08:58,7,0,7
58,2023-08-12T08:59:00+10:00,2023-08-12,08:59,15,0,15
58,2023-08-12T09:04:00+10:00,2023-08-12,09:04,5,0,5
58,2023-08-12T09:05:00+10:00,2023-08-12,09:05,2,0,2
62,2023-08-12T08:56:00+10:00,2023-08-12,08:56,0,2,2
62,2023-08-12T08:57:00+10:00,2023-08-12,08:57,0,2,2
62,2023-08-12T08:58:00+10:00,2023-08-12,08:58,1,1,2
62,2023-08-12T08:59:00+10:00,2023-08-12,08:59,0,2,2
62,2023-08-12T09:01:00+10:00,2023-08-12,09:01,1,0,1
62,2023-08-12T09:03:00+10:00,2023-08-12,09:03,1,0,1
63,2023-08-12T08:56:00+10:00,2023-08-12,08:56,2,0,2
63,2023-08-12T08:58:00+10:00,2023-08-12,08:58,2,2,4
63,2023-08-12T09:00:00+10:00,2023-08-12,09:00,1,0,1
67,2023-08-12T08:55:00+10:00,2023-08-12,08:55,1,4,5
67,2023-08-12T08:57:00+10:00,2023-08-12,08:57,1,2,3
67,2023-08-12T08:59:00+10:00,2023-08-12,08:59,4,2,6
67,2023-08-12T09:05:00+10:00,2023-08-12,09:05,3,2,5
67,2023-08-12T09:09:00+10:00,2023-08-12,09:09,3,6,9
68,2023-08-12T08:58:00+10:00,2023-08-12,08:58,1,2,3
68,2023-08-12T08:59:00+10:00,2023-08-12,08:59,5,2,7
68,2023-08-12T09:00:00+10:00,2023-08-12,09:00,1,0,1
68,2023-08-12T09:03:00+10:00,2023-08-12,09:03,1,1,2
68,2023-08-12T09:07:00+10:00,2023-08-12,09:07,2,1,3
68,2023-08-12T09:08:00+10:00,2023-08-12,09:08,5,1,6
72,2023-08-12T08:56:00+10:00,2023-08-12,08:56,3,1,4
72,2023-08-12T08:57:00+10:00,2023-08-12,08:57,3,1,4
72,2023-08-12T09:00:00+10:00,2023-08-12,09:00,3,0,3
72,2023-08-12T09:07:00+10:00,2023-08-12,09:07,0,3,3
76,2023-08-12T08:55:00+10:00,2023-08-12,08:55,1,0,1
76,2023-08-12T09:03:00+10:00,2023-08-12,09:03,1,1,2
76,2023-08-12T09:04:00+10:00,2023-08-12,09:04,1,0,1
76,2023-08-12T09:08:00+10:00,2023-08-12,09:08,0,1,1
79,2023-08-12T09:00:00+10:00,2023-08-12,09:00,0,3,3
79,2023-08-12T09:01:00+10:00,2023-08-12,09:01,0,2,2
85,2023-08-12T08:56:00+10:00,2023-08-12,08:56,1,0,1
85,2023-08-12T08:57:00+10:00,2023-08-12,08:57,1,0,1
85,2023-08-12T09:01:00+10:00,2023-08-12,09:01,1,0,1
85,2023-08-12T09:04:00+10:00,2023-08-12,09:04,2,1,3
86,2023-08-12T08:57:00+10:00,2023-08-12,08:57,0,1,1
86,2023-08-12T08:58:00+10:00,2023-08-12,08:58,2,1,3
86,2023-08-12T08:59:00+10:00,2023-08-12,08:59,3,0,3
86,2023-08-12T09:00:00+10:00,2023-08-12,09:00,1,0,1
86,2023-08-12T09:02:00+10:00,2023-08-12,09:02,1,1,2
86,2023-08-12T09:07:00+10:00,2023-08-12,09:07,0,1,1
109,2023-08-12T09:00:00+10:00,2023-08-12,09:00,7,8,15
117,2023-08-12T09:00:00+10:00,2023-08-12,09:00,3,8,11
122,2023-08-12T09:05:00+10:00,2023-08-12,09:05,1,0,1
122,2023-08-12T09:09:00+10:00,2023-08-12,09:09,0,1,1
3,2023-08-12T09:16:00+10:00,2023-08-12,09:16,0,5,5
4,2023-08-12T09:13:00+10:00,2023-08-12,09:13,4,1,5
4,2023-08-12T09:16:00+10:00,2023-08-12,09:16,6,5,11
4,2023-08-12T09:17:00+10:00,2023-08-12,09:17,2,8,10
4,2023-08-12T09:19:00+10:00,2023-08-12,09:19,11,4,15
4,2023-08-12T09:24:00+10:00,2023-08-12,09:24,12,3,15
6,2023-08-12T09:11:00+10:00,2023-08-12,09:11,7,2,9
6,2023-08-12T09:13:00+10:00,2023-08-12,09:13,2,0,2
6,2023-08-12T09:18:00+10:00,2023-08-12,09:18,3,8,11
6,2023-08-12T09:20:00+10:00,2023-08-12,09:20,5,2,7
6,2023-08-12T09:23:00+10:00,2023-08-12,09:23,8,4,12
8,2023-08-12T09:11:00+10:00,2023-08-12,09:11,3,1,4
8,2023-08-12T09:12:00+10:00,2023-08-12,09:12,1,1,2
8,2023-08-12T09:21:00+10:00,2023-08-12,09:21,1,3,4
14,2023-08-12T09:11:00+10:00,2023-08-12,09:11,2,1,3
14,2023-08-12T09:12:00+10:00,2023-08-12,09:12,0,2,2
14,2023-08-12T09:17:00+10:00,2023-08-12,09:17,3,0,3
14,2023-08-12T09:18:00+10:00,2023-08-12,09:18,2,1,3
14,2023-08-12T09:19:00+10:00,2023-08-12,09:19,1,1,2
14,2023-08-12T09:22:00+10:00,2023-08-12,09:22,4,0,4
14,2023-08-12T09:24:00+10:00,2023-08-12,09:24,3,0,3
21,2023-08-12T09:11:00+10:00,2023-08-12,09:11,6,0,6
21,2023-08-12T09:17:00+10:00,2023-08-12,09:17,1,4,5
21,2023-08-12T09:21:00+10:00,2023-08-12,09:21,0,4,4
21,2023-08-12T09:22:00+10:00,2023-08-12,09:22,1,4,5
28,2023-08-12T09:16:00+10:00,2023-08-12,09:16,0,10,10
28,2023-08-12T09:17:00+10:00,2023-08-12,09:17,1,1,2
28,2023-08-12T09:22:00+10:00,2023-08-12,09:22,6,2,8
28,2023-08-12T09:24:00+10:00,2023-08-12,09:24,4,0,4
29,2023-08-12T09:13:00+10:00,2023-08-12,09:13,0,1,1
29,2023-08-12T09:15:00+10:00,2023-08-12,09:15,0,4,4
29,2023-08-12T09:16:00+10:00,2023-08-12,09:16,3,0,3
29,2023-08-12T09:18:00+10:00,2023-08-12,09:18,0,1,1
29,2023-08-12T09:20:00+10:00,2023-08-12,09:20,3,5,8
29,2023-08-12T09:22:00+10:00,2023-08-12,09:22,1,5,6
29,2023-08-12T09:23:00+10:00,2023-08-12,09:23,3,2,5
39,2023-08-12T09:10:00+10:00,2023-08-12,09:10,3,1,4
39,2023-08-12T09:14:00+10:00,2023-08-12,09:14,1,4,5
39,2023-08-12T09:18:00+10:00,2023-08-12,09:18,1,0,1
39,2023-08-12T09:22:00+10:00,2023-08-12,09:22,1,2,3
39,2023-08-12T09:24:00+10:00,2023-08-12,09:24,2,3,5
41,2023-08-12T09:10:00+10:00,2023-08-12,09:10,12,10,22
41,2023-08-12T09:16:00+10:00,2023-08-12,09:16,3,13,16
41,2023-08-12T09:17:00+10:00,2023-08-12,09:17,6,5,11
54,2023-08-12T09:15:00+10:00,2023-08-12,09:15,3,1,4
54,2023-08-12T09:23:00+10:00,2023-08-12,09:23,3,0,3
54,2023-08-12T09:24:00+10:00,2023-08-12,09:24,1,0,1
55,2023-08-12T09:16:00+10:00,2023-08-12,09:16,2,10,12
55,2023-08-12T09:23:00+10:00,2023-08-12,09:23,7,9,16
59,2023-08-12T09:15:00+10:00,2023-08-12,09:15,17,14,31
61,2023-08-12T09:10:00+10:00,2023-08-12,09:10,2,1,3
61,2023-08-12T09:11:00+10:00,2023-08-12,09:11,2,3,5
61,2023-08-12T09:12:00+10:00,2023-08-12,09:12,0,2,2
61,2023-08-12T09:13:00+10:00,2023-08-12,09:13,0,3,3
61,2023-08-12T09:21:00+10:00,2023-08-12,09:21,1,0,1
65,2023-08-12T09:12:00+10:00,2023-08-12,09:12,6,1,7
65,2023-08-12T09:13:00+10:00,2023-08-12,09:13,1,0,1
65,2023-08-12T09:14:00+10:00,2023-08-12,09:14,2,1,3
65,2023-08-12T09:15:00+10:00,2023-08-12,09:15,2,2,4
65,2023-08-12T09:16:00+10:00,2023-08-12,09:16,0,1,1
65,2023-08-12T09:20:00+10:00,2023-08-12,09:20,3,2,5
65,2023-08-12T09:23:00+10:00,2023-08-12,09:23,2,3,5
66,2023-08-12T09:12:00+10:00,2023-08-12,09:12,2,9,11
66,2023-08-12T09:14:00+10:00,2023-08-12,09:14,3,2,5
66,2023-08-12T09:16:00+10:00,2023-08-12,09:16,0,3,3
66,2023-08-12T09:18:00+10:00,2023-08-12,09:18,1,2,3
66,2023-08-12T09:19:00+10:00,2023-08-12,09:19,3,2,5
66,2023-08-12T09:21:00+10:00,2023-08-12,09:21,2,5,7
69,2023-08-12T09:19:00+10:00,2023-08-12,09:19,1,2,3
69,2023-08-12T09:24:00+10:00,2023-08-12,09:24,1,2,3
70,2023-08-12T09:16:00+10:00,2023-08-12,09:16,1,1,2
70,2023-08-12T09:17:00+10:00,2023-08-12,09:17,2,0,2
71,2023-08-12T09:10:00+10:00,2023-08-12,09:10,1,0,1
71,2023-08-12T09:19:00+10:00,2023-08-12,09:19,1,0,1
71,2023-08-12T09:20:00+10:00,2023-08-12,09:20,0,1,1
77,2023-08-12T09:11:00+10:00,2023-08-12,09:11,1,2,3
77,2023-08-12T09:20:00+10:00,2023-08-12,09:20,3,1,4
78,2023-08-12T09:12:00+10:00,2023-08-12,09:12,1,4,5
78,2023-08-12T09:14:00+10:00,2023-08-12,09:14,1,0,1
84,2023-08-12T09:10:00+10:00,2023-08-12,09:10,57,18,75
87,2023-08-12T09:10:00+10:00,2023-08-12,09:10,1,1,2
87,2023-08-12T09:12:00+10:00,2023-08-12,09:12,1,1,2
87,2023-08-12T09:23:00+10:00,2023-08-12,09:23,1,0,1
107,2023-08-12T09:20:00+10:00,2023-08-12,09:20,7,7,14
108,2023-08-12T09:10:00+10:00,2023-08-12,09:10,3,1,4
108,2023-08-12T09:13:00+10:00,2023-08-12,09:13,2,0,2
108,2023-08-12T09:14:00+10:00,2023-08-12,09:14,2,2,4
108,2023-08-12T09:17:00+10:00,2023-08-12,09:17,0,1,1
108,2023-08-12T09:21:00+10:00,2023-08-12,09:21,1,0,1
1,2023-08-12T09:13:00+10:00,2023-08-12,09:13,9,2,11
1,2023-08-12T09:18:00+10:00,2023-08-12,09:18,0,4,4
1,2023-08-12T09:19:00+10:00,2023-08-12,09:19,1,1,2
1,2023-08-12T09:24:00+10:00,2023-08-12,09:24,5,1,6
2,2023-08-12T09:12:00+10:00,2023-08-12,09:12,0,4,4
2,2023-08-12T09:17:00+10:00,2023-08-12,09:17,1,4,5
2,2023-08-12T09:22:00+10:00,2023-08-12,09:22,3,2,5
7,2023-08-12T09:16:00+10:00,2023-08-12,09:16,1,0,1
7,2023-08-12T09:20:00+10:00,2023-08-12,09:20,0,4,4
7,2023-08-12T09:23:00+10:00,2023-08-12,09:23,0,2,2
9,2023-08-12T09:10:00+10:00,2023-08-12,09:10,7,1,8
9,2023-08-12T09:17:00+10:00,2023-08-12,09:17,0,2,2
9,2023-08-12T09:20:00+10:00,2023-08-12,09:20,2,5,7
9,2023-08-12T09:21:00+10:00,2023-08-12,09:21,1,2,3
10,2023-08-12T09:15:00+10:00,2023-08-12,09:15,1,1,2
10,2023-08-12T09:18:00+10:00,2023-08-12,09:18,2,0,2
10,2023-08-12T09:22:00+10:00,2023-08-12,09:22,0,2,2
11,2023-08-12T09:11:00+10:00,2023-08-12,09:11,1,1,2
11,2023-08-12T09:15:00+10:00,2023-08-12,09:15,1,4,5
12,2023-08-12T09:20:00+10:00,2023-08-12,09:20,2,0,2
17,2023-08-12T09:10:00+10:00,2023-08-12,09:10,2,1,3
17,2023-08-12T09:11:00+10:00,2023-08-12,09:11,7,0,7
17,2023-08-12T09:14:00+10:00,2023-08-12,09:14,2,0,2
17,2023-08-12T09:15:00+10:00,2023-08-12,09:15,2,0,2
17,2023-08-12T09:16:00+10:00,2023-08-12,09:16,0,1,1
17,2023-08-12T09:17:00+10:00,2023-08-12,09:17,0,1,1
17,2023-08-12T09:20:00+10:00,2023-08-12,09:20,1,0,1
18,2023-08-12T09:23:00+10:00,2023-08-12,09:23,0,3,3
24,2023-08-12T09:14:00+10:00,2023-08-12,09:14,6,1,7
24,2023-08-12T09:17:00+10:00,2023-08-12,09:17,3,8,11
24,2023-08-12T09:18:00+10:00,2023-08-12,09:18,3,5,8
27,2023-08-12T09:11:00+10:00,2023-08-12,09:11,2,3,5
35,2023-08-12T09:13:00+10:00,2023-08-12,09:13,9,1,10
35,2023-08-12T09:19:00+10:00,2023-08-12,09:19,7,4,11
35,2023-08-12T09:24:00+10:00,2023-08-12,09:24,6,5,11
53,2023-08-12T09:12:00+10:00,2023-08-12,09:12,2,1,3
53,2023-08-12T09:13:00+10:00,2023-08-12,09:13,2,1,3
53,2023-08-12T09:16:00+10:00,2023-08-12,09:16,4,4,8
53,2023-08-12T09:17:00+10:00,2023-08-12,09:17,4,6,10
53,2023-08-12T09:18:00+10:00,2023-08-12,09:18,1,4,5
53,2023-08-12T09:22:00+10:00,2023-08-12,09:22,6,3,9
53,2023-08-12T09:24:00+10:00,2023-08-12,09:24,2,0,2
56,2023-08-12T09:11:00+10:00,2023-08-12,09:11,1,1,2
56,2023-08-12T09:13:00+10:00,2023-08-12,09:13,1,0,1
56,2023-08-12T09:17:00+10:00,2023-08-12,09:17,1,2,3
56,2023-08-12T09:21:00+10:00,2023-08-12,09:21,7,0,7
56,2023-08-12T09:23:00+10:00,2023-08-12,09:23,2,0,2
56,2023-08-12T09:24:00+10:00,2023-08-12,09:24,4,3,7
58,2023-08-12T09:12:00+10:00,2023-08-12,09:12,12,1,13
58,2023-08-12T09:14:00+10:00,2023-08-12,09:14,3,1,4
58,2023-08-12T09:17:00+10:00,2023-08-12,09:17,3,6,9
62,2023-08-12T09:11:00+10:00,2023-08-12,09:11,0,1,1
62,2023-08-12T09:14:00+10:00,2023-08-12,09:14,2,4,6
62,2023-08-12T09:18:00+10:00,2023-08-12,09:18,2,1,3
62,2023-08-12T09:21:00+10:00,2023-08-12,09:21,2,0,2
62,2023-08-12T09:22:00+10:00,2023-08-12,09:22,2,0,2
62,2023-08-12T09:24:00+10:00,2023-08-12,09:24,5,0,5
63,2023-08-12T09:15:00+10:00,2023-08-12,09:15,0,2,2
63,2023-08-12T09:18:00+10:00,2023-08-12,09:18,0,2,2
63,2023-08-12T09:20:00+10:00,2023-08-12,09:20,3,3,6
63,2023-08-12T09:22:00+10:00,2023-08-12,09:22,0,1,1
63,2023-08-12T09:23:00+10:00,2023-08-12,09:23,0,5,5
67,2023-08-12T09:10:00+10:00,2023-08-12,09:10,1,3,4
67,2023-08-12T09:14:00+10:00,2023-08-12,09:14,10,1,11
67,2023-08-12T09:18:00+10:00,2023-08-12,09:18,3,6,9
67,2023-08-12T09:20:00+10:00,2023-08-12,09:20,4,8,12
67,2023-08-12T09:24:00+10:00,2023-08-12,09:24,6,2,8
68,2023-08-12T09:10:00+10:00,2023-08-12,09:10,2,2,4
68,2023-08-12T09:12:00+10:00,2023-08-12,09:12,2,3,5
68,2023-08-12T09:13:00+10:00,2023-08-12,09:13,2,2,4
68,2023-08-12T09:16:00+10:00,2023-08-12,09:16,7,5,12
68,2023-08-12T09:21:00+10:00,2023-08-12,09:21,2,1,3
72,2023-08-12T09:13:00+10:00,2023-08-12,09:13,3,0,3
72,2023-08-12T09:14:00+10:00,2023-08-12,09:14,6,0,6
72,2023-08-12T09:15:00+10:00,2023-08-12,09:15,1,2,3
72,2023-08-12T09:20:00+10:00,2023-08-12,09:20,2,5,7
76,2023-08-12T09:12:00+10:00,2023-08-12,09:12,1,4,5
76,2023-08-12T09:15:00+10:00,2023-08-12,09:15,2,1,3
76,2023-08-12T09:17:00+10:00,2023-08-12,09:17,1,0,1
76,2023-08-12T09:23:00+10:00,2023-08-12,09:23,1,0,1
79,2023-08-12T09:10:00+10:00,2023-08-12,09:10,5,1,6
79,2023-08-12T09:12:00+10:00,2023-08-12,09:12,3,7,10
79,2023-08-12T09:13:00+10:00,2023-08-12,09:13,3,2,5
79,2023-08-12T09:14:00+10:00,2023-08-12,09:14,2,4,6
79,2023-08-12T09:18:00+10:00,2023-08-12,09:18,4,1,5
79,2023-08-12T09:24:00+10:00,2023-08-12,09:24,4,4,8
85,2023-08-12T09:13:00+10:00,2023-08-12,09:13,2,0,2
85,2023-08-12T09:14:00+10:00,2023-08-12,09:14,2,1,3
85,2023-08-12T09:15:00+10:00,2023-08-12,09:15,2,0,2
85,2023-08-12T09:16:00+10:00,2023-08-12,09:16,0,4,4
85,2023-08-12T09:17:00+10:00,2023-08-12,09:17,0,1,1
85,2023-08-12T09:19:00+10:00,2023-08-12,09:19,1,0,1
85,2023-08-12T09:23:00+10:00,2023-08-12,09:23,1,2,3
86,2023-08-12T09:11:00+10:00,2023-08-12,09:11,0,1,1
86,2023-08-12T09:12:00+10:00,2023-08-12,09:12,1,1,2
86,2023-08-12T09:13:00+10:00,2023-08-12,09:13,1,0,1
86,2023-08-12T09:16:00+10:00,2023-08-12,09:16,1,2,3
86,2023-08-12T09:24:00+10:00,2023-08-12,09:24,0,2,2
109,2023-08-12T09:10:00+10:00,2023-08-12,09:10,6,2,8
109,2023-08-12T09:15:00+10:00,2023-08-12,09:15,8,7,15
109,2023-08-12T09:20:00+10:00,2023-08-12,09:20,3,1,4
122,2023-08-12T09:14:00+10:00,2023-08-12,09:14,1,0,1
122,2023-08-12T09:18:00+10:00,2023-08-12,09:18,1,2,3
122,2023-08-12T09:20:00+10:00,2023-08-12,09:20,1,0,1
122,2023-08-12T09:22:00+10:00,2023-08-12,09:22,0,2,2
122,2023-08-12T09:23:00+10:00,2023-08-12,09:23,0,2,2
29,2023-08-12T09:26:00+10:00,2023-08-12,09:26,4,5,9
29,2023-08-12T09:29:00+10:00,2023-08-12,09:29,3,0,3
29,2023-08-12T09:37:00+10:00,2023-08-12,09:37,0,3,3
29,2023-08-12T09:38:00+10:00,2023-08-12,09:38,2,0,2
29,2023-08-12T09:39:00+10:00,2023-08-12,09:39,4,1,5
39,2023-08-12T09:28:00+10:00,2023-08-12,09:28,3,2,5
39,2023-08-12T09:34:00+10:00,2023-08-12,09:34,4,3,7
39,2023-08-12T09:39:00+10:00,2023-08-12,09:39,2,1,3
41,2023-08-12T09:29:00+10:00,2023-08-12,09:29,19,2,21
41,2023-08-12T09:31:00+10:00,2023-08-12,09:31,7,8,15
41,2023-08-12T09:32:00+10:00,2023-08-12,09:32,29,12,41
41,2023-08-12T09:34:00+10:00,2023-08-12,09:34,15,6,21
41,2023-08-12T09:35:00+10:00,2023-08-12,09:35,30,4,34
41,2023-08-12T09:36:00+10:00,2023-08-12,09:36,9,10,19
41,2023-08-12T09:39:00+10:00,2023-08-12,09:39,13,5,18
54,2023-08-12T09:35:00+10:00,2023-08-12,09:35,1,0,1
54,2023-08-12T09:37:00+10:00,2023-08-12,09:37,2,0,2
55,2023-08-12T09:33:00+10:00,2023-08-12,09:33,2,2,4
55,2023-08-12T09:34:00+10:00,2023-08-12,09:34,7,3,10
55,2023-08-12T09:37:00+10:00,2023-08-12,09:37,0,4,4
55,2023-08-12T09:39:00+10:00,2023-08-12,09:39,7,9,16
59,2023-08-12T09:25:00+10:00,2023-08-12,09:25,19,32,51
59,2023-08-12T09:30:00+10:00,2023-08-12,09:30,11,24,35
59,2023-08-12T09:35:00+10:00,2023-08-12,09:35,14,17,31
61,2023-08-12T09:27:00+10:00,2023-08-12,09:27,1,2,3
61,2023-08-12T09:28:00+10:00,2023-08-12,09:28,0,3,3
61,2023-08-12T09:30:00+10:00,2023-08-12,09:30,1,1,2
61,2023-08-12T09:32:00+10:00,2023-08-12,09:32,3,6,9
61,2023-08-12T09:34:00+10:00,2023-08-12,09:34,0,4,4
61,2023-08-12T09:38:00+10:00,2023-08-12,09:38,0,4,4
65,2023-08-12T09:25:00+10:00,2023-08-12,09:25,9,3,12
65,2023-08-12T09:27:00+10:00,2023-08-12,09:27,3,5,8
65,2023-08-12T09:28:00+10:00,2023-08-12,09:28,3,0,3
65,2023-08-12T09:29:00+10:00,2023-08-12,09:29,3,2,5
65,2023-08-12T09:33:00+10:00,2023-08-12,09:33,1,47,48
65,2023-08-12T09:34:00+10:00,2023-08-12,09:34,1,0,1
65,2023-08-12T09:36:00+10:00,2023-08-12,09:36,5,2,7
65,2023-08-12T09:39:00+10:00,2023-08-12,09:39,5,8,13
66,2023-08-12T09:28:00+10:00,2023-08-12,09:28,4,9,13
66,2023-08-12T09:34:00+10:00,2023-08-12,09:34,4,5,9
66,2023-08-12T09:39:00+10:00,2023-08-12,09:39,4,3,7
69,2023-08-12T09:27:00+10:00,2023-08-12,09:27,2,3,5
69,2023-08-12T09:28:00+10:00,2023-08-12,09:28,4,1,5
69,2023-08-12T09:29:00+10:00,2023-08-12,09:29,8,1,9
69,2023-08-12T09:31:00+10:00,2023-08-12,09:31,4,0,4
69,2023-08-12T09:34:00+10:00,2023-08-12,09:34,5,1,6
69,2023-08-12T09:36:00+10:00,2023-08-12,09:36,1,0,1
69,2023-08-12T09:39:00+10:00,2023-08-12,09:39,1,6,7
70,2023-08-12T09:26:00+10:00,2023-08-12,09:26,1,3,4
70,2023-08-12T09:29:00+10:00,2023-08-12,09:29,2,1,3
71,2023-08-12T09:33:00+10:00,2023-08-12,09:33,3,0,3
71,2023-08-12T09:34:00+10:00,2023-08-12,09:34,0,3,3
75,2023-08-12T09:28:00+10:00,2023-08-12,09:28,3,1,4
75,2023-08-12T09:38:00+10:00,2023-08-12,09:38,1,0,1
77,2023-08-12T09:28:00+10:00,2023-08-12,09:28,0,1,1
77,2023-08-12T09:31:00+10:00,2023-08-12,09:31,2,1,3
77,2023-08-12T09:37:00+10:00,2023-08-12,09:37,0,4,4
78,2023-08-12T09:27:00+10:00,2023-08-12,09:27,0,1,1
78,2023-08-12T09:31:00+10:00,2023-08-12,09:31,1,0,1
78,2023-08-12T09:34:00+10:00,2023-08-12,09:34,0,1,1
78,2023-08-12T09:35:00+10:00,2023-08-12,09:35,1,0,1
78,2023-08-12T09:36:00+10:00,2023-08-12,09:36,0,1,1
84,2023-08-12T09:25:00+10:00,2023-08-12,09:25,34,46,80
87,2023-08-12T09:29:00+10:00,2023-08-12,09:29,3,1,4
87,2023-08-12T09:31:00+10:00,2023-08-12,09:31,1,2,3
87,2023-08-12T09:32:00+10:00,2023-08-12,09:32,2,1,3
87,2023-08-12T09:35:00+10:00,2023-08-12,09:35,3,1,4
87,2023-08-12T09:37:00+10:00,2023-08-12,09:37,0,2,2
107,2023-08-12T09:25:00+10:00,2023-08-12,09:25,8,9,17
108,2023-08-12T09:33:00+10:00,2023-08-12,09:33,3,1,4
108,2023-08-12T09:38:00+10:00,2023-08-12,09:38,0,2,2
1,2023-08-12T09:26:00+10:00,2023-08-12,09:26,1,4,5
1,2023-08-12T09:34:00+10:00,2023-08-12,09:34,9,2,11
1,2023-08-12T09:37:00+10:00,2023-08-12,09:37,4,6,10
2,2023-08-12T09:30:00+10:00,2023-08-12,09:30,11,6,17
2,2023-08-12T09:32:00+10:00,2023-08-12,09:32,3,7,10
2,2023-08-12T09:38:00+10:00,2023-08-12,09:38,5,5,10
7,2023-08-12T09:25:00+10:00,2023-08-12,09:25,2,0,2
7,2023-08-12T09:26:00+10:00,2023-08-12,09:26,0,1,1
7,2023-08-12T09:28:00+10:00,2023-08-12,09:28,0,1,1
7,2023-08-12T09:34:00+10:00,2023-08-12,09:34,2,3,5
7,2023-08-12T09:36:00+10:00,2023-08-12,09:36,2,1,3
7,2023-08-12T09:37:00+10:00,2023-08-12,09:37,1,0,1
9,2023-08-12T09:30:00+10:00,2023-08-12,09:30,2,0,2
9,2023-08-12T09:33:00+10:00,2023-08-12,09:33,1,1,2
10,2023-08-12T09:36:00+10:00,2023-08-12,09:36,1,1,2
11,2023-08-12T09:29:00+10:00,2023-08-12,09:29,0,1,1
11,2023-08-12T09:30:00+10:00,2023-08-12,09:30,3,2,5
11,2023-08-12T09:32:00+10:00,2023-08-12,09:32,2,0,2
11,2023-08-12T09:39:00+10:00,2023-08-12,09:39,0,2,2
12,2023-08-12T09:26:00+10:00,2023-08-12,09:26,1,1,2
12,2023-08-12T09:30:00+10:00,2023-08-12,09:30,0,1,1
12,2023-08-12T09:33:00+10:00,2023-08-12,09:33,2,0,2
12,2023-08-12T09:37:00+10:00,2023-08-12,09:37,4,1,5
12,2023-08-12T09:38:00+10:00,2023-08-12,09:38,0,1,1
12,2023-08-12T09:39:00+10:00,2023-08-12,09:39,0,1,1
17,2023-08-12T09:28:00+10:00,2023-08-12,09:28,1,1,2
17,2023-08-12T09:30:00+10:00,2023-08-12,09:30,2,0,2
17,2023-08-12T09:34:00+10:00,2023-08-12,09:34,1,2,3
17,2023-08-12T09:36:00+10:00,2023-08-12,09:36,3,1,4
17,2023-08-12T09:39:00+10:00,2023-08-12,09:39,1,1,2
18,2023-08-12T09:30:00+10:00,2023-08-12,09:30,1,1,2
18,2023-08-12T09:36:00+10:00,2023-08-12,09:36,2,1,3
24,2023-08-12T09:28:00+10:00,2023-08-12,09:28,8,15,23
24,2023-08-12T09:31:00+10:00,2023-08-12,09:31,1,4,5
24,2023-08-12T09:32:00+10:00,2023-08-12,09:32,15,7,22
24,2023-08-12T09:37:00+10:00,2023-08-12,09:37,12,3,15
27,2023-08-12T09:25:00+10:00,2023-08-12,09:25,0,6,6
27,2023-08-12T09:26:00+10:00,2023-08-12,09:26,5,1,6
27,2023-08-12T09:27:00+10:00,2023-08-12,09:27,2,0,2
27,2023-08-12T09:30:00+10:00,2023-08-12,09:30,2,0,2
27,2023-08-12T09:33:00+10:00,2023-08-12,09:33,0,2,2
27,2023-08-12T09:37:00+10:00,2023-08-12,09:37,4,1,5
27,2023-08-12T09:38:00+10:00,2023-08-12,09:38,3,2,5
35,2023-08-12T09:26:00+10:00,2023-08-12,09:26,2,4,6
35,2023-08-12T09:29:00+10:00,2023-08-12,09:29,11,2,13
35,2023-08-12T09:36:00+10:00,2023-08-12,09:36,11,5,16
35,2023-08-12T09:37:00+10:00,2023-08-12,09:37,13,6,19
35,2023-08-12T09:39:00+10:00,2023-08-12,09:39,8,6,14
53,2023-08-12T09:25:00+10:00,2023-08-12,09:25,5,5,10
53,2023-08-12T09:26:00+10:00,2023-08-12,09:26,3,4,7
53,2023-08-12T09:30:00+10:00,2023-08-12,09:30,2,2,4
53,2023-08-12T09:32:00+10:00,2023-08-12,09:32,4,4,8
53,2023-08-12T09:35:00+10:00,2023-08-12,09:35,5,7,12
53,2023-08-12T09:38:00+10:00,2023-08-12,09:38,8,4,12
56,2023-08-12T09:27:00+10:00,2023-08-12,09:27,1,3,4
56,2023-08-12T09:34:00+10:00,2023-08-12,09:34,4,1,5
57,2023-08-12T09:26:00+10:00,2023-08-12,09:26,2,1,3
57,2023-08-12T09:39:00+10:00,2023-08-12,09:39,0,3,3
58,2023-08-12T09:28:00+10:00,2023-08-12,09:28,5,4,9
58,2023-08-12T09:30:00+10:00,2023-08-12,09:30,7,2,9
58,2023-08-12T09:32:00+10:00,2023-08-12,09:32,10,1,11
58,2023-08-12T09:33:00+10:00,2023-08-12,09:33,2,2,4
58,2023-08-12T09:34:00+10:00,2023-08-12,09:34,10,4,14
62,2023-08-12T09:30:00+10:00,2023-08-12,09:30,3,2,5
62,2023-08-12T09:34:00+10:00,2023-08-12,09:34,0,4,4
62,2023-08-12T09:36:00+10:00,2023-08-12,09:36,0,1,1
62,2023-08-12T09:38:00+10:00,2023-08-12,09:38,2,0,2
63,2023-08-12T09:25:00+10:00,2023-08-12,09:25,2,3,5
63,2023-08-12T09:27:00+10:00,2023-08-12,09:27,4,8,12
63,2023-08-12T09:30:00+10:00,2023-08-12,09:30,1,3,4
63,2023-08-12T09:31:00+10:00,2023-08-12,09:31,5,0,5
63,2023-08-12T09:32:00+10:00,2023-08-12,09:32,2,5,7
63,2023-08-12T09:39:00+10:00,2023-08-12,09:39,1,2,3
67,2023-08-12T09:26:00+10:00,2023-08-12,09:26,7,6,13
67,2023-08-12T09:28:00+10:00,2023-08-12,09:28,5,11,16
67,2023-08-12T09:32:00+10:00,2023-08-12,09:32,5,10,15
67,2023-08-12T09:36:00+10:00,2023-08-12,09:36,1,13,14
67,2023-08-12T09:38:00+10:00,2023-08-12,09:38,8,2,10
67,2023-08-12T09:39:00+10:00,2023-08-12,09:39,7,10,17
68,2023-08-12T09:25:00+10:00,2023-08-12,09:25,3,3,6
68,2023-08-12T09:26:00+10:00,2023-08-12,09:26,1,2,3
68,2023-08-12T09:27:00+10:00,2023-08-12,09:27,0,2,2
68,2023-08-12T09:28:00+10:00,2023-08-12,09:28,4,1,5
68,2023-08-12T09:33:00+10:00,2023-08-12,09:33,5,2,7
68,2023-08-12T09:36:00+10:00,2023-08-12,09:36,4,1,5
72,2023-08-12T09:29:00+10:00,2023-08-12,09:29,8,1,9
72,2023-08-12T09:30:00+10:00,2023-08-12,09:30,1,0,1
72,2023-08-12T09:32:00+10:00,2023-08-12,09:32,1,0,1
72,2023-08-12T09:33:00+10:00,2023-08-12,09:33,3,1,4
72,2023-08-12T09:35:00+10:00,2023-08-12,09:35,0,3,3
76,2023-08-12T09:31:00+10:00,2023-08-12,09:31,2,0,2
76,2023-08-12T09:32:00+10:00,2023-08-12,09:32,3,3,6
76,2023-08-12T09:33:00+10:00,2023-08-12,09:33,2,1,3
76,2023-08-12T09:37:00+10:00,2023-08-12,09:37,0,2,2
76,2023-08-12T09:38:00+10:00,2023-08-12,09:38,1,1,2
76,2023-08-12T09:39:00+10:00,2023-08-12,09:39,4,2,6
79,2023-08-12T09:25:00+10:00,2023-08-12,09:25,1,3,4
79,2023-08-12T09:26:00+10:00,2023-08-12,09:26,4,1,5
79,2023-08-12T09:28:00+10:00,2023-08-12,09:28,4,2,6
79,2023-08-12T09:29:00+10:00,2023-08-12,09:29,3,8,11
79,2023-08-12T09:32:00+10:00,2023-08-12,09:32,4,7,11
79,2023-08-12T09:33:00+10:00,2023-08-12,09:33,4,7,11
79,2023-08-12T09:34:00+10:00,2023-08-12,09:34,5,4,9
85,2023-08-12T09:26:00+10:00,2023-08-12,09:26,1,1,2
85,2023-08-12T09:30:00+10:00,2023-08-12,09:30,3,0,3
85,2023-08-12T09:31:00+10:00,2023-08-12,09:31,4,0,4
85,2023-08-12T09:36:00+10:00,2023-08-12,09:36,1,0,1
85,2023-08-12T09:37:00+10:00,2023-08-12,09:37,3,1,4
86,2023-08-12T09:26:00+10:00,2023-08-12,09:26,4,0,4
86,2023-08-12T09:30:00+10:00,2023-08-12,09:30,1,1,2
86,2023-08-12T09:34:00+10:00,2023-08-12,09:34,1,0,1
86,2023-08-12T09:36:00+10:00,2023-08-12,09:36,1,0,1
117,2023-08-12T09:35:00+10:00,2023-08-12,09:35,8,3,11
122,2023-08-12T09:27:00+10:00,2023-08-12,09:27,0,2,2
122,2023-08-12T09:37:00+10:00,2023-08-12,09:37,1,0,1
3,2023-08-12T09:27:00+10:00,2023-08-12,09:27,8,7,15
3,2023-08-12T09:28:00+10:00,2023-08-12,09:28,1,4,5
3,2023-08-12T09:29:00+10:00,2023-08-12,09:29,5,3,8
3,2023-08-12T09:31:00+10:00,2023-08-12,09:31,5,0,5
3,2023-08-12T09:32:00+10:00,2023-08-12,09:32,1,1,2
3,2023-08-12T09:33:00+10:00,2023-08-12,09:33,0,2,2
3,2023-08-12T09:34:00+10:00,2023-08-12,09:34,5,3,8
3,2023-08-12T09:37:00+10:00,2023-08-12,09:37,1,4,5
4,2023-08-12T09:27:00+10:00,2023-08-12,09:27,12,7,19
4,2023-08-12T09:28:00+10:00,2023-08-12,09:28,4,4,8
4,2023-08-12T09:30:00+10:00,2023-08-12,09:30,7,10,17
4,2023-08-12T09:31:00+10:00,2023-08-12,09:31,12,8,20
4,2023-08-12T09:33:00+10:00,2023-08-12,09:33,9,7,16
4,2023-08-12T09:36:00+10:00,2023-08-12,09:36,12,4,16
6,2023-08-12T09:25:00+10:00,2023-08-12,09:25,8,5,13
6,2023-08-12T09:26:00+10:00,2023-08-12,09:26,3,9,12
6,2023-08-12T09:30:00+10:00,2023-08-12,09:30,3,4,7
6,2023-08-12T09:31:00+10:00,2023-08-12,09:31,8,2,10
6,2023-08-12T09:36:00+10:00,2023-08-12,09:36,5,3,8
6,2023-08-12T09:37:00+10:00,2023-08-12,09:37,5,9,14
6,2023-08-12T09:38:00+10:00,2023-08-12,09:38,7,4,11
8,2023-08-12T09:25:00+10:00,2023-08-12,09:25,0,1,1
8,2023-08-12T09:27:00+10:00,2023-08-12,09:27,1,0,1
8,2023-08-12T09:31:00+10:00,2023-08-12,09:31,4,4,8
8,2023-08-12T09:32:00+10:00,2023-08-12,09:32,0,1,1
8,2023-08-12T09:35:00+10:00,2023-08-12,09:35,0,2,2
8,2023-08-12T09:37:00+10:00,2023-08-12,09:37,3,3,6
8,2023-08-12T09:39:00+10:00,2023-08-12,09:39,0,2,2
14,2023-08-12T09:26:00+10:00,2023-08-12,09:26,3,1,4
14,2023-08-12T09:28:00+10:00,2023-08-12,09:28,1,4,5
14,2023-08-12T09:33:00+10:00,2023-08-12,09:33,2,2,4
14,2023-08-12T09:34:00+10:00,2023-08-12,09:34,2,1,3
21,2023-08-12T09:26:00+10:00,2023-08-12,09:26,1,4,5
21,2023-08-12T09:32:00+10:00,2023-08-12,09:32,2,3,5
21,2023-08-12T09:35:00+10:00,2023-08-12,09:35,1,0,1
28,2023-08-12T09:28:00+10:00,2023-08-12,09:28,7,7,14
28,2023-08-12T09:30:00+10:00,2023-08-12,09:30,0,2,2
28,2023-08-12T09:31:00+10:00,2023-08-12,09:31,7,0,7
28,2023-08-12T09:32:00+10:00,2023-08-12,09:32,4,0,4
28,2023-08-12T09:33:00+10:00,2023-08-12,09:33,6,4,10
28,2023-08-12T09:36:00+10:00,2023-08-12,09:36,1,4,5
28,2023-08-12T09:37:00+10:00,2023-08-12,09:37,3,1,4
28,2023-08-12T09:39:00+10:00,2023-08-12,09:39,1,2,3
3,2023-08-12T09:40:00+10:00,2023-08-12,09:40,3,8,11
3,2023-08-12T09:41:00+10:00,2023-08-12,09:41,2,5,7
3,2023-08-12T09:42:00+10:00,2023-08-12,09:42,5,2,7
3,2023-08-12T09:43:00+10:00,2023-08-12,09:43,6,5,11
3,2023-08-12T09:45:00+10:00,2023-08-12,09:45,3,6,9
3,2023-08-12T09:49:00+10:00,2023-08-12,09:49,1,9,10
3,2023-08-12T09:50:00+10:00,2023-08-12,09:50,6,9,15
4,2023-08-12T09:41:00+10:00,2023-08-12,09:41,6,10,16
4,2023-08-12T09:42:00+10:00,2023-08-12,09:42,18,3,21
4,2023-08-12T09:46:00+10:00,2023-08-12,09:46,13,13,26
4,2023-08-12T09:47:00+10:00,2023-08-12,09:47,18,6,24
4,2023-08-12T09:48:00+10:00,2023-08-12,09:48,10,5,15
4,2023-08-12T09:49:00+10:00,2023-08-12,09:49,15,5,20
4,2023-08-12T09:51:00+10:00,2023-08-12,09:51,8,8,16
6,2023-08-12T09:43:00+10:00,2023-08-12,09:43,7,11,18
6,2023-08-12T09:45:00+10:00,2023-08-12,09:45,14,4,18
6,2023-08-12T09:47:00+10:00,2023-08-12,09:47,11,6,17
6,2023-08-12T09:48:00+10:00,2023-08-12,09:48,1,8,9
6,2023-08-12T09:51:00+10:00,2023-08-12,09:51,6,4,10
8,2023-08-12T09:40:00+10:00,2023-08-12,09:40,0,2,2
8,2023-08-12T09:44:00+10:00,2023-08-12,09:44,3,1,4
8,2023-08-12T09:45:00+10:00,2023-08-12,09:45,0,4,4
8,2023-08-12T09:46:00+10:00,2023-08-12,09:46,0,3,3
8,2023-08-12T09:48:00+10:00,2023-08-12,09:48,3,1,4
8,2023-08-12T09:54:00+10:00,2023-08-12,09:54,1,9,10
14,2023-08-12T09:43:00+10:00,2023-08-12,09:43,6,2,8
14,2023-08-12T09:46:00+10:00,2023-08-12,09:46,4,2,6
14,2023-08-12T09:50:00+10:00,2023-08-12,09:50,1,1,2
21,2023-08-12T09:40:00+10:00,2023-08-12,09:40,2,0,2
21,2023-08-12T09:44:00+10:00,2023-08-12,09:44,1,0,1
21,2023-08-12T09:47:00+10:00,2023-08-12,09:47,0,2,2
21,2023-08-12T09:50:00+10:00,2023-08-12,09:50,5,0,5
21,2023-08-12T09:52:00+10:00,2023-08-12,09:52,2,0,2
28,2023-08-12T09:40:00+10:00,2023-08-12,09:40,1,2,3
28,2023-08-12T09:41:00+10:00,2023-08-12,09:41,4,4,8
28,2023-08-12T09:42:00+10:00,2023-08-12,09:42,2,2,4
28,2023-08-12T09:45:00+10:00,2023-08-12,09:45,4,9,13
28,2023-08-12T09:47:00+10:00,2023-08-12,09:47,7,6,13
28,2023-08-12T09:50:00+10:00,2023-08-12,09:50,6,3,9
28,2023-08-12T09:51:00+10:00,2023-08-12,09:51,2,1,3
28,2023-08-12T09:54:00+10:00,2023-08-12,09:54,9,1,10
29,2023-08-12T09:40:00+10:00,2023-08-12,09:40,3,7,10
29,2023-08-12T09:41:00+10:00,2023-08-12,09:41,1,3,4
29,2023-08-12T09:42:00+10:00,2023-08-12,09:42,5,0,5
29,2023-08-12T09:44:00+10:00,2023-08-12,09:44,4,4,8
29,2023-08-12T09:45:00+10:00,2023-08-12,09:45,0,4,4
29,2023-08-12T09:49:00+10:00,2023-08-12,09:49,5,5,10
29,2023-08-12T09:50:00+10:00,2023-08-12,09:50,2,4,6
29,2023-08-12T09:51:00+10:00,2023-08-12,09:51,0,5,5
29,2023-08-12T09:52:00+10:00,2023-08-12,09:52,4,0,4
29,2023-08-12T09:53:00+10:00,2023-08-12,09:53,1,7,8
29,2023-08-12T09:54:00+10:00,2023-08-12,09:54,1,4,5
39,2023-08-12T09:40:00+10:00,2023-08-12,09:40,1,2,3
39,2023-08-12T09:41:00+10:00,2023-08-12,09:41,0,6,6
39,2023-08-12T09:43:00+10:00,2023-08-12,09:43,1,1,2
39,2023-08-12T09:49:00+10:00,2023-08-12,09:49,5,4,9
41,2023-08-12T09:40:00+10:00,2023-08-12,09:40,9,6,15
41,2023-08-12T09:43:00+10:00,2023-08-12,09:43,27,7,34
41,2023-08-12T09:47:00+10:00,2023-08-12,09:47,20,13,33
41,2023-08-12T09:49:00+10:00,2023-08-12,09:49,15,13,28
41,2023-08-12T09:52:00+10:00,2023-08-12,09:52,50,7,57
41,2023-08-12T09:54:00+10:00,2023-08-12,09:54,14,7,21
54,2023-08-12T09:45:00+10:00,2023-08-12,09:45,1,0,1
54,2023-08-12T09:50:00+10:00,2023-08-12,09:50,3,1,4
55,2023-08-12T09:40:00+10:00,2023-08-12,09:40,2,11,13
55,2023-08-12T09:44:00+10:00,2023-08-12,09:44,12,12,24
55,2023-08-12T09:47:00+10:00,2023-08-12,09:47,9,7,16
55,2023-08-12T09:48:00+10:00,2023-08-12,09:48,3,11,14
55,2023-08-12T09:54:00+10:00,2023-08-12,09:54,12,3,15
59,2023-08-12T09:40:00+10:00,2023-08-12,09:40,14,15,29
59,2023-08-12T09:50:00+10:00,2023-08-12,09:50,9,21,30
61,2023-08-12T09:43:00+10:00,2023-08-12,09:43,2,2,4
61,2023-08-12T09:45:00+10:00,2023-08-12,09:45,0,3,3
61,2023-08-12T09:46:00+10:00,2023-08-12,09:46,3,14,17
61,2023-08-12T09:47:00+10:00,2023-08-12,09:47,2,4,6
61,2023-08-12T09:49:00+10:00,2023-08-12,09:49,0,2,2
61,2023-08-12T09:50:00+10:00,2023-08-12,09:50,0,5,5
65,2023-08-12T09:47:00+10:00,2023-08-12,09:47,1,2,3
66,2023-08-12T09:43:00+10:00,2023-08-12,09:43,6,10,16
66,2023-08-12T09:46:00+10:00,2023-08-12,09:46,8,6,14
66,2023-08-12T09:48:00+10:00,2023-08-12,09:48,1,9,10
66,2023-08-12T09:50:00+10:00,2023-08-12,09:50,2,6,8
66,2023-08-12T09:53:00+10:00,2023-08-12,09:53,2,10,12
66,2023-08-12T09:54:00+10:00,2023-08-12,09:54,3,1,4
69,2023-08-12T09:41:00+10:00,2023-08-12,09:41,1,1,2
69,2023-08-12T09:43:00+10:00,2023-08-12,09:43,3,0,3
69,2023-08-12T09:48:00+10:00,2023-08-12,09:48,7,3,10
69,2023-08-12T09:49:00+10:00,2023-08-12,09:49,8,4,12
69,2023-08-12T09:53:00+10:00,2023-08-12,09:53,3,1,4
70,2023-08-12T09:40:00+10:00,2023-08-12,09:40,0,2,2
70,2023-08-12T09:43:00+10:00,2023-08-12,09:43,1,2,3
70,2023-08-12T09:45:00+10:00,2023-08-12,09:45,2,0,2
70,2023-08-12T09:48:00+10:00,2023-08-12,09:48,5,1,6
70,2023-08-12T09:50:00+10:00,2023-08-12,09:50,0,2,2
70,2023-08-12T09:53:00+10:00,2023-08-12,09:53,4,0,4
70,2023-08-12T09:54:00+10:00,2023-08-12,09:54,6,4,10
75,2023-08-12T09:41:00+10:00,2023-08-12,09:41,0,3,3
75,2023-08-12T09:47:00+10:00,2023-08-12,09:47,0,1,1
77,2023-08-12T09:43:00+10:00,2023-08-12,09:43,0,1,1
77,2023-08-12T09:46:00+10:00,2023-08-12,09:46,2,1,3
77,2023-08-12T09:48:00+10:00,2023-08-12,09:48,5,2,7
77,2023-08-12T09:52:00+10:00,2023-08-12,09:52,2,0,2
78,2023-08-12T09:50:00+10:00,2023-08-12,09:50,0,1,1
78,2023-08-12T09:52:00+10:00,2023-08-12,09:52,0,13,13
78,2023-08-12T09:53:00+10:00,2023-08-12,09:53,0,1,1
87,2023-08-12T09:40:00+10:00,2023-08-12,09:40,2,5,7
87,2023-08-12T09:41:00+10:00,2023-08-12,09:41,3,4,7
87,2023-08-12T09:44:00+10:00,2023-08-12,09:44,2,2,4
87,2023-08-12T09:49:00+10:00,2023-08-12,09:49,1,2,3
87,2023-08-12T09:52:00+10:00,2023-08-12,09:52,5,3,8
87,2023-08-12T09:54:00+10:00,2023-08-12,09:54,0,1,1
107,2023-08-12T09:45:00+10:00,2023-08-12,09:45,5,12,17
108,2023-08-12T09:41:00+10:00,2023-08-12,09:41,2,0,2
108,2023-08-12T09:43:00+10:00,2023-08-12,09:43,4,2,6
108,2023-08-12T09:46:00+10:00,2023-08-12,09:46,0,3,3
108,2023-08-12T09:47:00+10:00,2023-08-12,09:47,5,6,11
108,2023-08-12T09:48:00+10:00,2023-08-12,09:48,3,1,4
108,2023-08-12T09:51:00+10:00,2023-08-12,09:51,0,2,2
108,2023-08-12T09:54:00+10:00,2023-08-12,09:54,1,0,1
118,2023-08-12T09:50:00+10:00,2023-08-12,09:50,2,2,4
1,2023-08-12T09:40:00+10:00,2023-08-12,09:40,6,13,19
1,2023-08-12T09:50:00+10:00,2023-08-12,09:50,7,10,17
1,2023-08-12T09:52:00+10:00,2023-08-12,09:52,5,7,12
1,2023-08-12T09:54:00+10:00,2023-08-12,09:54,7,12,19
2,2023-08-12T09:42:00+10:00,2023-08-12,09:42,0,3,3
2,2023-08-12T09:53:00+10:00,2023-08-12,09:53,3,0,3
2,2023-08-12T09:54:00+10:00,2023-08-12,09:54,4,1,5
7,2023-08-12T09:54:00+10:00,2023-08-12,09:54,0,1,1
9,2023-08-12T09:41:00+10:00,2023-08-12,09:41,0,1,1
9,2023-08-12T09:44:00+10:00,2023-08-12,09:44,0,2,2
9,2023-08-12T09:54:00+10:00,2023-08-12,09:54,0,4,4
10,2023-08-12T09:40:00+10:00,2023-08-12,09:40,0,1,1
10,2023-08-12T09:46:00+10:00,2023-08-12,09:46,0,2,2
10,2023-08-12T09:47:00+10:00,2023-08-12,09:47,2,0,2
11,2023-08-12T09:41:00+10:00,2023-08-12,09:41,2,0,2
11,2023-08-12T09:45:00+10:00,2023-08-12,09:45,2,4,6
11,2023-08-12T09:49:00+10:00,2023-08-12,09:49,1,1,2
11,2023-08-12T09:50:00+10:00,2023-08-12,09:50,2,3,5
12,2023-08-12T09:41:00+10:00,2023-08-12,09:41,1,2,3
12,2023-08-12T09:42:00+10:00,2023-08-12,09:42,3,4,7
12,2023-08-12T09:45:00+10:00,2023-08-12,09:45,4,4,8
12,2023-08-12T09:46:00+10:00,2023-08-12,09:46,6,0,6
12,2023-08-12T09:48:00+10:00,2023-08-12,09:48,2,13,15
12,2023-08-12T09:50:00+10:00,2023-08-12,09:50,4,3,7
17,2023-08-12T09:43:00+10:00,2023-08-12,09:43,4,1,5
17,2023-08-12T09:45:00+10:00,2023-08-12,09:45,3,2,5
17,2023-08-12T09:46:00+10:00,2023-08-12,09:46,2,3,5
17,2023-08-12T09:47:00+10:00,2023-08-12,09:47,0,2,2
17,2023-08-12T09:48:00+10:00,2023-08-12,09:48,3,1,4
17,2023-08-12T09:50:00+10:00,2023-08-12,09:50,5,1,6
17,2023-08-12T09:54:00+10:00,2023-08-12,09:54,2,0,2
18,2023-08-12T09:53:00+10:00,2023-08-12,09:53,0,3,3
24,2023-08-12T09:42:00+10:00,2023-08-12,09:42,9,4,13
24,2023-08-12T09:45:00+10:00,2023-08-12,09:45,3,0,3
24,2023-08-12T09:51:00+10:00,2023-08-12,09:51,4,4,8
27,2023-08-12T09:43:00+10:00,2023-08-12,09:43,1,3,4
27,2023-08-12T09:44:00+10:00,2023-08-12,09:44,1,2,3
27,2023-08-12T09:54:00+10:00,2023-08-12,09:54,2,1,3
35,2023-08-12T09:43:00+10:00,2023-08-12,09:43,5,6,11
35,2023-08-12T09:44:00+10:00,2023-08-12,09:44,6,5,11
35,2023-08-12T09:48:00+10:00,2023-08-12,09:48,18,7,25
35,2023-08-12T09:49:00+10:00,2023-08-12,09:49,13,13,26
35,2023-08-12T09:50:00+10:00,2023-08-12,09:50,13,7,20
35,2023-08-12T09:51:00+10:00,2023-08-12,09:51,7,10,17
53,2023-08-12T09:41:00+10:00,2023-08-12,09:41,6,6,12
53,2023-08-12T09:46:00+10:00,2023-08-12,09:46,6,4,10
53,2023-08-12T09:47:00+10:00,2023-08-12,09:47,11,1,12
53,2023-08-12T09:53:00+10:00,2023-08-12,09:53,1,5,6
56,2023-08-12T09:41:00+10:00,2023-08-12,09:41,5,2,7
56,2023-08-12T09:42:00+10:00,2023-08-12,09:42,2,1,3
56,2023-08-12T09:45:00+10:00,2023-08-12,09:45,5,0,5
56,2023-08-12T09:46:00+10:00,2023-08-12,09:46,6,1,7
56,2023-08-12T09:49:00+10:00,2023-08-12,09:49,2,1,3
57,2023-08-12T09:43:00+10:00,2023-08-12,09:43,1,2,3
57,2023-08-12T09:53:00+10:00,2023-08-12,09:53,1,2,3
58,2023-08-12T09:41:00+10:00,2023-08-12,09:41,12,0,12
58,2023-08-12T09:44:00+10:00,2023-08-12,09:44,6,0,6
58,2023-08-12T09:46:00+10:00,2023-08-12,09:46,9,7,16
58,2023-08-12T09:47:00+10:00,2023-08-12,09:47,1,3,4
62,2023-08-12T09:41:00+10:00,2023-08-12,09:41,1,1,2
62,2023-08-12T09:46:00+10:00,2023-08-12,09:46,1,1,2
62,2023-08-12T09:48:00+10:00,2023-08-12,09:48,4,2,6
62,2023-08-12T09:51:00+10:00,2023-08-12,09:51,2,1,3
62,2023-08-12T09:52:00+10:00,2023-08-12,09:52,4,1,5
62,2023-08-12T09:54:00+10:00,2023-08-12,09:54,3,2,5
63,2023-08-12T09:43:00+10:00,2023-08-12,09:43,7,3,10
63,2023-08-12T09:46:00+10:00,2023-08-12,09:46,2,5,7
63,2023-08-12T09:47:00+10:00,2023-08-12,09:47,1,6,7
63,2023-08-12T09:48:00+10:00,2023-08-12,09:48,7,6,13
67,2023-08-12T09:41:00+10:00,2023-08-12,09:41,6,3,9
67,2023-08-12T09:42:00+10:00,2023-08-12,09:42,7,7,14
67,2023-08-12T09:49:00+10:00,2023-08-12,09:49,5,8,13
67,2023-08-12T09:51:00+10:00,2023-08-12,09:51,16,12,28
67,2023-08-12T09:53:00+10:00,2023-08-12,09:53,4,8,12
68,2023-08-12T09:47:00+10:00,2023-08-12,09:47,3,2,5
68,2023-08-12T09:48:00+10:00,2023-08-12,09:48,4,1,5
68,2023-08-12T09:52:00+10:00,2023-08-12,09:52,6,4,10
68,2023-08-12T09:53:00+10:00,2023-08-12,09:53,4,2,6
68,2023-08-12T09:54:00+10:00,2023-08-12,09:54,6,6,12
72,2023-08-12T09:40:00+10:00,2023-08-12,09:40,3,0,3
72,2023-08-12T09:42:00+10:00,2023-08-12,09:42,0,1,1
72,2023-08-12T09:43:00+10:00,2023-08-12,09:43,2,0,2
72,2023-08-12T09:47:00+10:00,2023-08-12,09:47,3,2,5
72,2023-08-12T09:48:00+10:00,2023-08-12,09:48,1,3,4
72,2023-08-12T09:50:00+10:00,2023-08-12,09:50,1,25,26
76,2023-08-12T09:41:00+10:00,2023-08-12,09:41,3,1,4
79,2023-08-12T09:41:00+10:00,2023-08-12,09:41,2,4,6
79,2023-08-12T09:42:00+10:00,2023-08-12,09:42,4,5,9
79,2023-08-12T09:46:00+10:00,2023-08-12,09:46,2,2,4
79,2023-08-12T09:49:00+10:00,2023-08-12,09:49,5,4,9
79,2023-08-12T09:50:00+10:00,2023-08-12,09:50,1,9,10
79,2023-08-12T09:52:00+10:00,2023-08-12,09:52,3,8,11
79,2023-08-12T09:54:00+10:00,2023-08-12,09:54,7,5,12
85,2023-08-12T09:49:00+10:00,2023-08-12,09:49,1,2,3
85,2023-08-12T09:52:00+10:00,2023-08-12,09:52,0,3,3
86,2023-08-12T09:41:00+10:00,2023-08-12,09:41,0,1,1
86,2023-08-12T09:51:00+10:00,2023-08-12,09:51,1,2,3
109,2023-08-12T09:40:00+10:00,2023-08-12,09:40,3,6,9
122,2023-08-12T09:41:00+10:00,2023-08-12,09:41,1,1,2
122,2023-08-12T09:42:00+10:00,2023-08-12,09:42,2,0,2
8,2023-08-12T10:42:00+10:00,2023-08-12,10:42,3,2,5
8,2023-08-12T10:43:00+10:00,2023-08-12,10:43,4,2,6
8,2023-08-12T10:52:00+10:00,2023-08-12,10:52,0,2,2
8,2023-08-12T10:54:00+10:00,2023-08-12,10:54,2,3,5
14,2023-08-12T10:02:00+10:00,2023-08-12,10:02,2,0,2
14,2023-08-12T10:05:00+10:00,2023-08-12,10:05,5,4,9
14,2023-08-12T10:10:00+10:00,2023-08-12,10:10,3,1,4
14,2023-08-12T10:13:00+10:00,2023-08-12,10:13,3,0,3
14,2023-08-12T10:14:00+10:00,2023-08-12,10:14,2,1,3
14,2023-08-12T10:15:00+10:00,2023-08-12,10:15,4,3,7
14,2023-08-12T10:17:00+10:00,2023-08-12,10:17,5,0,5
14,2023-08-12T10:19:00+10:00,2023-08-12,10:19,5,1,6
14,2023-08-12T10:21:00+10:00,2023-08-12,10:21,7,2,9
14,2023-08-12T10:23:00+10:00,2023-08-12,10:23,3,2,5
14,2023-08-12T10:24:00+10:00,2023-08-12,10:24,4,5,9
14,2023-08-12T10:26:00+10:00,2023-08-12,10:26,5,2,7
14,2023-08-12T10:29:00+10:00,2023-08-12,10:29,2,2,4
14,2023-08-12T10:31:00+10:00,2023-08-12,10:31,8,1,9
14,2023-08-12T10:33:00+10:00,2023-08-12,10:33,0,2,2
14,2023-08-12T10:34:00+10:00,2023-08-12,10:34,3,1,4
14,2023-08-12T10:36:00+10:00,2023-08-12,10:36,0,1,1
14,2023-08-12T10:37:00+10:00,2023-08-12,10:37,2,2,4
14,2023-08-12T10:38:00+10:00,2023-08-12,10:38,0,2,2
14,2023-08-12T10:43:00+10:00,2023-08-12,10:43,5,1,6
14,2023-08-12T10:50:00+10:00,2023-08-12,10:50,6,1,7
14,2023-08-12T10:54:00+10:00,2023-08-12,10:54,3,2,5
21,2023-08-12T09:57:00+10:00,2023-08-12,09:57,3,8,11
21,2023-08-12T10:04:00+10:00,2023-08-12,10:04,13,1,14
21,2023-08-12T10:14:00+10:00,2023-08-12,10:14,0,2,2
21,2023-08-12T10:16:00+10:00,2023-08-12,10:16,5,1,6
21,2023-08-12T10:17:00+10:00,2023-08-12,10:17,0,2,2
21,2023-08-12T10:18:00+10:00,2023-08-12,10:18,2,0,2
21,2023-08-12T10:19:00+10:00,2023-08-12,10:19,3,3,6
21,2023-08-12T10:26:00+10:00,2023-08-12,10:26,0,3,3
21,2023-08-12T10:31:00+10:00,2023-08-12,10:31,3,0,3
21,2023-08-12T10:32:00+10:00,2023-08-12,10:32,4,6,10
21,2023-08-12T10:36:00+10:00,2023-08-12,10:36,2,6,8
21,2023-08-12T10:38:00+10:00,2023-08-12,10:38,3,0,3
21,2023-08-12T10:40:00+10:00,2023-08-12,10:40,2,4,6
21,2023-08-12T10:41:00+10:00,2023-08-12,10:41,4,2,6
21,2023-08-12T10:42:00+10:00,2023-08-12,10:42,0,3,3
21,2023-08-12T10:43:00+10:00,2023-08-12,10:43,0,3,3
21,2023-08-12T10:47:00+10:00,2023-08-12,10:47,6,1,7
21,2023-08-12T10:50:00+10:00,2023-08-12,10:50,3,0,3
21,2023-08-12T10:55:00+10:00,2023-08-12,10:55,1,0,1
28,2023-08-12T09:55:00+10:00,2023-08-12,09:55,8,2,10
28,2023-08-12T09:56:00+10:00,2023-08-12,09:56,5,7,12
28,2023-08-12T10:02:00+10:00,2023-08-12,10:02,15,2,17
28,2023-08-12T10:03:00+10:00,2023-08-12,10:03,12,0,12
28,2023-08-12T10:04:00+10:00,2023-08-12,10:04,4,4,8
28,2023-08-12T10:09:00+10:00,2023-08-12,10:09,11,5,16
28,2023-08-12T10:11:00+10:00,2023-08-12,10:11,5,6,11
28,2023-08-12T10:14:00+10:00,2023-08-12,10:14,6,3,9
28,2023-08-12T10:15:00+10:00,2023-08-12,10:15,10,3,13
28,2023-08-12T10:16:00+10:00,2023-08-12,10:16,3,10,13
28,2023-08-12T10:22:00+10:00,2023-08-12,10:22,14,8,22
28,2023-08-12T10:27:00+10:00,2023-08-12,10:27,8,1,9
28,2023-08-12T10:29:00+10:00,2023-08-12,10:29,4,4,8
28,2023-08-12T10:32:00+10:00,2023-08-12,10:32,5,1,6
28,2023-08-12T10:33:00+10:00,2023-08-12,10:33,9,4,13
28,2023-08-12T10:34:00+10:00,2023-08-12,10:34,9,5,14
28,2023-08-12T10:37:00+10:00,2023-08-12,10:37,7,10,17
28,2023-08-12T10:38:00+10:00,2023-08-12,10:38,2,6,8
28,2023-08-12T10:39:00+10:00,2023-08-12,10:39,2,5,7
28,2023-08-12T10:41:00+10:00,2023-08-12,10:41,9,2,11
28,2023-08-12T10:46:00+10:00,2023-08-12,10:46,6,5,11
28,2023-08-12T10:50:00+10:00,2023-08-12,10:50,9,8,17
28,2023-08-12T10:51:00+10:00,2023-08-12,10:51,10,1,11
28,2023-08-12T10:54:00+10:00,2023-08-12,10:54,19,0,19
29,2023-08-12T09:56:00+10:00,2023-08-12,09:56,0,7,7
29,2023-08-12T09:57:00+10:00,2023-08-12,09:57,3,0,3
29,2023-08-12T10:09:00+10:00,2023-08-12,10:09,0,12,12
29,2023-08-12T10:10:00+10:00,2023-08-12,10:10,4,11,15
29,2023-08-12T10:12:00+10:00,2023-08-12,10:12,9,5,14
29,2023-08-12T10:13:00+10:00,2023-08-12,10:13,3,13,16
29,2023-08-12T10:16:00+10:00,2023-08-12,10:16,0,8,8
29,2023-08-12T10:19:00+10:00,2023-08-12,10:19,5,13,18
29,2023-08-12T10:20:00+10:00,2023-08-12,10:20,6,6,12
29,2023-08-12T10:22:00+10:00,2023-08-12,10:22,1,19,20
29,2023-08-12T10:26:00+10:00,2023-08-12,10:26,8,5,13
29,2023-08-12T10:27:00+10:00,2023-08-12,10:27,2,12,14
29,2023-08-12T10:29:00+10:00,2023-08-12,10:29,0,1,1
29,2023-08-12T10:30:00+10:00,2023-08-12,10:30,3,15,18
29,2023-08-12T10:32:00+10:00,2023-08-12,10:32,3,7,10
29,2023-08-12T10:34:00+10:00,2023-08-12,10:34,1,18,19
29,2023-08-12T10:35:00+10:00,2023-08-12,10:35,11,20,31
29,2023-08-12T10:40:00+10:00,2023-08-12,10:40,8,3,11
29,2023-08-12T10:41:00+10:00,2023-08-12,10:41,1,12,13
29,2023-08-12T10:43:00+10:00,2023-08-12,10:43,2,18,20
29,2023-08-12T10:44:00+10:00,2023-08-12,10:44,1,11,12
29,2023-08-12T10:47:00+10:00,2023-08-12,10:47,6,6,12
29,2023-08-12T10:51:00+10:00,2023-08-12,10:51,8,12,20
29,2023-08-12T10:52:00+10:00,2023-08-12,10:52,9,4,13
39,2023-08-12T09:56:00+10:00,2023-08-12,09:56,0,2,2
39,2023-08-12T09:58:00+10:00,2023-08-12,09:58,3,0,3
39,2023-08-12T09:59:00+10:00,2023-08-12,09:59,1,1,2
39,2023-08-12T10:00:00+10:00,2023-08-12,10:00,2,4,6
39,2023-08-12T10:05:00+10:00,2023-08-12,10:05,2,0,2
39,2023-08-12T10:09:00+10:00,2023-08-12,10:09,2,1,3
39,2023-08-12T10:10:00+10:00,2023-08-12,10:10,0,1,1
39,2023-08-12T10:12:00+10:00,2023-08-12,10:12,0,3,3
39,2023-08-12T10:16:00+10:00,2023-08-12,10:16,0,2,2
39,2023-08-12T10:24:00+10:00,2023-08-12,10:24,3,2,5
39,2023-08-12T10:26:00+10:00,2023-08-12,10:26,1,0,1
39,2023-08-12T10:36:00+10:00,2023-08-12,10:36,0,3,3
39,2023-08-12T10:40:00+10:00,2023-08-12,10:40,0,1,1
39,2023-08-12T10:42:00+10:00,2023-08-12,10:42,1,2,3
39,2023-08-12T10:47:00+10:00,2023-08-12,10:47,2,2,4
39,2023-08-12T10:49:00+10:00,2023-08-12,10:49,1,1,2
39,2023-08-12T10:52:00+10:00,2023-08-12,10:52,1,0,1
39,2023-08-12T10:53:00+10:00,2023-08-12,10:53,1,0,1
41,2023-08-12T10:06:00+10:00,2023-08-12,10:06,7,13,20
41,2023-08-12T10:07:00+10:00,2023-08-12,10:07,16,13,29
41,2023-08-12T10:14:00+10:00,2023-08-12,10:14,19,9,28
41,2023-08-12T10:15:00+10:00,2023-08-12,10:15,8,19,27
41,2023-08-12T10:20:00+10:00,2023-08-12,10:20,18,19,37
41,2023-08-12T10:25:00+10:00,2023-08-12,10:25,14,9,23
41,2023-08-12T10:27:00+10:00,2023-08-12,10:27,30,23,53
41,2023-08-12T10:31:00+10:00,2023-08-12,10:31,31,18,49
41,2023-08-12T10:32:00+10:00,2023-08-12,10:32,30,23,53
41,2023-08-12T10:34:00+10:00,2023-08-12,10:34,54,13,67
41,2023-08-12T10:36:00+10:00,2023-08-12,10:36,6,16,22
41,2023-08-12T10:39:00+10:00,2023-08-12,10:39,31,7,38
41,2023-08-12T10:45:00+10:00,2023-08-12,10:45,37,4,41
41,2023-08-12T10:47:00+10:00,2023-08-12,10:47,28,9,37
41,2023-08-12T10:51:00+10:00,2023-08-12,10:51,26,9,35
41,2023-08-12T10:53:00+10:00,2023-08-12,10:53,29,11,40
54,2023-08-12T09:55:00+10:00,2023-08-12,09:55,0,2,2
54,2023-08-12T09:58:00+10:00,2023-08-12,09:58,3,0,3
54,2023-08-12T10:00:00+10:00,2023-08-12,10:00,1,1,2
54,2023-08-12T10:01:00+10:00,2023-08-12,10:01,5,0,5
54,2023-08-12T10:04:00+10:00,2023-08-12,10:04,4,0,4
54,2023-08-12T10:05:00+10:00,2023-08-12,10:05,1,0,1
54,2023-08-12T10:08:00+10:00,2023-08-12,10:08,0,3,3
54,2023-08-12T10:12:00+10:00,2023-08-12,10:12,2,0,2
54,2023-08-12T10:13:00+10:00,2023-08-12,10:13,1,1,2
54,2023-08-12T10:14:00+10:00,2023-08-12,10:14,0,1,1
54,2023-08-12T10:15:00+10:00,2023-08-12,10:15,0,1,1
54,2023-08-12T10:20:00+10:00,2023-08-12,10:20,3,0,3
54,2023-08-12T10:21:00+10:00,2023-08-12,10:21,5,3,8
54,2023-08-12T10:26:00+10:00,2023-08-12,10:26,2,0,2
54,2023-08-12T10:27:00+10:00,2023-08-12,10:27,1,2,3
54,2023-08-12T10:32:00+10:00,2023-08-12,10:32,2,1,3
54,2023-08-12T10:33:00+10:00,2023-08-12,10:33,0,1,1
54,2023-08-12T10:35:00+10:00,2023-08-12,10:35,2,0,2
54,2023-08-12T10:37:00+10:00,2023-08-12,10:37,1,1,2
54,2023-08-12T10:42:00+10:00,2023-08-12,10:42,2,0,2
54,2023-08-12T10:44:00+10:00,2023-08-12,10:44,2,2,4
54,2023-08-12T10:45:00+10:00,2023-08-12,10:45,0,2,2
54,2023-08-12T10:47:00+10:00,2023-08-12,10:47,0,2,2
54,2023-08-12T10:50:00+10:00,2023-08-12,10:50,3,0,3
54,2023-08-12T10:51:00+10:00,2023-08-12,10:51,1,0,1
55,2023-08-12T09:55:00+10:00,2023-08-12,09:55,5,9,14
55,2023-08-12T09:57:00+10:00,2023-08-12,09:57,8,4,12
55,2023-08-12T09:58:00+10:00,2023-08-12,09:58,3,19,22
55,2023-08-12T09:59:00+10:00,2023-08-12,09:59,7,8,15
55,2023-08-12T10:02:00+10:00,2023-08-12,10:02,20,10,30
55,2023-08-12T10:06:00+10:00,2023-08-12,10:06,4,17,21
55,2023-08-12T10:08:00+10:00,2023-08-12,10:08,11,3,14
55,2023-08-12T10:10:00+10:00,2023-08-12,10:10,0,5,5
55,2023-08-12T10:16:00+10:00,2023-08-12,10:16,5,10,15
55,2023-08-12T10:18:00+10:00,2023-08-12,10:18,13,24,37
55,2023-08-12T10:19:00+10:00,2023-08-12,10:19,1,8,9
55,2023-08-12T10:20:00+10:00,2023-08-12,10:20,3,3,6
55,2023-08-12T10:21:00+10:00,2023-08-12,10:21,10,9,19
55,2023-08-12T10:25:00+10:00,2023-08-12,10:25,4,5,9
55,2023-08-12T10:27:00+10:00,2023-08-12,10:27,5,29,34
55,2023-08-12T10:29:00+10:00,2023-08-12,10:29,15,7,22
55,2023-08-12T10:30:00+10:00,2023-08-12,10:30,3,6,9
55,2023-08-12T10:38:00+10:00,2023-08-12,10:38,1,13,14
55,2023-08-12T10:46:00+10:00,2023-08-12,10:46,6,10,16
55,2023-08-12T10:52:00+10:00,2023-08-12,10:52,9,16,25
55,2023-08-12T10:53:00+10:00,2023-08-12,10:53,8,10,18
55,2023-08-12T10:55:00+10:00,2023-08-12,10:55,14,15,29
59,2023-08-12T10:00:00+10:00,2023-08-12,10:00,9,17,26
59,2023-08-12T10:10:00+10:00,2023-08-12,10:10,30,19,49
59,2023-08-12T10:55:00+10:00,2023-08-12,10:55,28,34,62
61,2023-08-12T09:57:00+10:00,2023-08-12,09:57,2,13,15
61,2023-08-12T10:00:00+10:00,2023-08-12,10:00,0,5,5
61,2023-08-12T10:04:00+10:00,2023-08-12,10:04,0,5,5
61,2023-08-12T10:06:00+10:00,2023-08-12,10:06,0,2,2
61,2023-08-12T10:07:00+10:00,2023-08-12,10:07,0,4,4
61,2023-08-12T10:11:00+10:00,2023-08-12,10:11,5,2,7
61,2023-08-12T10:15:00+10:00,2023-08-12,10:15,0,8,8
61,2023-08-12T10:19:00+10:00,2023-08-12,10:19,5,3,8
61,2023-08-12T10:20:00+10:00,2023-08-12,10:20,0,3,3
61,2023-08-12T10:21:00+10:00,2023-08-12,10:21,4,4,8
61,2023-08-12T10:22:00+10:00,2023-08-12,10:22,3,17,20
61,2023-08-12T10:29:00+10:00,2023-08-12,10:29,2,7,9
61,2023-08-12T10:30:00+10:00,2023-08-12,10:30,0,5,5
61,2023-08-12T10:33:00+10:00,2023-08-12,10:33,1,5,6
61,2023-08-12T10:38:00+10:00,2023-08-12,10:38,6,7,13
61,2023-08-12T10:42:00+10:00,2023-08-12,10:42,1,8,9
61,2023-08-12T10:45:00+10:00,2023-08-12,10:45,0,7,7
61,2023-08-12T10:46:00+10:00,2023-08-12,10:46,1,7,8
61,2023-08-12T10:50:00+10:00,2023-08-12,10:50,4,3,7
61,2023-08-12T10:52:00+10:00,2023-08-12,10:52,1,3,4
61,2023-08-12T10:53:00+10:00,2023-08-12,10:53,1,2,3
61,2023-08-12T10:54:00+10:00,2023-08-12,10:54,6,11,17
65,2023-08-12T09:57:00+10:00,2023-08-12,09:57,14,1,15
65,2023-08-12T10:06:00+10:00,2023-08-12,10:06,1,3,4
65,2023-08-12T10:08:00+10:00,2023-08-12,10:08,6,2,8
65,2023-08-12T10:09:00+10:00,2023-08-12,10:09,1,3,4
65,2023-08-12T10:14:00+10:00,2023-08-12,10:14,5,9,14
65,2023-08-12T10:17:00+10:00,2023-08-12,10:17,6,5,11
65,2023-08-12T10:18:00+10:00,2023-08-12,10:18,5,14,19
65,2023-08-12T10:19:00+10:00,2023-08-12,10:19,2,5,7
65,2023-08-12T10:20:00+10:00,2023-08-12,10:20,7,5,12
65,2023-08-12T10:26:00+10:00,2023-08-12,10:26,10,3,13
65,2023-08-12T10:32:00+10:00,2023-08-12,10:32,11,9,20
65,2023-08-12T10:34:00+10:00,2023-08-12,10:34,3,4,7
65,2023-08-12T10:37:00+10:00,2023-08-12,10:37,0,6,6
65,2023-08-12T10:39:00+10:00,2023-08-12,10:39,0,4,4
65,2023-08-12T10:40:00+10:00,2023-08-12,10:40,4,1,5
65,2023-08-12T10:45:00+10:00,2023-08-12,10:45,6,3,9
65,2023-08-12T10:46:00+10:00,2023-08-12,10:46,1,1,2
65,2023-08-12T10:47:00+10:00,2023-08-12,10:47,1,6,7
65,2023-08-12T10:50:00+10:00,2023-08-12,10:50,7,4,11
65,2023-08-12T10:51:00+10:00,2023-08-12,10:51,13,4,17
65,2023-08-12T10:52:00+10:00,2023-08-12,10:52,10,0,10
65,2023-08-12T10:53:00+10:00,2023-08-12,10:53,1,3,4
65,2023-08-12T10:54:00+10:00,2023-08-12,10:54,9,1,10
65,2023-08-12T10:55:00+10:00,2023-08-12,10:55,1,3,4
66,2023-08-12T09:55:00+10:00,2023-08-12,09:55,5,9,14
66,2023-08-12T09:58:00+10:00,2023-08-12,09:58,7,3,10
66,2023-08-12T10:05:00+10:00,2023-08-12,10:05,4,16,20
66,2023-08-12T10:08:00+10:00,2023-08-12,10:08,0,10,10
66,2023-08-12T10:09:00+10:00,2023-08-12,10:09,1,6,7
66,2023-08-12T10:10:00+10:00,2023-08-12,10:10,5,9,14
66,2023-08-12T10:11:00+10:00,2023-08-12,10:11,7,9,16
66,2023-08-12T10:15:00+10:00,2023-08-12,10:15,7,6,13
66,2023-08-12T10:21:00+10:00,2023-08-12,10:21,14,8,22
66,2023-08-12T10:22:00+10:00,2023-08-12,10:22,7,7,14
66,2023-08-12T10:23:00+10:00,2023-08-12,10:23,8,8,16
66,2023-08-12T10:24:00+10:00,2023-08-12,10:24,7,7,14
66,2023-08-12T10:33:00+10:00,2023-08-12,10:33,6,8,14
66,2023-08-12T10:36:00+10:00,2023-08-12,10:36,3,6,9
66,2023-08-12T10:37:00+10:00,2023-08-12,10:37,12,3,15
66,2023-08-12T10:39:00+10:00,2023-08-12,10:39,4,17,21
66,2023-08-12T10:40:00+10:00,2023-08-12,10:40,8,8,16
66,2023-08-12T10:42:00+10:00,2023-08-12,10:42,8,9,17
66,2023-08-12T10:43:00+10:00,2023-08-12,10:43,5,1,6
66,2023-08-12T10:44:00+10:00,2023-08-12,10:44,9,11,20
66,2023-08-12T10:45:00+10:00,2023-08-12,10:45,15,13,28
66,2023-08-12T10:48:00+10:00,2023-08-12,10:48,13,11,24
66,2023-08-12T10:51:00+10:00,2023-08-12,10:51,15,18,33
66,2023-08-12T10:53:00+10:00,2023-08-12,10:53,7,12,19
69,2023-08-12T09:56:00+10:00,2023-08-12,09:56,4,6,10
69,2023-08-12T09:57:00+10:00,2023-08-12,09:57,5,1,6
69,2023-08-12T10:00:00+10:00,2023-08-12,10:00,12,0,12
69,2023-08-12T10:02:00+10:00,2023-08-12,10:02,10,4,14
69,2023-08-12T10:06:00+10:00,2023-08-12,10:06,4,3,7
69,2023-08-12T10:10:00+10:00,2023-08-12,10:10,5,4,9
69,2023-08-12T10:12:00+10:00,2023-08-12,10:12,1,2,3
69,2023-08-12T10:14:00+10:00,2023-08-12,10:14,5,4,9
69,2023-08-12T10:20:00+10:00,2023-08-12,10:20,3,2,5
69,2023-08-12T10:23:00+10:00,2023-08-12,10:23,6,6,12
69,2023-08-12T10:26:00+10:00,2023-08-12,10:26,11,2,13
69,2023-08-12T10:27:00+10:00,2023-08-12,10:27,6,2,8
69,2023-08-12T10:31:00+10:00,2023-08-12,10:31,6,2,8
69,2023-08-12T10:34:00+10:00,2023-08-12,10:34,0,4,4
69,2023-08-12T10:41:00+10:00,2023-08-12,10:41,1,3,4
69,2023-08-12T10:48:00+10:00,2023-08-12,10:48,1,3,4
69,2023-08-12T10:50:00+10:00,2023-08-12,10:50,3,4,7
69,2023-08-12T10:55:00+10:00,2023-08-12,10:55,2,2,4
70,2023-08-12T10:00:00+10:00,2023-08-12,10:00,2,1,3
70,2023-08-12T10:01:00+10:00,2023-08-12,10:01,6,3,9
70,2023-08-12T10:03:00+10:00,2023-08-12,10:03,3,0,3
70,2023-08-12T10:06:00+10:00,2023-08-12,10:06,3,2,5
70,2023-08-12T10:07:00+10:00,2023-08-12,10:07,2,4,6
70,2023-08-12T10:11:00+10:00,2023-08-12,10:11,9,3,12
70,2023-08-12T10:14:00+10:00,2023-08-12,10:14,4,4,8
70,2023-08-12T10:21:00+10:00,2023-08-12,10:21,1,1,2
70,2023-08-12T10:22:00+10:00,2023-08-12,10:22,3,3,6
70,2023-08-12T10:23:00+10:00,2023-08-12,10:23,1,4,5
70,2023-08-12T10:27:00+10:00,2023-08-12,10:27,1,4,5
70,2023-08-12T10:28:00+10:00,2023-08-12,10:28,4,2,6
70,2023-08-12T10:33:00+10:00,2023-08-12,10:33,2,2,4
70,2023-08-12T10:41:00+10:00,2023-08-12,10:41,7,4,11
70,2023-08-12T10:43:00+10:00,2023-08-12,10:43,6,6,12
70,2023-08-12T10:44:00+10:00,2023-08-12,10:44,3,5,8
70,2023-08-12T10:47:00+10:00,2023-08-12,10:47,1,3,4
70,2023-08-12T10:48:00+10:00,2023-08-12,10:48,4,3,7
70,2023-08-12T10:54:00+10:00,2023-08-12,10:54,1,1,2
71,2023-08-12T10:16:00+10:00,2023-08-12,10:16,0,1,1
71,2023-08-12T10:17:00+10:00,2023-08-12,10:17,0,1,1
75,2023-08-12T09:57:00+10:00,2023-08-12,09:57,1,0,1
75,2023-08-12T10:19:00+10:00,2023-08-12,10:19,7,0,7
75,2023-08-12T10:20:00+10:00,2023-08-12,10:20,2,0,2
75,2023-08-12T10:34:00+10:00,2023-08-12,10:34,0,1,1
75,2023-08-12T10:42:00+10:00,2023-08-12,10:42,6,1,7
75,2023-08-12T10:47:00+10:00,2023-08-12,10:47,1,0,1
75,2023-08-12T10:50:00+10:00,2023-08-12,10:50,3,0,3
75,2023-08-12T10:53:00+10:00,2023-08-12,10:53,2,1,3
75,2023-08-12T10:54:00+10:00,2023-08-12,10:54,4,0,4
77,2023-08-12T09:59:00+10:00,2023-08-12,09:59,2,1,3
77,2023-08-12T10:00:00+10:00,2023-08-12,10:00,2,2,4
77,2023-08-12T10:02:00+10:00,2023-08-12,10:02,1,0,1
77,2023-08-12T10:08:00+10:00,2023-08-12,10:08,4,2,6
77,2023-08-12T10:09:00+10:00,2023-08-12,10:09,3,0,3
77,2023-08-12T10:10:00+10:00,2023-08-12,10:10,4,6,10
77,2023-08-12T10:12:00+10:00,2023-08-12,10:12,3,6,9
77,2023-08-12T10:16:00+10:00,2023-08-12,10:16,3,2,5
77,2023-08-12T10:20:00+10:00,2023-08-12,10:20,2,2,4
77,2023-08-12T10:24:00+10:00,2023-08-12,10:24,4,3,7
77,2023-08-12T10:28:00+10:00,2023-08-12,10:28,1,3,4
77,2023-08-12T10:30:00+10:00,2023-08-12,10:30,2,3,5
77,2023-08-12T10:35:00+10:00,2023-08-12,10:35,3,1,4
77,2023-08-12T10:38:00+10:00,2023-08-12,10:38,2,9,11
77,2023-08-12T10:41:00+10:00,2023-08-12,10:41,2,0,2
77,2023-08-12T10:42:00+10:00,2023-08-12,10:42,5,3,8
77,2023-08-12T10:43:00+10:00,2023-08-12,10:43,0,4,4
77,2023-08-12T10:46:00+10:00,2023-08-12,10:46,0,3,3
77,2023-08-12T10:53:00+10:00,2023-08-12,10:53,3,5,8
78,2023-08-12T09:55:00+10:00,2023-08-12,09:55,0,2,2
78,2023-08-12T09:59:00+10:00,2023-08-12,09:59,2,2,4
78,2023-08-12T10:06:00+10:00,2023-08-12,10:06,0,1,1
78,2023-08-12T10:11:00+10:00,2023-08-12,10:11,0,1,1
78,2023-08-12T10:21:00+10:00,2023-08-12,10:21,0,1,1
78,2023-08-12T10:24:00+10:00,2023-08-12,10:24,2,1,3
78,2023-08-12T10:25:00+10:00,2023-08-12,10:25,1,2,3
78,2023-08-12T10:33:00+10:00,2023-08-12,10:33,1,0,1
78,2023-08-12T10:34:00+10:00,2023-08-12,10:34,1,0,1
78,2023-08-12T10:38:00+10:00,2023-08-12,10:38,0,3,3
78,2023-08-12T10:41:00+10:00,2023-08-12,10:41,1,0,1
78,2023-08-12T10:46:00+10:00,2023-08-12,10:46,5,0,5
78,2023-08-12T10:49:00+10:00,2023-08-12,10:49,0,1,1
78,2023-08-12T10:55:00+10:00,2023-08-12,10:55,2,0,2
84,2023-08-12T10:05:00+10:00,2023-08-12,10:05,47,32,79
84,2023-08-12T10:15:00+10:00,2023-08-12,10:15,65,41,106
84,2023-08-12T10:50:00+10:00,2023-08-12,10:50,82,47,129
87,2023-08-12T09:58:00+10:00,2023-08-12,09:58,8,2,10
87,2023-08-12T10:00:00+10:00,2023-08-12,10:00,3,2,5
87,2023-08-12T10:03:00+10:00,2023-08-12,10:03,1,3,4
87,2023-08-12T10:04:00+10:00,2023-08-12,10:04,0,1,1
87,2023-08-12T10:07:00+10:00,2023-08-12,10:07,1,1,2
87,2023-08-12T10:11:00+10:00,2023-08-12,10:11,1,4,5
87,2023-08-12T10:14:00+10:00,2023-08-12,10:14,0,2,2
87,2023-08-12T10:15:00+10:00,2023-08-12,10:15,1,3,4
87,2023-08-12T10:17:00+10:00,2023-08-12,10:17,1,1,2
87,2023-08-12T10:25:00+10:00,2023-08-12,10:25,4,1,5
87,2023-08-12T10:27:00+10:00,2023-08-12,10:27,2,1,3
87,2023-08-12T10:33:00+10:00,2023-08-12,10:33,1,1,2
87,2023-08-12T10:39:00+10:00,2023-08-12,10:39,0,3,3
87,2023-08-12T10:40:00+10:00,2023-08-12,10:40,4,8,12
87,2023-08-12T10:42:00+10:00,2023-08-12,10:42,8,0,8
87,2023-08-12T10:47:00+10:00,2023-08-12,10:47,2,0,2
87,2023-08-12T10:49:00+10:00,2023-08-12,10:49,1,0,1
87,2023-08-12T10:53:00+10:00,2023-08-12,10:53,3,0,3
87,2023-08-12T10:55:00+10:00,2023-08-12,10:55,1,1,2
107,2023-08-12T10:00:00+10:00,2023-08-12,10:00,3,13,16
107,2023-08-12T10:25:00+10:00,2023-08-12,10:25,17,10,27
108,2023-08-12T09:58:00+10:00,2023-08-12,09:58,1,3,4
108,2023-08-12T10:05:00+10:00,2023-08-12,10:05,3,4,7
108,2023-08-12T10:07:00+10:00,2023-08-12,10:07,0,3,3
108,2023-08-12T10:09:00+10:00,2023-08-12,10:09,1,1,2
108,2023-08-12T10:10:00+10:00,2023-08-12,10:10,3,1,4
108,2023-08-12T10:11:00+10:00,2023-08-12,10:11,1,1,2
108,2023-08-12T10:15:00+10:00,2023-08-12,10:15,0,1,1
108,2023-08-12T10:17:00+10:00,2023-08-12,10:17,0,1,1
108,2023-08-12T10:25:00+10:00,2023-08-12,10:25,4,0,4
108,2023-08-12T10:28:00+10:00,2023-08-12,10:28,4,1,5
108,2023-08-12T10:29:00+10:00,2023-08-12,10:29,0,2,2
108,2023-08-12T10:30:00+10:00,2023-08-12,10:30,2,0,2
108,2023-08-12T10:33:00+10:00,2023-08-12,10:33,3,3,6
108,2023-08-12T10:36:00+10:00,2023-08-12,10:36,0,2,2
108,2023-08-12T10:39:00+10:00,2023-08-12,10:39,2,4,6
108,2023-08-12T10:41:00+10:00,2023-08-12,10:41,4,3,7
108,2023-08-12T10:44:00+10:00,2023-08-12,10:44,2,0,2
108,2023-08-12T10:50:00+10:00,2023-08-12,10:50,2,2,4
108,2023-08-12T10:52:00+10:00,2023-08-12,10:52,0,4,4
108,2023-08-12T10:53:00+10:00,2023-08-12,10:53,7,0,7
118,2023-08-12T10:00:00+10:00,2023-08-12,10:00,1,6,7
118,2023-08-12T10:10:00+10:00,2023-08-12,10:10,0,1,1
118,2023-08-12T10:20:00+10:00,2023-08-12,10:20,2,0,2
118,2023-08-12T10:25:00+10:00,2023-08-12,10:25,2,0,2
118,2023-08-12T10:45:00+10:00,2023-08-12,10:45,0,2,2
118,2023-08-12T10:55:00+10:00,2023-08-12,10:55,7,5,12
1,2023-08-12T09:55:00+10:00,2023-08-12,09:55,7,13,20
1,2023-08-12T10:03:00+10:00,2023-08-12,10:03,11,4,15
1,2023-08-12T10:06:00+10:00,2023-08-12,10:06,11,10,21
1,2023-08-12T10:07:00+10:00,2023-08-12,10:07,13,7,20
1,2023-08-12T10:11:00+10:00,2023-08-12,10:11,6,10,16
1,2023-08-12T10:12:00+10:00,2023-08-12,10:12,11,3,14
1,2023-08-12T10:13:00+10:00,2023-08-12,10:13,12,10,22
1,2023-08-12T10:16:00+10:00,2023-08-12,10:16,17,5,22
1,2023-08-12T10:18:00+10:00,2023-08-12,10:18,17,6,23
1,2023-08-12T10:25:00+10:00,2023-08-12,10:25,6,3,9
1,2023-08-12T10:27:00+10:00,2023-08-12,10:27,6,16,22
1,2023-08-12T10:30:00+10:00,2023-08-12,10:30,12,5,17
1,2023-08-12T10:31:00+10:00,2023-08-12,10:31,14,11,25
1,2023-08-12T10:35:00+10:00,2023-08-12,10:35,12,13,25
1,2023-08-12T10:39:00+10:00,2023-08-12,10:39,14,18,32
1,2023-08-12T10:43:00+10:00,2023-08-12,10:43,13,15,28
1,2023-08-12T10:46:00+10:00,2023-08-12,10:46,14,30,44
1,2023-08-12T10:47:00+10:00,2023-08-12,10:47,9,14,23
1,2023-08-12T10:48:00+10:00,2023-08-12,10:48,9,15,24
1,2023-08-12T10:50:00+10:00,2023-08-12,10:50,7,15,22
1,2023-08-12T10:51:00+10:00,2023-08-12,10:51,12,12,24
1,2023-08-12T10:55:00+10:00,2023-08-12,10:55,20,6,26
2,2023-08-12T09:59:00+10:00,2023-08-12,09:59,1,10,11
2,2023-08-12T10:01:00+10:00,2023-08-12,10:01,1,9,10
2,2023-08-12T10:02:00+10:00,2023-08-12,10:02,2,10,12
2,2023-08-12T10:03:00+10:00,2023-08-12,10:03,3,5,8
2,2023-08-12T10:07:00+10:00,2023-08-12,10:07,6,2,8
2,2023-08-12T10:12:00+10:00,2023-08-12,10:12,3,4,7
2,2023-08-12T10:13:00+10:00,2023-08-12,10:13,6,8,14
2,2023-08-12T10:19:00+10:00,2023-08-12,10:19,7,3,10
2,2023-08-12T10:21:00+10:00,2023-08-12,10:21,3,9,12
2,2023-08-12T10:25:00+10:00,2023-08-12,10:25,11,2,13
2,2023-08-12T10:26:00+10:00,2023-08-12,10:26,7,4,11
2,2023-08-12T10:27:00+10:00,2023-08-12,10:27,0,9,9
2,2023-08-12T10:29:00+10:00,2023-08-12,10:29,9,12,21
2,2023-08-12T10:30:00+10:00,2023-08-12,10:30,5,12,17
2,2023-08-12T10:31:00+10:00,2023-08-12,10:31,11,10,21
2,2023-08-12T10:32:00+10:00,2023-08-12,10:32,1,3,4
2,2023-08-12T10:33:00+10:00,2023-08-12,10:33,7,14,21
2,2023-08-12T10:37:00+10:00,2023-08-12,10:37,1,15,16
2,2023-08-12T10:39:00+10:00,2023-08-12,10:39,7,8,15
2,2023-08-12T10:43:00+10:00,2023-08-12,10:43,6,10,16
2,2023-08-12T10:49:00+10:00,2023-08-12,10:49,3,9,12
7,2023-08-12T10:02:00+10:00,2023-08-12,10:02,0,2,2
7,2023-08-12T10:09:00+10:00,2023-08-12,10:09,0,3,3
7,2023-08-12T10:12:00+10:00,2023-08-12,10:12,2,0,2
7,2023-08-12T10:14:00+10:00,2023-08-12,10:14,0,1,1
7,2023-08-12T10:15:00+10:00,2023-08-12,10:15,1,3,4
7,2023-08-12T10:21:00+10:00,2023-08-12,10:21,1,0,1
7,2023-08-12T10:23:00+10:00,2023-08-12,10:23,1,2,3
7,2023-08-12T10:26:00+10:00,2023-08-12,10:26,2,0,2
7,2023-08-12T10:30:00+10:00,2023-08-12,10:30,0,1,1
7,2023-08-12T10:32:00+10:00,2023-08-12,10:32,0,5,5
7,2023-08-12T10:34:00+10:00,2023-08-12,10:34,1,2,3
7,2023-08-12T10:47:00+10:00,2023-08-12,10:47,0,1,1
7,2023-08-12T10:52:00+10:00,2023-08-12,10:52,2,4,6
9,2023-08-12T09:55:00+10:00,2023-08-12,09:55,1,0,1
9,2023-08-12T10:01:00+10:00,2023-08-12,10:01,0,2,2
9,2023-08-12T10:10:00+10:00,2023-08-12,10:10,0,1,1
9,2023-08-12T10:13:00+10:00,2023-08-12,10:13,0,2,2
9,2023-08-12T10:16:00+10:00,2023-08-12,10:16,1,5,6
9,2023-08-12T10:19:00+10:00,2023-08-12,10:19,1,1,2
9,2023-08-12T10:25:00+10:00,2023-08-12,10:25,0,3,3
9,2023-08-12T10:26:00+10:00,2023-08-12,10:26,1,1,2
9,2023-08-12T10:34:00+10:00,2023-08-12,10:34,3,2,5
9,2023-08-12T10:36:00+10:00,2023-08-12,10:36,9,3,12
9,2023-08-12T10:40:00+10:00,2023-08-12,10:40,0,2,2
9,2023-08-12T10:48:00+10:00,2023-08-12,10:48,4,4,8
9,2023-08-12T10:50:00+10:00,2023-08-12,10:50,1,0,1
9,2023-08-12T10:52:00+10:00,2023-08-12,10:52,0,16,16
9,2023-08-12T10:54:00+10:00,2023-08-12,10:54,0,2,2
10,2023-08-12T09:59:00+10:00,2023-08-12,09:59,0,1,1
10,2023-08-12T10:12:00+10:00,2023-08-12,10:12,1,1,2
10,2023-08-12T10:14:00+10:00,2023-08-12,10:14,0,4,4
10,2023-08-12T10:18:00+10:00,2023-08-12,10:18,4,3,7
10,2023-08-12T10:19:00+10:00,2023-08-12,10:19,0,2,2
10,2023-08-12T10:30:00+10:00,2023-08-12,10:30,5,0,5
10,2023-08-12T10:39:00+10:00,2023-08-12,10:39,4,1,5
10,2023-08-12T10:42:00+10:00,2023-08-12,10:42,0,2,2
10,2023-08-12T10:47:00+10:00,2023-08-12,10:47,5,2,7
11,2023-08-12T10:00:00+10:00,2023-08-12,10:00,2,2,4
11,2023-08-12T10:02:00+10:00,2023-08-12,10:02,2,0,2
11,2023-08-12T10:03:00+10:00,2023-08-12,10:03,1,0,1
11,2023-08-12T10:05:00+10:00,2023-08-12,10:05,0,1,1
11,2023-08-12T10:06:00+10:00,2023-08-12,10:06,0,1,1
11,2023-08-12T10:08:00+10:00,2023-08-12,10:08,1,1,2
11,2023-08-12T10:10:00+10:00,2023-08-12,10:10,5,6,11
11,2023-08-12T10:30:00+10:00,2023-08-12,10:30,3,0,3
11,2023-08-12T10:35:00+10:00,2023-08-12,10:35,4,0,4
11,2023-08-12T10:36:00+10:00,2023-08-12,10:36,0,1,1
11,2023-08-12T10:41:00+10:00,2023-08-12,10:41,0,2,2
11,2023-08-12T10:42:00+10:00,2023-08-12,10:42,0,1,1
11,2023-08-12T10:44:00+10:00,2023-08-12,10:44,2,2,4
11,2023-08-12T10:45:00+10:00,2023-08-12,10:45,7,1,8
11,2023-08-12T10:54:00+10:00,2023-08-12,10:54,1,7,8
11,2023-08-12T10:55:00+10:00,2023-08-12,10:55,2,2,4
12,2023-08-12T09:57:00+10:00,2023-08-12,09:57,0,5,5
12,2023-08-12T10:02:00+10:00,2023-08-12,10:02,1,0,1
12,2023-08-12T10:03:00+10:00,2023-08-12,10:03,2,4,6
12,2023-08-12T10:06:00+10:00,2023-08-12,10:06,0,2,2
12,2023-08-12T10:12:00+10:00,2023-08-12,10:12,1,3,4
12,2023-08-12T10:14:00+10:00,2023-08-12,10:14,0,3,3
12,2023-08-12T10:15:00+10:00,2023-08-12,10:15,2,1,3
12,2023-08-12T10:17:00+10:00,2023-08-12,10:17,1,4,5
12,2023-08-12T10:26:00+10:00,2023-08-12,10:26,3,2,5
12,2023-08-12T10:32:00+10:00,2023-08-12,10:32,1,3,4
12,2023-08-12T10:34:00+10:00,2023-08-12,10:34,9,1,10
12,2023-08-12T10:35:00+10:00,2023-08-12,10:35,1,0,1
12,2023-08-12T10:42:00+10:00,2023-08-12,10:42,2,4,6
12,2023-08-12T10:50:00+10:00,2023-08-12,10:50,2,14,16
12,2023-08-12T10:53:00+10:00,2023-08-12,10:53,3,1,4
12,2023-08-12T10:55:00+10:00,2023-08-12,10:55,3,4,7
17,2023-08-12T09:58:00+10:00,2023-08-12,09:58,5,2,7
17,2023-08-12T10:00:00+10:00,2023-08-12,10:00,1,0,1
17,2023-08-12T10:04:00+10:00,2023-08-12,10:04,8,0,8
17,2023-08-12T10:05:00+10:00,2023-08-12,10:05,2,0,2
17,2023-08-12T10:10:00+10:00,2023-08-12,10:10,5,1,6
17,2023-08-12T10:11:00+10:00,2023-08-12,10:11,3,1,4
17,2023-08-12T10:15:00+10:00,2023-08-12,10:15,2,3,5
17,2023-08-12T10:16:00+10:00,2023-08-12,10:16,3,1,4
17,2023-08-12T10:18:00+10:00,2023-08-12,10:18,2,0,2
17,2023-08-12T10:20:00+10:00,2023-08-12,10:20,1,4,5
17,2023-08-12T10:24:00+10:00,2023-08-12,10:24,3,2,5
17,2023-08-12T10:28:00+10:00,2023-08-12,10:28,1,4,5
17,2023-08-12T10:29:00+10:00,2023-08-12,10:29,1,6,7
17,2023-08-12T10:31:00+10:00,2023-08-12,10:31,4,1,5
17,2023-08-12T10:32:00+10:00,2023-08-12,10:32,1,3,4
17,2023-08-12T10:35:00+10:00,2023-08-12,10:35,9,4,13
17,2023-08-12T10:36:00+10:00,2023-08-12,10:36,2,1,3
17,2023-08-12T10:37:00+10:00,2023-08-12,10:37,3,1,4
17,2023-08-12T10:41:00+10:00,2023-08-12,10:41,6,1,7
17,2023-08-12T10:43:00+10:00,2023-08-12,10:43,1,2,3
17,2023-08-12T10:44:00+10:00,2023-08-12,10:44,16,3,19
17,2023-08-12T10:46:00+10:00,2023-08-12,10:46,0,7,7
17,2023-08-12T10:48:00+10:00,2023-08-12,10:48,1,6,7
17,2023-08-12T10:49:00+10:00,2023-08-12,10:49,3,3,6
17,2023-08-12T10:50:00+10:00,2023-08-12,10:50,5,1,6
17,2023-08-12T10:51:00+10:00,2023-08-12,10:51,5,3,8
17,2023-08-12T10:52:00+10:00,2023-08-12,10:52,2,1,3
18,2023-08-12T10:00:00+10:00,2023-08-12,10:00,3,0,3
18,2023-08-12T10:01:00+10:00,2023-08-12,10:01,0,1,1
18,2023-08-12T10:11:00+10:00,2023-08-12,10:11,0,1,1
18,2023-08-12T10:22:00+10:00,2023-08-12,10:22,3,1,4
18,2023-08-12T10:26:00+10:00,2023-08-12,10:26,3,0,3
18,2023-08-12T10:33:00+10:00,2023-08-12,10:33,0,1,1
18,2023-08-12T10:42:00+10:00,2023-08-12,10:42,0,1,1
18,2023-08-12T10:49:00+10:00,2023-08-12,10:49,4,4,8
18,2023-08-12T10:54:00+10:00,2023-08-12,10:54,1,2,3
24,2023-08-12T09:59:00+10:00,2023-08-12,09:59,10,9,19
24,2023-08-12T10:01:00+10:00,2023-08-12,10:01,17,3,20
24,2023-08-12T10:04:00+10:00,2023-08-12,10:04,17,18,35
24,2023-08-12T10:09:00+10:00,2023-08-12,10:09,4,1,5
24,2023-08-12T10:11:00+10:00,2023-08-12,10:11,11,8,19
24,2023-08-12T10:12:00+10:00,2023-08-12,10:12,5,2,7
24,2023-08-12T10:15:00+10:00,2023-08-12,10:15,1,9,10
24,2023-08-12T10:18:00+10:00,2023-08-12,10:18,8,11,19
24,2023-08-12T10:23:00+10:00,2023-08-12,10:23,1,23,24
24,2023-08-12T10:29:00+10:00,2023-08-12,10:29,6,8,14
24,2023-08-12T10:33:00+10:00,2023-08-12,10:33,1,7,8
24,2023-08-12T10:34:00+10:00,2023-08-12,10:34,4,4,8
24,2023-08-12T10:35:00+10:00,2023-08-12,10:35,4,5,9
24,2023-08-12T10:37:00+10:00,2023-08-12,10:37,12,5,17
24,2023-08-12T10:39:00+10:00,2023-08-12,10:39,3,8,11
24,2023-08-12T10:43:00+10:00,2023-08-12,10:43,13,9,22
24,2023-08-12T10:48:00+10:00,2023-08-12,10:48,4,12,16
24,2023-08-12T10:49:00+10:00,2023-08-12,10:49,12,13,25
24,2023-08-12T10:50:00+10:00,2023-08-12,10:50,8,5,13
24,2023-08-12T10:53:00+10:00,2023-08-12,10:53,12,6,18
24,2023-08-12T10:55:00+10:00,2023-08-12,10:55,4,12,16
27,2023-08-12T09:55:00+10:00,2023-08-12,09:55,5,0,5
27,2023-08-12T09:57:00+10:00,2023-08-12,09:57,1,2,3
27,2023-08-12T09:58:00+10:00,2023-08-12,09:58,7,2,9
27,2023-08-12T10:01:00+10:00,2023-08-12,10:01,0,1,1
27,2023-08-12T10:04:00+10:00,2023-08-12,10:04,1,3,4
27,2023-08-12T10:06:00+10:00,2023-08-12,10:06,1,2,3
27,2023-08-12T10:08:00+10:00,2023-08-12,10:08,6,3,9
27,2023-08-12T10:09:00+10:00,2023-08-12,10:09,2,3,5
27,2023-08-12T10:10:00+10:00,2023-08-12,10:10,0,7,7
27,2023-08-12T10:11:00+10:00,2023-08-12,10:11,4,0,4
27,2023-08-12T10:12:00+10:00,2023-08-12,10:12,2,2,4
27,2023-08-12T10:14:00+10:00,2023-08-12,10:14,1,1,2
27,2023-08-12T10:15:00+10:00,2023-08-12,10:15,2,1,3
27,2023-08-12T10:19:00+10:00,2023-08-12,10:19,2,1,3
27,2023-08-12T10:20:00+10:00,2023-08-12,10:20,2,8,10
27,2023-08-12T10:21:00+10:00,2023-08-12,10:21,5,0,5
27,2023-08-12T10:22:00+10:00,2023-08-12,10:22,4,1,5
27,2023-08-12T10:23:00+10:00,2023-08-12,10:23,0,4,4
27,2023-08-12T10:24:00+10:00,2023-08-12,10:24,1,5,6
27,2023-08-12T10:26:00+10:00,2023-08-12,10:26,4,4,8
27,2023-08-12T10:27:00+10:00,2023-08-12,10:27,8,0,8
27,2023-08-12T10:29:00+10:00,2023-08-12,10:29,6,4,10
27,2023-08-12T10:31:00+10:00,2023-08-12,10:31,6,3,9
27,2023-08-12T10:33:00+10:00,2023-08-12,10:33,1,4,5
27,2023-08-12T10:37:00+10:00,2023-08-12,10:37,3,9,12
27,2023-08-12T10:39:00+10:00,2023-08-12,10:39,3,0,3
27,2023-08-12T10:50:00+10:00,2023-08-12,10:50,0,5,5
27,2023-08-12T10:52:00+10:00,2023-08-12,10:52,2,5,7
27,2023-08-12T10:55:00+10:00,2023-08-12,10:55,0,5,5
35,2023-08-12T10:08:00+10:00,2023-08-12,10:08,10,8,18
35,2023-08-12T10:13:00+10:00,2023-08-12,10:13,9,5,14
35,2023-08-12T10:14:00+10:00,2023-08-12,10:14,7,4,11
35,2023-08-12T10:18:00+10:00,2023-08-12,10:18,12,4,16
35,2023-08-12T10:19:00+10:00,2023-08-12,10:19,11,4,15
35,2023-08-12T10:20:00+10:00,2023-08-12,10:20,3,5,8
35,2023-08-12T10:23:00+10:00,2023-08-12,10:23,8,3,11
35,2023-08-12T10:24:00+10:00,2023-08-12,10:24,7,11,18
35,2023-08-12T10:28:00+10:00,2023-08-12,10:28,11,6,17
35,2023-08-12T10:29:00+10:00,2023-08-12,10:29,12,8,20
35,2023-08-12T10:30:00+10:00,2023-08-12,10:30,9,7,16
35,2023-08-12T10:35:00+10:00,2023-08-12,10:35,6,2,8
35,2023-08-12T10:36:00+10:00,2023-08-12,10:36,8,3,11
35,2023-08-12T10:37:00+10:00,2023-08-12,10:37,16,5,21
35,2023-08-12T10:38:00+10:00,2023-08-12,10:38,8,12,20
35,2023-08-12T10:45:00+10:00,2023-08-12,10:45,5,6,11
35,2023-08-12T10:46:00+10:00,2023-08-12,10:46,12,6,18
35,2023-08-12T10:51:00+10:00,2023-08-12,10:51,9,9,18
35,2023-08-12T10:52:00+10:00,2023-08-12,10:52,5,9,14
53,2023-08-12T09:55:00+10:00,2023-08-12,09:55,8,4,12
53,2023-08-12T10:00:00+10:00,2023-08-12,10:00,1,2,3
53,2023-08-12T10:01:00+10:00,2023-08-12,10:01,4,4,8
53,2023-08-12T10:03:00+10:00,2023-08-12,10:03,8,5,13
53,2023-08-12T10:05:00+10:00,2023-08-12,10:05,6,6,12
53,2023-08-12T10:07:00+10:00,2023-08-12,10:07,3,2,5
53,2023-08-12T10:10:00+10:00,2023-08-12,10:10,3,0,3
53,2023-08-12T10:12:00+10:00,2023-08-12,10:12,7,4,11
53,2023-08-12T10:13:00+10:00,2023-08-12,10:13,10,10,20
53,2023-08-12T10:28:00+10:00,2023-08-12,10:28,5,6,11
53,2023-08-12T10:32:00+10:00,2023-08-12,10:32,12,2,14
53,2023-08-12T10:37:00+10:00,2023-08-12,10:37,8,5,13
53,2023-08-12T10:38:00+10:00,2023-08-12,10:38,4,3,7
53,2023-08-12T10:39:00+10:00,2023-08-12,10:39,3,5,8
53,2023-08-12T10:41:00+10:00,2023-08-12,10:41,12,6,18
53,2023-08-12T10:43:00+10:00,2023-08-12,10:43,11,4,15
53,2023-08-12T10:44:00+10:00,2023-08-12,10:44,5,3,8
53,2023-08-12T10:48:00+10:00,2023-08-12,10:48,4,11,15
53,2023-08-12T10:53:00+10:00,2023-08-12,10:53,7,9,16
56,2023-08-12T09:57:00+10:00,2023-08-12,09:57,9,2,11
56,2023-08-12T10:02:00+10:00,2023-08-12,10:02,2,0,2
56,2023-08-12T10:03:00+10:00,2023-08-12,10:03,8,3,11
56,2023-08-12T10:04:00+10:00,2023-08-12,10:04,3,2,5
56,2023-08-12T10:08:00+10:00,2023-08-12,10:08,4,2,6
56,2023-08-12T10:10:00+10:00,2023-08-12,10:10,3,4,7
56,2023-08-12T10:20:00+10:00,2023-08-12,10:20,3,4,7
56,2023-08-12T10:21:00+10:00,2023-08-12,10:21,7,0,7
56,2023-08-12T10:29:00+10:00,2023-08-12,10:29,4,1,5
56,2023-08-12T10:31:00+10:00,2023-08-12,10:31,3,0,3
56,2023-08-12T10:33:00+10:00,2023-08-12,10:33,2,1,3
56,2023-08-12T10:39:00+10:00,2023-08-12,10:39,3,0,3
56,2023-08-12T10:40:00+10:00,2023-08-12,10:40,7,0,7
56,2023-08-12T10:41:00+10:00,2023-08-12,10:41,1,10,11
56,2023-08-12T10:44:00+10:00,2023-08-12,10:44,6,5,11
56,2023-08-12T10:47:00+10:00,2023-08-12,10:47,5,3,8
56,2023-08-12T10:50:00+10:00,2023-08-12,10:50,12,1,13
56,2023-08-12T10:53:00+10:00,2023-08-12,10:53,5,2,7
56,2023-08-12T10:55:00+10:00,2023-08-12,10:55,6,1,7
57,2023-08-12T09:55:00+10:00,2023-08-12,09:55,0,1,1
57,2023-08-12T09:57:00+10:00,2023-08-12,09:57,1,2,3
57,2023-08-12T09:59:00+10:00,2023-08-12,09:59,0,1,1
57,2023-08-12T10:01:00+10:00,2023-08-12,10:01,4,3,7
57,2023-08-12T10:02:00+10:00,2023-08-12,10:02,1,2,3
57,2023-08-12T10:04:00+10:00,2023-08-12,10:04,1,6,7
57,2023-08-12T10:08:00+10:00,2023-08-12,10:08,1,1,2
57,2023-08-12T10:10:00+10:00,2023-08-12,10:10,0,2,2
57,2023-08-12T10:14:00+10:00,2023-08-12,10:14,3,3,6
57,2023-08-12T10:19:00+10:00,2023-08-12,10:19,1,1,2
57,2023-08-12T10:22:00+10:00,2023-08-12,10:22,3,3,6
57,2023-08-12T10:28:00+10:00,2023-08-12,10:28,0,6,6
57,2023-08-12T10:32:00+10:00,2023-08-12,10:32,0,1,1
57,2023-08-12T10:41:00+10:00,2023-08-12,10:41,1,1,2
57,2023-08-12T10:48:00+10:00,2023-08-12,10:48,2,2,4
57,2023-08-12T10:51:00+10:00,2023-08-12,10:51,0,1,1
57,2023-08-12T10:53:00+10:00,2023-08-12,10:53,2,2,4
58,2023-08-12T09:55:00+10:00,2023-08-12,09:55,2,2,4
58,2023-08-12T09:56:00+10:00,2023-08-12,09:56,11,1,12
58,2023-08-12T10:02:00+10:00,2023-08-12,10:02,11,2,13
58,2023-08-12T10:03:00+10:00,2023-08-12,10:03,14,8,22
58,2023-08-12T10:04:00+10:00,2023-08-12,10:04,26,0,26
58,2023-08-12T10:06:00+10:00,2023-08-12,10:06,14,1,15
58,2023-08-12T10:07:00+10:00,2023-08-12,10:07,8,2,10
58,2023-08-12T10:12:00+10:00,2023-08-12,10:12,12,14,26
58,2023-08-12T10:14:00+10:00,2023-08-12,10:14,10,7,17
58,2023-08-12T10:22:00+10:00,2023-08-12,10:22,14,3,17
58,2023-08-12T10:23:00+10:00,2023-08-12,10:23,7,4,11
58,2023-08-12T10:30:00+10:00,2023-08-12,10:30,1,0,1
58,2023-08-12T10:31:00+10:00,2023-08-12,10:31,15,2,17
58,2023-08-12T10:32:00+10:00,2023-08-12,10:32,11,3,14
58,2023-08-12T10:43:00+10:00,2023-08-12,10:43,1,0,1
58,2023-08-12T10:44:00+10:00,2023-08-12,10:44,6,9,15
58,2023-08-12T10:46:00+10:00,2023-08-12,10:46,3,7,10
58,2023-08-12T10:47:00+10:00,2023-08-12,10:47,17,15,32
58,2023-08-12T10:49:00+10:00,2023-08-12,10:49,10,0,10
62,2023-08-12T09:59:00+10:00,2023-08-12,09:59,6,3,9
62,2023-08-12T10:03:00+10:00,2023-08-12,10:03,5,0,5
62,2023-08-12T10:07:00+10:00,2023-08-12,10:07,3,0,3
62,2023-08-12T10:08:00+10:00,2023-08-12,10:08,3,0,3
62,2023-08-12T10:09:00+10:00,2023-08-12,10:09,4,1,5
62,2023-08-12T10:10:00+10:00,2023-08-12,10:10,1,0,1
62,2023-08-12T10:14:00+10:00,2023-08-12,10:14,0,4,4
62,2023-08-12T10:15:00+10:00,2023-08-12,10:15,8,0,8
62,2023-08-12T10:16:00+10:00,2023-08-12,10:16,1,0,1
62,2023-08-12T10:18:00+10:00,2023-08-12,10:18,2,8,10
62,2023-08-12T10:19:00+10:00,2023-08-12,10:19,4,4,8
62,2023-08-12T10:20:00+10:00,2023-08-12,10:20,4,3,7
62,2023-08-12T10:21:00+10:00,2023-08-12,10:21,10,3,13
62,2023-08-12T10:26:00+10:00,2023-08-12,10:26,1,3,4
62,2023-08-12T10:30:00+10:00,2023-08-12,10:30,1,2,3
62,2023-08-12T10:34:00+10:00,2023-08-12,10:34,6,2,8
62,2023-08-12T10:39:00+10:00,2023-08-12,10:39,2,1,3
62,2023-08-12T10:46:00+10:00,2023-08-12,10:46,4,0,4
62,2023-08-12T10:49:00+10:00,2023-08-12,10:49,0,2,2
62,2023-08-12T10:51:00+10:00,2023-08-12,10:51,5,1,6
62,2023-08-12T10:52:00+10:00,2023-08-12,10:52,11,3,14
62,2023-08-12T10:53:00+10:00,2023-08-12,10:53,3,2,5
62,2023-08-12T10:55:00+10:00,2023-08-12,10:55,8,1,9
63,2023-08-12T09:55:00+10:00,2023-08-12,09:55,2,9,11
63,2023-08-12T09:58:00+10:00,2023-08-12,09:58,2,1,3
63,2023-08-12T10:00:00+10:00,2023-08-12,10:00,1,4,5
63,2023-08-12T10:03:00+10:00,2023-08-12,10:03,3,9,12
63,2023-08-12T10:07:00+10:00,2023-08-12,10:07,3,5,8
63,2023-08-12T10:08:00+10:00,2023-08-12,10:08,0,6,6
63,2023-08-12T10:12:00+10:00,2023-08-12,10:12,0,1,1
63,2023-08-12T10:14:00+10:00,2023-08-12,10:14,0,9,9
63,2023-08-12T10:15:00+10:00,2023-08-12,10:15,2,10,12
63,2023-08-12T10:16:00+10:00,2023-08-12,10:16,1,1,2
63,2023-08-12T10:20:00+10:00,2023-08-12,10:20,3,6,9
63,2023-08-12T10:21:00+10:00,2023-08-12,10:21,6,5,11
63,2023-08-12T10:28:00+10:00,2023-08-12,10:28,1,5,6
63,2023-08-12T10:30:00+10:00,2023-08-12,10:30,2,9,11
63,2023-08-12T10:40:00+10:00,2023-08-12,10:40,3,7,10
63,2023-08-12T10:41:00+10:00,2023-08-12,10:41,3,7,10
63,2023-08-12T10:42:00+10:00,2023-08-12,10:42,1,7,8
63,2023-08-12T10:44:00+10:00,2023-08-12,10:44,1,3,4
63,2023-08-12T10:49:00+10:00,2023-08-12,10:49,4,1,5
63,2023-08-12T10:50:00+10:00,2023-08-12,10:50,1,8,9
63,2023-08-12T10:51:00+10:00,2023-08-12,10:51,2,4,6
67,2023-08-12T09:56:00+10:00,2023-08-12,09:56,3,6,9
67,2023-08-12T09:58:00+10:00,2023-08-12,09:58,5,7,12
67,2023-08-12T10:01:00+10:00,2023-08-12,10:01,6,4,10
67,2023-08-12T10:03:00+10:00,2023-08-12,10:03,5,8,13
67,2023-08-12T10:05:00+10:00,2023-08-12,10:05,1,10,11
67,2023-08-12T10:07:00+10:00,2023-08-12,10:07,4,12,16
67,2023-08-12T10:08:00+10:00,2023-08-12,10:08,3,9,12
67,2023-08-12T10:09:00+10:00,2023-08-12,10:09,7,8,15
67,2023-08-12T10:17:00+10:00,2023-08-12,10:17,4,2,6
67,2023-08-12T10:21:00+10:00,2023-08-12,10:21,3,7,10
67,2023-08-12T10:22:00+10:00,2023-08-12,10:22,1,2,3
67,2023-08-12T10:24:00+10:00,2023-08-12,10:24,3,3,6
67,2023-08-12T10:28:00+10:00,2023-08-12,10:28,4,5,9
67,2023-08-12T10:30:00+10:00,2023-08-12,10:30,6,9,15
67,2023-08-12T10:31:00+10:00,2023-08-12,10:31,4,6,10
67,2023-08-12T10:35:00+10:00,2023-08-12,10:35,3,7,10
67,2023-08-12T10:37:00+10:00,2023-08-12,10:37,3,6,9
67,2023-08-12T10:38:00+10:00,2023-08-12,10:38,5,6,11
67,2023-08-12T10:42:00+10:00,2023-08-12,10:42,14,11,25
67,2023-08-12T10:43:00+10:00,2023-08-12,10:43,14,7,21
67,2023-08-12T10:46:00+10:00,2023-08-12,10:46,2,7,9
67,2023-08-12T10:51:00+10:00,2023-08-12,10:51,3,11,14
67,2023-08-12T10:52:00+10:00,2023-08-12,10:52,1,3,4
67,2023-08-12T10:55:00+10:00,2023-08-12,10:55,4,9,13
68,2023-08-12T09:55:00+10:00,2023-08-12,09:55,2,0,2
68,2023-08-12T09:58:00+10:00,2023-08-12,09:58,3,1,4
68,2023-08-12T10:00:00+10:00,2023-08-12,10:00,4,3,7
68,2023-08-12T10:02:00+10:00,2023-08-12,10:02,5,1,6
68,2023-08-12T10:03:00+10:00,2023-08-12,10:03,4,6,10
68,2023-08-12T10:07:00+10:00,2023-08-12,10:07,3,3,6
68,2023-08-12T10:08:00+10:00,2023-08-12,10:08,2,2,4
68,2023-08-12T10:15:00+10:00,2023-08-12,10:15,0,3,3
68,2023-08-12T10:16:00+10:00,2023-08-12,10:16,1,2,3
68,2023-08-12T10:17:00+10:00,2023-08-12,10:17,1,3,4
68,2023-08-12T10:24:00+10:00,2023-08-12,10:24,4,1,5
68,2023-08-12T10:25:00+10:00,2023-08-12,10:25,2,1,3
68,2023-08-12T10:26:00+10:00,2023-08-12,10:26,3,0,3
68,2023-08-12T10:28:00+10:00,2023-08-12,10:28,6,8,14
68,2023-08-12T10:29:00+10:00,2023-08-12,10:29,4,2,6
68,2023-08-12T10:34:00+10:00,2023-08-12,10:34,4,1,5
68,2023-08-12T10:35:00+10:00,2023-08-12,10:35,0,2,2
68,2023-08-12T10:40:00+10:00,2023-08-12,10:40,4,1,5
68,2023-08-12T10:41:00+10:00,2023-08-12,10:41,2,5,7
68,2023-08-12T10:45:00+10:00,2023-08-12,10:45,5,4,9
68,2023-08-12T10:47:00+10:00,2023-08-12,10:47,3,3,6
68,2023-08-12T10:51:00+10:00,2023-08-12,10:51,1,1,2
68,2023-08-12T10:54:00+10:00,2023-08-12,10:54,1,1,2
72,2023-08-12T09:59:00+10:00,2023-08-12,09:59,1,5,6
72,2023-08-12T10:06:00+10:00,2023-08-12,10:06,5,2,7
72,2023-08-12T10:08:00+10:00,2023-08-12,10:08,3,3,6
72,2023-08-12T10:13:00+10:00,2023-08-12,10:13,9,8,17
72,2023-08-12T10:17:00+10:00,2023-08-12,10:17,0,2,2
72,2023-08-12T10:22:00+10:00,2023-08-12,10:22,5,5,10
72,2023-08-12T10:24:00+10:00,2023-08-12,10:24,3,6,9
72,2023-08-12T10:26:00+10:00,2023-08-12,10:26,4,0,4
72,2023-08-12T10:29:00+10:00,2023-08-12,10:29,3,5,8
72,2023-08-12T10:33:00+10:00,2023-08-12,10:33,7,3,10
72,2023-08-12T10:39:00+10:00,2023-08-12,10:39,6,1,7
72,2023-08-12T10:43:00+10:00,2023-08-12,10:43,3,0,3
72,2023-08-12T10:44:00+10:00,2023-08-12,10:44,6,2,8
72,2023-08-12T10:46:00+10:00,2023-08-12,10:46,2,5,7
72,2023-08-12T10:48:00+10:00,2023-08-12,10:48,9,6,15
72,2023-08-12T10:54:00+10:00,2023-08-12,10:54,2,0,2
76,2023-08-12T09:55:00+10:00,2023-08-12,09:55,2,0,2
76,2023-08-12T09:58:00+10:00,2023-08-12,09:58,3,1,4
76,2023-08-12T10:00:00+10:00,2023-08-12,10:00,1,0,1
76,2023-08-12T10:03:00+10:00,2023-08-12,10:03,1,2,3
76,2023-08-12T10:04:00+10:00,2023-08-12,10:04,1,1,2
76,2023-08-12T10:09:00+10:00,2023-08-12,10:09,5,2,7
76,2023-08-12T10:15:00+10:00,2023-08-12,10:15,2,0,2
76,2023-08-12T10:19:00+10:00,2023-08-12,10:19,2,1,3
76,2023-08-12T10:23:00+10:00,2023-08-12,10:23,0,1,1
76,2023-08-12T10:27:00+10:00,2023-08-12,10:27,1,0,1
76,2023-08-12T10:29:00+10:00,2023-08-12,10:29,1,1,2
76,2023-08-12T10:31:00+10:00,2023-08-12,10:31,0,1,1
76,2023-08-12T10:32:00+10:00,2023-08-12,10:32,1,0,1
76,2023-08-12T10:36:00+10:00,2023-08-12,10:36,2,1,3
76,2023-08-12T10:37:00+10:00,2023-08-12,10:37,3,2,5
76,2023-08-12T10:38:00+10:00,2023-08-12,10:38,1,2,3
76,2023-08-12T10:39:00+10:00,2023-08-12,10:39,1,2,3
76,2023-08-12T10:42:00+10:00,2023-08-12,10:42,1,3,4
76,2023-08-12T10:48:00+10:00,2023-08-12,10:48,0,2,2
79,2023-08-12T09:55:00+10:00,2023-08-12,09:55,6,2,8
79,2023-08-12T09:56:00+10:00,2023-08-12,09:56,4,5,9
79,2023-08-12T09:57:00+10:00,2023-08-12,09:57,24,3,27
79,2023-08-12T10:03:00+10:00,2023-08-12,10:03,8,0,8
79,2023-08-12T10:05:00+10:00,2023-08-12,10:05,4,5,9
79,2023-08-12T10:09:00+10:00,2023-08-12,10:09,10,2,12
79,2023-08-12T10:10:00+10:00,2023-08-12,10:10,9,8,17
79,2023-08-12T10:12:00+10:00,2023-08-12,10:12,1,1,2
79,2023-08-12T10:17:00+10:00,2023-08-12,10:17,6,7,13
79,2023-08-12T10:19:00+10:00,2023-08-12,10:19,4,4,8
79,2023-08-12T10:20:00+10:00,2023-08-12,10:20,6,7,13
79,2023-08-12T10:21:00+10:00,2023-08-12,10:21,5,6,11
79,2023-08-12T10:27:00+10:00,2023-08-12,10:27,11,8,19
79,2023-08-12T10:31:00+10:00,2023-08-12,10:31,12,8,20
79,2023-08-12T10:33:00+10:00,2023-08-12,10:33,11,9,20
79,2023-08-12T10:36:00+10:00,2023-08-12,10:36,7,2,9
79,2023-08-12T10:40:00+10:00,2023-08-12,10:40,11,4,15
79,2023-08-12T10:41:00+10:00,2023-08-12,10:41,9,3,12
79,2023-08-12T10:44:00+10:00,2023-08-12,10:44,8,13,21
79,2023-08-12T10:46:00+10:00,2023-08-12,10:46,3,11,14
79,2023-08-12T10:49:00+10:00,2023-08-12,10:49,10,3,13
79,2023-08-12T10:51:00+10:00,2023-08-12,10:51,7,7,14
79,2023-08-12T10:52:00+10:00,2023-08-12,10:52,3,1,4
79,2023-08-12T10:53:00+10:00,2023-08-12,10:53,3,1,4
79,2023-08-12T10:54:00+10:00,2023-08-12,10:54,12,5,17
79,2023-08-12T10:55:00+10:00,2023-08-12,10:55,1,9,10
85,2023-08-12T09:57:00+10:00,2023-08-12,09:57,2,1,3
85,2023-08-12T10:05:00+10:00,2023-08-12,10:05,2,0,2
85,2023-08-12T10:06:00+10:00,2023-08-12,10:06,1,1,2
85,2023-08-12T10:09:00+10:00,2023-08-12,10:09,4,0,4
85,2023-08-12T10:19:00+10:00,2023-08-12,10:19,0,1,1
85,2023-08-12T10:22:00+10:00,2023-08-12,10:22,2,2,4
85,2023-08-12T10:23:00+10:00,2023-08-12,10:23,5,0,5
85,2023-08-12T10:24:00+10:00,2023-08-12,10:24,1,1,2
85,2023-08-12T10:30:00+10:00,2023-08-12,10:30,2,3,5
85,2023-08-12T10:35:00+10:00,2023-08-12,10:35,4,0,4
85,2023-08-12T10:40:00+10:00,2023-08-12,10:40,8,1,9
85,2023-08-12T10:45:00+10:00,2023-08-12,10:45,5,0,5
85,2023-08-12T10:47:00+10:00,2023-08-12,10:47,1,1,2
85,2023-08-12T10:49:00+10:00,2023-08-12,10:49,3,2,5
85,2023-08-12T10:54:00+10:00,2023-08-12,10:54,3,2,5
86,2023-08-12T09:57:00+10:00,2023-08-12,09:57,1,0,1
86,2023-08-12T09:59:00+10:00,2023-08-12,09:59,3,0,3
86,2023-08-12T10:06:00+10:00,2023-08-12,10:06,1,2,3
86,2023-08-12T10:11:00+10:00,2023-08-12,10:11,2,2,4
86,2023-08-12T10:12:00+10:00,2023-08-12,10:12,2,3,5
86,2023-08-12T10:13:00+10:00,2023-08-12,10:13,3,1,4
86,2023-08-12T10:20:00+10:00,2023-08-12,10:20,0,1,1
86,2023-08-12T10:21:00+10:00,2023-08-12,10:21,4,0,4
86,2023-08-12T10:23:00+10:00,2023-08-12,10:23,5,0,5
86,2023-08-12T10:24:00+10:00,2023-08-12,10:24,1,1,2
86,2023-08-12T10:27:00+10:00,2023-08-12,10:27,1,1,2
86,2023-08-12T10:33:00+10:00,2023-08-12,10:33,0,1,1
86,2023-08-12T10:37:00+10:00,2023-08-12,10:37,3,0,3
86,2023-08-12T10:38:00+10:00,2023-08-12,10:38,2,1,3
86,2023-08-12T10:40:00+10:00,2023-08-12,10:40,0,1,1
86,2023-08-12T10:42:00+10:00,2023-08-12,10:42,1,1,2
86,2023-08-12T10:46:00+10:00,2023-08-12,10:46,1,2,3
86,2023-08-12T10:52:00+10:00,2023-08-12,10:52,1,0,1
109,2023-08-12T10:00:00+10:00,2023-08-12,10:00,12,4,16
109,2023-08-12T10:25:00+10:00,2023-08-12,10:25,4,8,12
109,2023-08-12T10:40:00+10:00,2023-08-12,10:40,11,9,20
109,2023-08-12T10:45:00+10:00,2023-08-12,10:45,2,8,10
109,2023-08-12T10:50:00+10:00,2023-08-12,10:50,3,14,17
117,2023-08-12T10:00:00+10:00,2023-08-12,10:00,4,25,29
117,2023-08-12T10:20:00+10:00,2023-08-12,10:20,7,22,29
117,2023-08-12T10:30:00+10:00,2023-08-12,10:30,5,8,13
117,2023-08-12T10:55:00+10:00,2023-08-12,10:55,18,18,36
122,2023-08-12T09:56:00+10:00,2023-08-12,09:56,0,2,2
122,2023-08-12T09:58:00+10:00,2023-08-12,09:58,0,1,1
122,2023-08-12T10:00:00+10:00,2023-08-12,10:00,0,1,1
122,2023-08-12T10:05:00+10:00,2023-08-12,10:05,2,0,2
122,2023-08-12T10:07:00+10:00,2023-08-12,10:07,1,0,1
122,2023-08-12T10:13:00+10:00,2023-08-12,10:13,1,0,1
122,2023-08-12T10:26:00+10:00,2023-08-12,10:26,1,0,1
122,2023-08-12T10:30:00+10:00,2023-08-12,10:30,0,1,1
122,2023-08-12T10:42:00+10:00,2023-08-12,10:42,0,2,2
3,2023-08-12T09:58:00+10:00,2023-08-12,09:58,4,2,6
3,2023-08-12T10:00:00+10:00,2023-08-12,10:00,7,10,17
3,2023-08-12T10:05:00+10:00,2023-08-12,10:05,7,5,12
3,2023-08-12T10:06:00+10:00,2023-08-12,10:06,6,5,11
3,2023-08-12T10:18:00+10:00,2023-08-12,10:18,5,7,12
3,2023-08-12T10:24:00+10:00,2023-08-12,10:24,7,9,16
3,2023-08-12T10:25:00+10:00,2023-08-12,10:25,5,9,14
3,2023-08-12T10:32:00+10:00,2023-08-12,10:32,3,6,9
3,2023-08-12T10:36:00+10:00,2023-08-12,10:36,12,5,17
3,2023-08-12T10:38:00+10:00,2023-08-12,10:38,6,6,12
3,2023-08-12T10:41:00+10:00,2023-08-12,10:41,7,20,27
3,2023-08-12T10:50:00+10:00,2023-08-12,10:50,5,11,16
3,2023-08-12T10:54:00+10:00,2023-08-12,10:54,9,15,24
4,2023-08-12T09:55:00+10:00,2023-08-12,09:55,17,6,23
4,2023-08-12T09:58:00+10:00,2023-08-12,09:58,21,3,24
4,2023-08-12T10:01:00+10:00,2023-08-12,10:01,13,6,19
4,2023-08-12T10:02:00+10:00,2023-08-12,10:02,12,4,16
4,2023-08-12T10:03:00+10:00,2023-08-12,10:03,13,5,18
4,2023-08-12T10:07:00+10:00,2023-08-12,10:07,14,8,22
4,2023-08-12T10:09:00+10:00,2023-08-12,10:09,7,10,17
4,2023-08-12T10:11:00+10:00,2023-08-12,10:11,12,5,17
4,2023-08-12T10:17:00+10:00,2023-08-12,10:17,12,4,16
4,2023-08-12T10:23:00+10:00,2023-08-12,10:23,20,4,24
4,2023-08-12T10:27:00+10:00,2023-08-12,10:27,16,12,28
4,2023-08-12T10:28:00+10:00,2023-08-12,10:28,8,16,24
4,2023-08-12T10:31:00+10:00,2023-08-12,10:31,24,13,37
4,2023-08-12T10:35:00+10:00,2023-08-12,10:35,10,20,30
4,2023-08-12T10:36:00+10:00,2023-08-12,10:36,17,8,25
4,2023-08-12T10:37:00+10:00,2023-08-12,10:37,23,6,29
4,2023-08-12T10:41:00+10:00,2023-08-12,10:41,15,12,27
4,2023-08-12T10:44:00+10:00,2023-08-12,10:44,29,8,37
4,2023-08-12T10:49:00+10:00,2023-08-12,10:49,19,15,34
4,2023-08-12T10:53:00+10:00,2023-08-12,10:53,37,25,62
6,2023-08-12T09:57:00+10:00,2023-08-12,09:57,5,1,6
6,2023-08-12T09:58:00+10:00,2023-08-12,09:58,10,10,20
6,2023-08-12T10:01:00+10:00,2023-08-12,10:01,6,1,7
6,2023-08-12T10:05:00+10:00,2023-08-12,10:05,8,4,12
6,2023-08-12T10:06:00+10:00,2023-08-12,10:06,4,4,8
6,2023-08-12T10:07:00+10:00,2023-08-12,10:07,7,5,12
6,2023-08-12T10:10:00+10:00,2023-08-12,10:10,8,6,14
6,2023-08-12T10:11:00+10:00,2023-08-12,10:11,4,1,5
6,2023-08-12T10:15:00+10:00,2023-08-12,10:15,3,4,7
6,2023-08-12T10:17:00+10:00,2023-08-12,10:17,10,2,12
6,2023-08-12T10:19:00+10:00,2023-08-12,10:19,14,7,21
6,2023-08-12T10:25:00+10:00,2023-08-12,10:25,7,1,8
6,2023-08-12T10:26:00+10:00,2023-08-12,10:26,3,5,8
6,2023-08-12T10:35:00+10:00,2023-08-12,10:35,8,4,12
6,2023-08-12T10:40:00+10:00,2023-08-12,10:40,4,3,7
6,2023-08-12T10:45:00+10:00,2023-08-12,10:45,11,17,28
6,2023-08-12T10:46:00+10:00,2023-08-12,10:46,8,12,20
6,2023-08-12T10:47:00+10:00,2023-08-12,10:47,14,5,19
6,2023-08-12T10:52:00+10:00,2023-08-12,10:52,7,5,12
6,2023-08-12T10:53:00+10:00,2023-08-12,10:53,10,6,16
6,2023-08-12T10:55:00+10:00,2023-08-12,10:55,11,1,12
8,2023-08-12T10:01:00+10:00,2023-08-12,10:01,1,0,1
8,2023-08-12T10:04:00+10:00,2023-08-12,10:04,4,0,4
8,2023-08-12T10:06:00+10:00,2023-08-12,10:06,2,0,2
8,2023-08-12T10:12:00+10:00,2023-08-12,10:12,4,5,9
8,2023-08-12T10:13:00+10:00,2023-08-12,10:13,0,3,3
8,2023-08-12T10:15:00+10:00,2023-08-12,10:15,1,2,3
8,2023-08-12T10:16:00+10:00,2023-08-12,10:16,2,6,8
8,2023-08-12T10:19:00+10:00,2023-08-12,10:19,1,3,4
8,2023-08-12T10:23:00+10:00,2023-08-12,10:23,0,6,6
8,2023-08-12T10:24:00+10:00,2023-08-12,10:24,3,1,4
8,2023-08-12T10:26:00+10:00,2023-08-12,10:26,0,3,3
8,2023-08-12T10:27:00+10:00,2023-08-12,10:27,2,6,8
8,2023-08-12T10:31:00+10:00,2023-08-12,10:31,1,0,1
8,2023-08-12T10:32:00+10:00,2023-08-12,10:32,1,5,6
8,2023-08-12T10:36:00+10:00,2023-08-12,10:36,2,4,6
8,2023-08-12T10:41:00+10:00,2023-08-12,10:41,2,1,3
